явственно	j a f s t vʲ i n a
гомер	ɡ a mʲ e r
сплетавший	s p lʲ i t a f ʂ i j
усыновляйте	u s i n a v lʲ a j tʲ e
льда	lʲ d a
прозвучишь	p r a z v u t͡ɕ i ʂ
сатирах	s a tʲ i r a x
ремиксов	rʲ i mʲ i k s a f
залепляю	z a lʲ i p lʲ a j u
абсорбированиями	a p s a r bʲ i r a v a nʲ i j a mʲ i
плавкою	p ɫ a f k a j u
зашумит	z a ʂ u mʲ i t
мужененавистничествам	m u ʐ i nʲ i n a vʲ i sʲ nʲ i t͡ɕ i s t v a m
золотистым	z a ɫ a tʲ i s t i m
катерочках	k a tʲ i r o t͡ɕ k a x
смеялось	s mʲ i j a ɫ a sʲ
замыслу	z a m i s ɫ u
семиугольника	sʲ i mʲ i u ɡ o lʲ nʲ i k a
присягнувши	p rʲ i sʲ i ɡ n u f ʂ i
поносят	p a n o sʲ a t
изучитесь	i z u t͡ɕ i tʲ i sʲ
помойкою	p a m o j k a j u
англицизациею	a n ɡ lʲ i t͡s i z a t͡s i j i j u
прыщавый	p r i ɕː a v i j
усопла	u s o p ɫ a
полетать	p a lʲ i t a tʲ
укутывающий	u k u t i v a j u ɕː i j
муруй	m u r u j
суммируешь	s u mʲ i r u j i ʂ
секта	sʲ e k t a
заклейте	z a k lʲ e j tʲ e
амилазой	a mʲ i ɫ a z a j
посодействовать	p a s a dʲ e j s t v a v a tʲ
опьянивший	a p ⁽ʲ ⁾ j i nʲ i f ʂ i j
заговаривайтесь	z a ɡ a v a rʲ i v a j tʲ i sʲ
ужесточения	u ʐ i s t a t͡ɕ e nʲ i j a
расправах	r a s p r a v a x
летный	lʲ e t n i j
дубу	d u b u
загадит	z a ɡ a dʲ i t
пропитайтесь	p r a pʲ i t a j tʲ i sʲ
отсчётах	a t͡ɕ ɕː o t a x
десницу	dʲ i sʲ nʲ i t͡s u
обуевала	a b u j i v a ɫ a
вертлуг	vʲ i r t ɫ u k
навевавший	n a vʲ i v a f ʂ i j
полиграфиях	p a lʲ i ɡ r a fʲ i j a x
западаешь	z a p a d a j i ʂ
дозрею	d a z rʲ e j u
взыскиваете	v z i s kʲ i v a j i tʲ e
изъянами	i z j a n a mʲ i
метафизику	mʲ i t a fʲ i zʲ i k u
веселеешь	vʲ i sʲ i lʲ e j i ʂ
технократию	tʲ i x n a k r a tʲ i j u
пригородом	p rʲ i ɡ a r a d a m
пионеров	pʲ i a nʲ e r a f
поручительством	p a r u t͡ɕ i tʲ i lʲ s t v a m
гостьях	ɡ o sʲ tʲ j a x
подтягиваюсь	p a tʲː a ɡʲ i v a j u sʲ
присчитывай	p rʲ i ɕː i t i v a j
оттаяло	a t a j i ɫ a
опушалась	a p u ʂ a ɫ a sʲ
поклонничество	p a k ɫ o nʲ i t͡ɕ i s t v a
аблаутов	a b ɫ a u t a f
отекаю	a tʲ i k a j u
стипендий	sʲ tʲ i pʲ e nʲ dʲ i j
кромкой	k r o m k a j
вляпался	v lʲ a p a ɫ s ⁽ʲ ⁾ a
уверовать	u vʲ e r a v a tʲ
тускневши	t u s k nʲ e f ʂ i
прокалываешь	p r a k a ɫ i v a j i ʂ
сконфузят	s k a n f u zʲ a t
извиняли	i z vʲ i nʲ a lʲ i
пофигизмами	p a fʲ i ɡʲ i z m a mʲ i
мурзиками	m u r zʲ i k a mʲ i
реквизициями	rʲ i k vʲ i zʲ i t͡s i j a mʲ i
администрациях	a d mʲ i nʲ i s t r a t͡s i j a x
оттащила	a t a ɕː i ɫ a
сроднивший	s r a dʲ nʲ i f ʂ i j
недолюбливайте	nʲ i d a lʲ u b lʲ i v a j tʲ e
множится	m n o ʐ i t͡s a
нарды	n a r d i
истеки	i sʲ tʲ i kʲ i
правоохранительный	p r a v a a x r a nʲ i tʲ i lʲ n i j
выскабливая	v i s k a b lʲ i v a j a
аудите	a u dʲ i tʲ e
обвил	a b vʲ i ɫ
шепнув	ʂ i p n u f
горкой	ɡ o r k a j
флексийный	f lʲ i k sʲ i j n i j
святою	s vʲ i t o j u
кастаньеты	k a s t a nʲ j e t i
подействовать	p a dʲ e j s t v a v a tʲ
кебабах	kʲ i b a b a x
оживляйтесь	a ʐ i v lʲ a j tʲ i sʲ
осклабляю	a s k ɫ a b lʲ a j u
уклонении	u k ɫ a nʲ e nʲ i i
адекватностях	a d i k v a t n a sʲ tʲ a x
анализирует	a n a lʲ i zʲ i r u j i t
лосося	ɫ a s o sʲ a
бабосам	b a b o s a m
восстанут	v a s t a n u t
красив	k r a sʲ i f
чайковский	t͡ɕ i j k o f s kʲ i j
асинхронный	a sʲ i n x r o n i j
мировыми	mʲ i r a v i mʲ i
вакансию	v a k a n ⁽ʲ ⁾ sʲ i j u
водяного	v a dʲ i n o v a
обросший	a b r o ʂ i j
текилах	tʲ i kʲ i ɫ a x
насаждавши	n a s a ʐ d a f ʂ i
дискетах	dʲ i s kʲ e t a x
приплясывать	p rʲ i p lʲ a s i v a tʲ
плешь	p lʲ e ʂ
предъявится	p rʲ i d j a vʲ i t͡s a
размягчаемый	r a z mʲ i x t͡ɕ a j i m i j
запрягут	z a p rʲ i ɡ u t
настучав	n a s t u t͡ɕ a f
губерниях	ɡ u bʲ e r nʲ i j a x
унесётесь	u nʲ i sʲ o tʲ i sʲ
раскачиваемся	r a s k a t͡ɕ i v a j i m sʲ a
больнаи	b a lʲ n a i
помазанников	p a m a z a nʲ i k a f
нумерацией	n u mʲ i r a t͡s i j i j
изготовлением	i z ɡ a t a v lʲ e nʲ i j i m
держава	dʲ i r ʐ a v a
умиришь	u mʲ i rʲ i ʂ
убежим	u bʲ i ʐ i m
доводят	d a v o dʲ a t
отбудьте	a d b u tʲː e
хиты	xʲ i t i
силаче	sʲ i ɫ a t͡ɕ e
прерывавши	p rʲ i r i v a f ʂ i
зондируем	z a nʲ dʲ i r u j i m
упроси	u p r a sʲ i
гирям	ɡʲ i rʲ a m
назначении	n a z n a t͡ɕ e nʲ i i
облепляемый	a b lʲ i p lʲ a j i m i j
реабилитируем	rʲ i a bʲ i lʲ i tʲ i r u j i m
ликбезам	lʲ i ɡ bʲ e z a m
мотылькам	m a t i lʲ k a m
ускоришься	u s k o rʲ i ʂ sʲ a
фасолей	f a s o lʲ i j
дуэта	d u e t a
мимикрий	mʲ i mʲ i k rʲ i j
мейтнериев	mʲ i j tʲ nʲ e rʲ i j i f
склеило	s k lʲ e i ɫ a
буревестника	b u rʲ i vʲ e sʲ nʲ i k a
благоустрой	b ɫ a ɡ a u s t r o j
заглинизированности	z a ɡ lʲ i nʲ i zʲ i r a v a n a sʲ tʲ i
укреплений	u k rʲ i p lʲ e nʲ i j
гостю	ɡ o sʲ tʲ u
сгущаюсь	z ɡ u ɕː a j u sʲ
разговляются	r a z ɡ a v lʲ a j u t͡s a
биотоксичность	bʲ i a t a k sʲ i t͡ɕ n a sʲ tʲ
клавдия	k ɫ a v dʲ i j a
деканаты	d i k a n a t i
возобновите	v a z a b n a vʲ i tʲ e
укрылся	u k r i ɫ s ⁽ʲ ⁾ a
рожаете	r a ʐ a j i tʲ e
угрожающий	u ɡ r a ʐ a j u ɕː i j
толковании	t a ɫ k a v a nʲ i i
деревяшкой	dʲ i rʲ i vʲ a ʂ k a j
сачкуйте	s a t͡ɕ k u j tʲ e
гвардейца	ɡ v a r dʲ e j t͡s a
завешивайте	z a vʲ e ʂ i v a j tʲ e
висело	vʲ i sʲ e ɫ a
капибарами	k a pʲ i b a r a mʲ i
растило	r a sʲ tʲ i ɫ a
вазочками	v a z a t͡ɕ k a mʲ i
льдинок	lʲ dʲ i n a k
туземцами	t u zʲ e m t͡s a mʲ i
чахотке	t͡ɕ i x o t kʲ e
привстающий	p rʲ i f s t a j u ɕː i j
реликта	rʲ i lʲ i k t a
отдалять	a d a lʲ a tʲ
блумфонтейн	b ɫ u m f a n t i j n
отставший	a t͡s s t a f ʂ i j
токсичный	t a k sʲ i t͡ɕ n i j
валенком	v a lʲ i n k a m
приземлявшийся	p rʲ i zʲ i m lʲ a f ʂ i j sʲ a
невежественна	nʲ i vʲ e ʐ i s t vʲ i n a
артистка	a r tʲ i s t k a
шампуня	ʂ a m p u nʲ a
негодованию	nʲ i ɡ a d a v a nʲ i j u
приготовлением	p rʲ i ɡ a t a v lʲ e nʲ i j i m
магнатов	m a ɡ n a t a f
вступлениях	f s t u p lʲ e nʲ i j a x
окопа	a k o p a
озарила	a z a rʲ i ɫ a
отворачивающийся	a t v a r a t͡ɕ i v a j u ɕː i j sʲ a
простудивши	p r a s t u dʲ i f ʂ i
комиссиями	k a mʲ i sʲ i j a mʲ i
расхищав	r a s xʲ i ɕː a f
нарекла	n a rʲ i k ɫ a
сровняйте	s r a v nʲ a j tʲ e
осияваешь	a sʲ i j i v a j i ʂ
инактивирую	i n a k tʲ i vʲ i r u j u
умудрит	u m u d rʲ i t
гуглите	ɡ u ɡ lʲ i tʲ e
пропитывав	p r a pʲ i t i v a f
самоцвета	s a m a t͡s vʲ e t a
толстяком	t a ɫ s ⁽ʲ ⁾ tʲ i k o m
всклокоченный	f s k ɫ a k o t͡ɕ i n i j
нервничавший	nʲ e r v nʲ i t͡ɕ i f ʂ i j
борющийся	b o rʲ u ɕː i j sʲ a
зачитывайся	z a t͡ɕ i t i v a j sʲ a
остужав	a s t u ʐ a f
лосьонам	ɫ a sʲ j o n a m
вальцующий	v a lʲ t͡s u j u ɕː i j
распиная	r a s pʲ i n a j a
топазу	t a p a z u
телетекстах	tʲ e lʲ i tʲ e k s t a x
подзаголовков	p a d͡z z a ɡ a ɫ o f k a f
ревел	rʲ i vʲ e ɫ
благословимся	b ɫ a ɡ a s ɫ a vʲ i m sʲ a
какую	k a k u j u
зажглись	z a ʐ ɡ lʲ i sʲ
орошу	a r a ʂ u
шарахать	ʂ a r a x a tʲ
руководств	r u k a v o t͡s t f
клянчу	k lʲ a nʲ t͡ɕ u
зацепляло	z a t͡s i p lʲ a ɫ a
абаданце	a b a d a n t͡s i
реяв	rʲ e j i f
ранетки	r a nʲ e t kʲ i
покладая	p a k ɫ a d a j a
предпишем	p rʲ i t pʲ i ʂ i m
бороздим	b a r a zʲ dʲ i m
нуворишам	n u v a rʲ i ʂ a m
арке	a r kʲ e
взбегав	v z bʲ i ɡ a f
гуманизме	ɡ u m a nʲ i z mʲ e
рожью	r o ʐ j u
гидраты	ɡʲ i d r a t i
доверительностям	d a vʲ i rʲ i tʲ i lʲ n a sʲ tʲ a m
холодавши	x a ɫ a d a f ʂ i
тюльпана	tʲ u lʲ p a n a
выкрасило	v i k r a sʲ i ɫ a
взвинчивал	v z vʲ i nʲ t͡ɕ i v a ɫ
вуй	v u j
маразмы	m a r a z m i
дисгармониею	dʲ i z ɡ a r m o nʲ i j i j u
ломаку	ɫ a m a k u
памятей	p a mʲ i tʲ i j
вседозволенностях	f sʲ i d a z v o lʲ i n a sʲ tʲ a x
куркумой	k u r k u m a j
тушуй	t u ʂ u j
заносит	z a n o sʲ i t
киноаппаратом	kʲ i n a a p a r a t a m
припоминаешь	p rʲ i p a mʲ i n a j i ʂ
зевал	zʲ i v a ɫ
накалывать	n a k a ɫ i v a tʲ
контрактниках	k a n t r a k tʲ nʲ i k a x
обучавшийся	a b u t͡ɕ a f ʂ i j sʲ a
упоминаются	u p a mʲ i n a j u t͡s a
абдеритами	a b dʲ i rʲ i t a mʲ i
теребейчук	tʲ i rʲ i bʲ i j t͡ɕ u k
учугов	u t͡ɕ u ɡ a f
изведав	i z vʲ e d a f
дополнивший	d a p o ɫ nʲ i f ʂ i j
давлениям	d a v lʲ e nʲ i j a m
приколоть	p rʲ i k a ɫ o tʲ
колосьям	k a ɫ o sʲ j a m
монголом	m a n ɡ o ɫ a m
высевок	v i sʲ i v a k
затешешь	z a tʲ e ʂ i ʂ
дураков	d u r a k o f
коренившись	k a rʲ i nʲ i f ʂ i sʲ
тулии	t u lʲ i i
выкраиваются	v i k r a i v a j u t͡s a
мнений	m nʲ e nʲ i j
просветлевший	p r a s vʲ i t lʲ e f ʂ i j
первые	pʲ e r v i j e
буханке	b u x a n kʲ e
светиться	s vʲ i tʲ i t͡s a
завораживать	z a v a r a ʐ i v a tʲ
епитрахилей	j i pʲ i t r a xʲ i lʲ i j
статейкой	s t a tʲ e j k a j
вмазывай	v m a z i v a j
прощанья	p r a ɕː a nʲ j a
кочевнике	k a t͡ɕ e v nʲ i kʲ e
хлебцем	x lʲ e p t͡s i m
употребляли	u p a t rʲ i b lʲ a lʲ i
хадиса	x a dʲ i s a
ощетинила	a ɕː i tʲ i nʲ i ɫ a
сочинением	s a t͡ɕ i nʲ e nʲ i j i m
приползать	p rʲ i p a ɫ z a tʲ
съедутся	s j e d u t͡s a
цесарем	t͡s e s a rʲ i m
сосною	s a s n o j u
патрульному	p a t r u lʲ n a m u
гобелене	ɡ a bʲ i lʲ e nʲ e
анусах	a n u s a x
исписывало	i s pʲ i s i v a ɫ a
бесноватыми	bʲ i s n a v a t i mʲ i
ризе	rʲ i zʲ e
террористе	t i r a rʲ i sʲ tʲ e
прислужили	p rʲ i s ɫ u ʐ i lʲ i
ослихам	a s ⁽ʲ ⁾ lʲ i x a m
артистке	a r tʲ i s t kʲ e
облюю	a b lʲ u j u
вкрадывалась	f k r a d i v a ɫ a sʲ
перетекли	pʲ i rʲ i tʲ i k lʲ i
поправишь	p a p r a vʲ i ʂ
окаю	o k a j u
резнями	rʲ i zʲ nʲ a mʲ i
подворотне	p a d v a r o tʲ nʲ e
жажда	ʐ a ʐ d a
прожидях	p r o ʐ i dʲ a x
хаяли	x a j i lʲ i
свечнике	s vʲ i t͡ɕ nʲ i kʲ e
обнажите	a b n a ʐ i tʲ e
раздвинулись	r a z d vʲ i n u lʲ i sʲ
подметайте	p a d mʲ i t a j tʲ e
скороговорка	s k a r a ɡ a v o r k a
осмотрами	a s m o t r a mʲ i
крошенный	k r o ʂ i n i j
растревоживают	r a s t rʲ i v o ʐ i v a j u t
загар	z a ɡ a r
толкалось	t a ɫ k a ɫ a sʲ
сердцебиениях	sʲ i r t͡s i bʲ i j e nʲ i j a x
обветшалый	a b vʲ i t͡ʂ ʂ a ɫ i j
трактуете	t r a k t u j i tʲ e
ненадобный	nʲ i n a d a b n i j
слёзы	s ⁽ʲ ⁾ lʲ o z i
перетягивавши	pʲ i rʲ i tʲ a ɡʲ i v a f ʂ i
ободам	o b a d a m
увезёшь	u vʲ i zʲ o ʂ
преградивший	p rʲ i ɡ r a dʲ i f ʂ i j
засвистим	z a s vʲ i sʲ tʲ i m
киноактрисой	kʲ i n a a k t rʲ i s a j
уединявшись	u j i dʲ i nʲ a f ʂ i sʲ
активизируете	a k tʲ i vʲ i zʲ i r u j i tʲ e
огонькам	a ɡ a nʲ k a m
дымили	d i mʲ i lʲ i
аккомпанировали	a k a m p a nʲ i r a v a lʲ i
бутилируют	b u tʲ i lʲ i r u j u t
владиславом	v ɫ a dʲ i s ɫ a v a m
толкнёшь	t a ɫ k nʲ o ʂ
затирая	z a tʲ i r a j a
пользованиях	p o lʲ z a v a nʲ i j a x
прапорщик	p r a p a r ɕː i k
соревнуйтесь	s a rʲ i v n u j tʲ i sʲ
фабрикую	f a b rʲ i k u j u
восприняла	v a s p rʲ i nʲ i ɫ a
похоронишь	p a x a r o nʲ i ʂ
сходна	s x o d n a
возвышенно	v a z v i ʂ i n a
автогене	a f t a ɡʲ e nʲ e
промокавший	p r a m a k a f ʂ i j
перегрелись	pʲ i rʲ i ɡ rʲ e lʲ i sʲ
подготовляйте	p a d ɡ a t a v lʲ a j tʲ e
потребностях	p a t rʲ e b n a sʲ tʲ a x
одаривая	a d a rʲ i v a j a
чугунно	t͡ɕ u ɡ u n a
отваживаемся	a t v a ʐ i v a j i m sʲ a
презумпциями	p rʲ i z u m p t͡s i j a mʲ i
расстраивался	r a s t r a i v a ɫ s ⁽ʲ ⁾ a
довлело	d a v lʲ e ɫ a
смрадишь	s m r a dʲ i ʂ
адсорбировав	a t͡s s a r bʲ i r a v a f
рефракторе	rʲ i f r a k t a rʲ e
излияниями	i z ⁽ʲ ⁾ lʲ i j a nʲ i j a mʲ i
гобеленами	ɡ a bʲ i lʲ e n a mʲ i
приглядывавшийся	p rʲ i ɡ lʲ a d i v a f ʂ i j sʲ a
эксцессов	i k s t͡s e s a f
взяточникам	v zʲ a t a t͡ɕ nʲ i k a m
потёрла	p a tʲ o r ɫ a
абстрактам	a p s t r a k t a m
сосками	s o s k a mʲ i
брёха	b rʲ o x a
поблагодарить	p a b ɫ a ɡ a d a rʲ i tʲ
жучков	ʐ u t͡ɕ k o f
осечкам	a sʲ e t͡ɕ k a m
специализмы	s pʲ i t͡s i a lʲ i z m i
сертификата	sʲ i r tʲ i fʲ i k a t a
гонореи	ɡ a n a rʲ e i
украдёшь	u k r a dʲ o ʂ
воздадите	v a z d a dʲ i tʲ e
прожигаем	p r a ʐ i ɡ a j i m
бутафорией	b u t a f o rʲ i j i j
дисциплинировала	dʲ i s t͡s i p lʲ i nʲ i r a v a ɫ a
осунется	a s u nʲ i t͡s a
виновницах	vʲ i n o v nʲ i t͡s a x
питомце	pʲ i t o m t͡s i
замяло	z a mʲ a ɫ a
порочили	p a r o t͡ɕ i lʲ i
деточка	dʲ e t a t͡ɕ k a
пересказываем	pʲ i rʲ i s k a z i v a j i m
башке	b a ʂ kʲ e
поблагодарим	p a b ɫ a ɡ a d a rʲ i m
дублёнки	d u b lʲ o n kʲ i
развернувший	r a z vʲ i r n u f ʂ i j
противоположу	p r o tʲ i v a p a ɫ a ʐ u
нюхальщики	nʲ u x a lʲ ɕː i kʲ i
озари	a z a rʲ i
отчужу	a t͡ɕ u ʐ u
буферах	b u fʲ i r a x
дотягивающийся	d a tʲ a ɡʲ i v a j u ɕː i j sʲ a
венчания	vʲ i nʲ t͡ɕ a nʲ i j a
окупленный	a k u p lʲ i n i j
построит	p a s t r o i t
уязвляя	u j i z v lʲ a j a
поговорите	p a ɡ a v a rʲ i tʲ e
царевна	t͡s a rʲ e v n a
болте	b a ɫ tʲ e
забил	z a bʲ i ɫ
люкс	lʲ u k s
сбило	z bʲ i ɫ a
чаячий	t͡ɕ a j i t͡ɕ i j
надававший	n a d a v a f ʂ i j
конку	k o n k u
усмехаясь	u s mʲ i x a j i sʲ
привязь	p rʲ i vʲ i sʲ
парадигмам	p a r a dʲ i ɡ m a m
зачёркиваем	z a t͡ɕ o r kʲ i v a j i m
сущностью	s u ɕː n a sʲ tʲ j u
подмечавший	p a d mʲ i t͡ɕ a f ʂ i j
реек	rʲ e j i k
просветишь	p r a s vʲ e tʲ i ʂ
нидерландского	nʲ i dʲ i r ɫ a n t s k a v a
поладив	p a ɫ a dʲ i f
новоангличанах	n o v a a n ɡ lʲ i t͡ɕ a n a x
пожирает	p a ʐ i r a j i t
тарифов	t a rʲ i f a f
насчёт	n a ɕː o t
распускавшись	r a s p u s k a f ʂ i sʲ
забывался	z a b i v a ɫ s ⁽ʲ ⁾ a
оклемаетесь	a k lʲ i m a j i tʲ i sʲ
провозя	p r a v a zʲ a
уделах	u dʲ e ɫ a x
вытряхивает	v i t rʲ a xʲ i v a j i t
затрудни	z a t r u dʲ nʲ i
принимавшись	p rʲ i nʲ i m a f ʂ i sʲ
прокладывающий	p r a k ɫ a d i v a j u ɕː i j
русифицируешься	r u sʲ i fʲ i t͡s i r u j i ʂ sʲ a
створу	s t v o r u
расходовали	r a s x o d a v a lʲ i
зачаровав	z a t͡ɕ i r a v a f
чемпионами	t͡ɕ i m ⁽ʲ ⁾ pʲ i o n a mʲ i
расчёсывалась	r a ɕ t͡ɕ o s i v a ɫ a sʲ
заревом	z a rʲ i v a m
неформально	nʲ i f a r m a lʲ n a
отслеживает	a t͡s s ⁽ʲ ⁾ lʲ e ʐ i v a j i t
приглядываем	p rʲ i ɡ lʲ a d i v a j i m
брюссельский	b rʲ u sʲ e lʲ s kʲ i j
роках	r o k a x
раскручивало	r a s k r u t͡ɕ i v a ɫ a
челнок	t͡ɕ i ɫ n o k
ремешкам	rʲ i mʲ i ʂ k a m
ведавший	vʲ e d a f ʂ i j
иволгою	i v a ɫ ɡ a j u
колледж	k o lʲ i t͡ʂ ʂ
проверив	p r a vʲ e rʲ i f
микросхемы	mʲ i k r a s xʲ e m i
выясняешь	v i j i sʲ nʲ a j i ʂ
надколеннике	n a t k a lʲ e nʲ i kʲ e
перекусят	pʲ i rʲ i k u sʲ a t
покрученный	p a k r u t͡ɕ i n i j
затирав	z a tʲ i r a f
перечтём	pʲ i rʲ i t͡ɕ tʲ o m
подданству	p o d a n s t v u
выливался	v i lʲ i v a ɫ s ⁽ʲ ⁾ a
порастёт	p a r a sʲ tʲ o t
провайдеры	p r a v a j d i r i
полемику	p a lʲ e mʲ i k u
переломлю	pʲ i rʲ i ɫ a m lʲ u
разъём	r a z j o m
изменяло	i z mʲ i nʲ a ɫ a
абсорбатам	a p s a r b a t a m
писателями	pʲ i s a tʲ i lʲ a mʲ i
лад	ɫ a t
ахи	a xʲ i
извлекут	i z v lʲ i k u t
взбираетесь	v z bʲ i r a j i tʲ i sʲ
фотокарточками	f a t a k a r t a t͡ɕ k a mʲ i
объедаемый	a b j i d a j i m i j
завалитесь	z a v a lʲ i tʲ i sʲ
закладывай	z a k ɫ a d i v a j
урезывав	u rʲ e z i v a f
приделать	p rʲ i dʲ e ɫ a tʲ
переставить	pʲ i rʲ i s t a vʲ i tʲ
кремниев	k rʲ e m nʲ i j i f
всовавши	f s a v a f ʂ i
цингою	t͡s i n ɡ o j u
криптонов	k rʲ i p t o n a f
гомони	ɡ a m a nʲ i
думаем	d u m a j i m
повязанный	p a vʲ a z a n i j
застрелив	z a s t rʲ i lʲ i f
апограф	a p o ɡ r a f
подсолнухе	p a t͡s s o ɫ n u xʲ e
прививай	p rʲ i vʲ i v a j
буккеры	b u kʲ i r i
юмористическая	j u m a rʲ i sʲ tʲ i t͡ɕ i s k a j a
выдворявши	v i d v a rʲ a f ʂ i
подлодке	p a d ɫ o t kʲ e
лапали	ɫ a p a lʲ i
отщепляйте	a t͡ɕ ɕː i p lʲ a j tʲ e
заведованием	z a vʲ e d a v a nʲ i j i m
смудрит	s m u d rʲ i t
здесь	zʲ dʲ e sʲ
заимейте	z a i mʲ e j tʲ e
кувшинках	k u f ʂ i n k a x
покатаешь	p a k a t a j i ʂ
подшипникам	p a t͡ʂ ʂ i p nʲ i k a m
несбыточный	nʲ i z b i t a t͡ɕ n i j
стоил	s t o i ɫ
заебать	z a j i b a tʲ
заразятся	z a r a zʲ a t͡s a
спросонок	s p r a s o n a k
заперлись	z a pʲ i r lʲ i sʲ
героинях	ɡʲ i r a i nʲ a x
мучу	m u t͡ɕ u
запираюсь	z a pʲ i r a j u sʲ
непогрешимый	nʲ i p a ɡ rʲ i ʂ i m i j
пакистанцы	p a kʲ i s t a n t͡s i
повертит	p a vʲ e r tʲ i t
епархия	j i p a r xʲ i j a
покрышка	p a k r i ʂ k a
театре	tʲ i a t a rʲ e
тучности	t u t͡ɕ n a sʲ tʲ i
спёр	s pʲ o r
вставишься	f s t a vʲ i ʂ sʲ a
выправлять	v i p r a v lʲ a tʲ
ветшаем	vʲ i t͡ʂ ʂ a j i m
надушу	n a d u ʂ u
лизнув	lʲ i z n u f
опасения	a p a sʲ e nʲ i j a
переливает	pʲ i rʲ i lʲ i v a j i t
чувствуйте	t͡ɕ u s t v u j tʲ e
осушал	a s u ʂ a ɫ
вводимся	v o dʲ i m sʲ a
секунды	sʲ i k u n d i
походом	p a x o d a m
осведомляющийся	a s vʲ i d a m lʲ a j u ɕː i j sʲ a
плюрализмам	p lʲ u r a lʲ i z m a m
звенеть	z vʲ i nʲ e tʲ
пейджер	p e j d͡ʐ ʐ i r
повалила	p a v a lʲ i ɫ a
аскетом	a s kʲ e t a m
синтеза	sʲ i n t i z a
киноплёнках	kʲ i n a p lʲ o n k a x
клетку	k lʲ e t k u
отворачиваюсь	a t v a r a t͡ɕ i v a j u sʲ
закопушкой	z a k a p u ʂ k a j
преобразовывавшийся	p rʲ i a b r a z o v i v a f ʂ i j sʲ a
отборы	a d b o r i
алкинов	a ɫ kʲ i n a f
треклистах	t r i k lʲ i s t a x
обнадёживай	a b n a dʲ o ʐ i v a j
постылевший	p a s t i lʲ i f ʂ i j
накалялась	n a k a lʲ a ɫ a sʲ
горячностей	ɡ a rʲ a t͡ɕ n a sʲ tʲ i j
отворачивай	a t v a r a t͡ɕ i v a j
симулируй	sʲ i m u lʲ i r u j
туманностях	t u m a n a sʲ tʲ a x
усложняем	u s ɫ a ʐ nʲ a j i m
разгоняете	r a z ɡ a nʲ a j i tʲ e
трансляциям	t r a n s ⁽ʲ ⁾ lʲ a t͡s i j a m
ударяемся	u d a rʲ a j i m sʲ a
осмысливаемый	a s m i s ⁽ʲ ⁾ lʲ i v a j i m i j
властолюбия	v ɫ a s t a lʲ u bʲ i j a
залепляя	z a lʲ i p lʲ a j a
волокут	v a ɫ a k u t
шаромыгой	ʂ a r a m i ɡ a j
черемшах	t͡ɕ i rʲ i m ʂ a x
остротой	a s t r o t a j
дружественен	d r u ʐ i s t vʲ i nʲ i n
ассемблера	a s e m b lʲ i r a
попросись	p a p r a sʲ i sʲ
темпераментами	tʲ i m ⁽ʲ ⁾ pʲ i r a mʲ i n t a mʲ i
утком	u t k o m
пробурчала	p r a b u r t͡ɕ a ɫ a
опробованный	a p r o b a v a n i j
потаскушки	p a t a s k u ʂ kʲ i
заискивали	z a i s kʲ i v a lʲ i
гидрологиях	ɡʲ i d r a ɫ o ɡʲ i j a x
спокойствии	s p a k o j s t vʲ i i
табличку	t a b lʲ i t͡ɕ k u
информационный	i n f a r m a t͡s i o n i j
потопталось	p a t a p t a ɫ a sʲ
интерпретированный	i n t i r p rʲ i tʲ i r a v a n i j
кусаем	k u s a j i m
насылаем	n a s i ɫ a j i m
сталкиваюсь	s t a ɫ kʲ i v a j u sʲ
накапливаем	n a k a p lʲ i v a j i m
систола	sʲ i s t a ɫ a
миньетчиком	mʲ i nʲ j e t͡ɕ i k a m
краткам	k r a t k a m
арумынкой	a r u m i n k a j
вырисовываться	v i rʲ i s o v i v a t͡s a
обидами	a bʲ i d a mʲ i
состряпаете	s a s t rʲ a p a j i tʲ e
одышка	a d i ʂ k a
тротуару	t r a t u a r u
безобразием	bʲ i z a b r a zʲ i j i m
выспрашиваемый	v i s p r a ʂ i v a j i m i j
плацента	p ɫ a t͡s e n t a
фургону	f u r ɡ o n u
выворачиваете	v i v a r a t͡ɕ i v a j i tʲ e
выражен	v i r a ʐ i n
соизволением	s a i z v a lʲ e nʲ i j i m
раздельно	r a zʲ dʲ e lʲ n a
олимпийкою	a lʲ i m ⁽ʲ ⁾ pʲ i j k a j u
сформулировал	s f a r m u lʲ i r a v a ɫ
вскинул	f s kʲ i n u ɫ
переболевала	pʲ i rʲ i b a lʲ i v a ɫ a
съязвил	s j i z vʲ i ɫ
должные	d o ɫ ʐ n i j e
вытворяешь	v i t v a rʲ a j i ʂ
поведываете	p a vʲ e d i v a j i tʲ e
пригибают	p rʲ i ɡʲ i b a j u t
сигало	sʲ i ɡ a ɫ a
опаску	a p a s k u
амбра	a m b r a
катране	k a t r a nʲ e
снашивала	s n a ʂ i v a ɫ a
смыкал	s m i k a ɫ
сигналю	sʲ i ɡ n a lʲ u
разрознивши	r a z r o zʲ nʲ i f ʂ i
заменялись	z a mʲ i nʲ a lʲ i sʲ
ухаживавши	u x a ʐ i v a f ʂ i
налегке	n a lʲ i xʲ kʲ e
жидкостями	ʐ i t k a sʲ tʲ a mʲ i
свинина	s vʲ i nʲ i n a
рисовал	rʲ i s a v a ɫ
ливийка	lʲ i vʲ i j k a
чохой	t͡ɕ i x o j
аллюзиями	a lʲ u zʲ i j a mʲ i
шумов	ʂ u m a f
хачике	x a t͡ɕ i kʲ e
текил	tʲ i kʲ i ɫ
понудит	p a n u dʲ i t
самосвалах	s a m a s v a ɫ a x
вскриков	f s k rʲ i k a f
силиконы	sʲ i lʲ i k o n i
плевав	p lʲ i v a f
тыква	t i k v a
распространяйся	r a s p r a s t r a nʲ a j sʲ a
варьируют	v a rʲ j i r u j u t
интриган	i n t rʲ i ɡ a n
просвещай	p r a s vʲ i ɕː a j
завернуть	z a vʲ i r n u tʲ
поживавший	p a ʐ i v a f ʂ i j
адсорбируя	a t͡s s a r bʲ i r u j a
оперативностью	a pʲ i r a tʲ i v n a sʲ tʲ j u
пополнять	p a p a ɫ nʲ a tʲ
врезаете	v rʲ i z a j i tʲ e
приятны	p rʲ i j a t n i
утопаем	u t o p a j i m
поели	p a j e lʲ i
манкой	m a n k a j
садит	s a dʲ i t
опушавшись	a p u ʂ a f ʂ i sʲ
антидоте	a nʲ tʲ i d o tʲ e
комбинируешь	k a m ⁽ʲ ⁾ bʲ i nʲ i r u j i ʂ
сопроводишь	s a p r a v a dʲ i ʂ
нормированиями	n a r mʲ i r a v a nʲ i j a mʲ i
кувшинку	k u f ʂ i n k u
досадовавший	d a s a d a v a f ʂ i j
орешь	o rʲ i ʂ
пригодность	p rʲ i ɡ o d n a sʲ tʲ
сыроваров	s i r a v a r a f
октябрь	a k tʲ a b rʲ
прожёвываемый	p r a ʐ o v i v a j i m i j
касайтесь	k a s a j tʲ i sʲ
женит	ʐ e nʲ i t
жёрнов	ʐ o r n a f
отпугивало	a t p u ɡʲ i v a ɫ a
файликах	f a j lʲ i k a x
изобарою	i z a b a r a j u
размежует	r a z mʲ i ʐ u j i t
опушайся	a p u ʂ a j sʲ a
баклага	b a k ɫ a ɡ a
категоричностей	k a tʲ i ɡ a rʲ i t͡ɕ n a sʲ tʲ i j
выводкам	v i v a t k a m
взвешивавши	v z vʲ e ʂ i v a f ʂ i
проиграешь	p r a i ɡ r a j i ʂ
энергоносители	i n e r ɡ a n a sʲ i tʲ i lʲ i
погрешу	p a ɡ rʲ i ʂ u
промахах	p r o m a x a x
опером	o pʲ i r a m
заела	z a j e ɫ a
котировать	k a tʲ i r a v a tʲ
неустроенностям	nʲ i u s t r o j i n a sʲ tʲ a m
подчёркивают	p a t͡ɕ o r kʲ i v a j u t
генетикам	ɡʲ i n e tʲ i k a m
каскадам	k a s k a d a m
вкладывают	f k ɫ a d i v a j u t
питону	pʲ i t o n u
искалечило	i s k a lʲ e t͡ɕ i ɫ a
неумерен	nʲ i u mʲ e rʲ i n
финансировало	fʲ i n a n ⁽ʲ ⁾ sʲ i r a v a ɫ a
общо	a p ɕː o
вампирах	v a m ⁽ʲ ⁾ pʲ i r a x
выловят	v i ɫ a vʲ a t
наноса	n a n o s a
присмотрев	p rʲ i s m a t rʲ e f
богословы	b a ɡ a s ɫ o v i
расстилавши	r a sʲ tʲ i ɫ a f ʂ i
искорёжило	i s k a rʲ o ʐ i ɫ a
отчисляем	a t͡ɕ i s ⁽ʲ ⁾ lʲ a j i m
выдачею	v i d a t͡ɕ i j u
родословными	r a d a s ɫ o v n i mʲ i
околёсицах	a k a lʲ o sʲ i t͡s a x
мораторий	m a r a t o rʲ i j
штрафовал	ʂ t r a f a v a ɫ
заутрень	z a u t rʲ i nʲ
придаваемый	p rʲ i d a v a j i m i j
сдавило	z d a vʲ i ɫ a
стремянку	s t rʲ i mʲ a n k u
времечке	v rʲ e mʲ i t͡ɕ kʲ e
понимаетесь	p a nʲ i m a j i tʲ i sʲ
присудим	p rʲ i s u dʲ i m
скорректировал	s k a rʲ i k tʲ i r a v a ɫ
искусите	i s k u sʲ i tʲ e
свергала	s vʲ i r ɡ a ɫ a
трудовой	t r u d a v o j
заблагорассудим	z a b ɫ a ɡ a r a s u dʲ i m
пожелтеем	p a ʐ i ɫ tʲ e j i m
грузимый	ɡ r u zʲ i m i j
спарывали	s p a r i v a lʲ i
востоковедам	v a s t a k a vʲ e d a m
правобережный	p r a v a bʲ i rʲ e ʐ n i j
жерлах	ʐ e r ɫ a x
бесполезный	bʲ i s p a lʲ e z n i j
выпрямлял	v i p rʲ i m lʲ a ɫ
вытряхнешь	v i t rʲ i x nʲ i ʂ
ватка	v a t k a
садку	s a t k u
заколебать	z a k a lʲ i b a tʲ
разживалась	r a ʐ i v a ɫ a sʲ
ворвитесь	v a r vʲ i tʲ i sʲ
задремлют	z a d rʲ e m lʲ u t
раскраской	r a s k r a s k a j
курский	k u r s kʲ i j
гувернантку	ɡ u vʲ i r n a n t k u
бризантностях	b rʲ i z a n t n a sʲ tʲ a x
дружила	d r u ʐ i ɫ a
контроллера	k a n t r o lʲ i r a
оканчивавшись	a k a nʲ t͡ɕ i v a f ʂ i sʲ
тупишь	t u pʲ i ʂ
библиотекарша	bʲ i b lʲ i a tʲ e k a r ʂ a
сраженью	s r a ʐ e nʲ j u
кошелях	k a ʂ i lʲ a x
вкалывая	f k a ɫ i v a j a
сливами	s ⁽ʲ ⁾ lʲ i v a mʲ i
полутьмах	p a ɫ u tʲ m a x
выдают	v i d a j u t
путаюсь	p u t a j u sʲ
совратили	s a v r a tʲ i lʲ i
мановении	m a n a vʲ e nʲ i i
матрасами	m a t r a s a mʲ i
лесоматериалам	lʲ e s a m a tʲ i rʲ i a ɫ a m
привяжу	p rʲ i vʲ i ʐ u
деспотами	dʲ e s p a t a mʲ i
пропитаниях	p r a pʲ i t a nʲ i j a x
отворяв	a t v a rʲ a f
мясорубками	mʲ i s a r u p k a mʲ i
укутавши	u k u t a f ʂ i
дынями	d i nʲ a mʲ i
мудоёба	m u d a j o b a
подстраховал	p a t͡s s t r a x a v a ɫ
обзвонит	a b z v a nʲ i t
лейкозом	lʲ i j k o z a m
установит	u s t a n o vʲ i t
совершатся	s a vʲ i r ʂ a t͡s a
десятиугольнику	dʲ i sʲ i tʲ i u ɡ o lʲ nʲ i k u
упрятав	u p rʲ a t a f
щитках	ɕː i t k a x
недоедавший	nʲ i d a j i d a f ʂ i j
запросят	z a p r o sʲ a t
лженаука	ɫ ʐ i n a u k a
вёзся	vʲ o sʲ a
одинока	a dʲ i n o k a
выдавливая	v i d a v lʲ i v a j a
котелки	k a tʲ i ɫ kʲ i
придерусь	p rʲ i dʲ i r u sʲ
типажах	tʲ i p a ʐ a x
ангстрем	a n k s t r i m
жестокий	ʐ i s t o kʲ i j
посвистывали	p a s vʲ i s t i v a lʲ i
удочерениях	u d a t͡ɕ i rʲ e nʲ i j a x
азиками	a zʲ i k a mʲ i
привинти	p rʲ i vʲ i nʲ tʲ i
синхронизаций	sʲ i n x r a nʲ i z a t͡s i j
заржаветь	z a r ʐ a vʲ i tʲ
отлежалась	a t lʲ i ʐ a ɫ a sʲ
девайсам	dʲ i v a j s a m
эликсиром	i lʲ i k sʲ i r a m
взмётываемый	v z mʲ o t i v a j i m i j
откраиваешь	a t k r a i v a j i ʂ
пионеру	pʲ i a nʲ e r u
акойт	a k o j t
дотаскав	d a t a s k a f
завершало	z a vʲ i r ʂ a ɫ a
нику	nʲ i k u
разъяряете	r a z j i rʲ a j i tʲ e
демократично	d ɪ m ɔ k r ɛ t ɪ t͡ʃ n ɔ
самобутній	s ɛ m ɔ b u tʲ nʲ i i
сатана	s ɛ t ɛ n ɑ
афганський	ɛ f ɦ ɑ nʲ sʲ k ɪ i
літ	lʲ i t
автобусна	ɛ u t ɔ b u s n ɛ
щокою	ʃ t͡ʃ ɔ k ɔ j u
оленина	ɔ ɫ ɪ n ɪ n ɛ
космодром	k ɔ s m ɔ d r ɔ m
поступку	p ɔ s t u p k u
ознайомлення	ɔ z n ɛ j ɔ m ɫ ɪ nʲ ɛ
другий	d r u ɦ ɪ i
свіча	sʲ ʋ i t͡ʃ ɛ
капітал	k ɛ p i t ɑ ɫ
ім'я	i m j ɛ
насолодитися	n ɛ s ɔ ɫ ɔ d ɪ t ɪ sʲ ɛ
чорт	t͡ʃ ɔ r t
каплиці	k ɛ p ɫ ɪ t͡sʲ i
перевиховати	p ɪ r ɪ ʋ ɪ x ɔ ʋ ɛ t ɪ
свояк	s ʋ ɔ j ɑ k
незалежности	n ɪ z ɛ ɫ ɛ ʒ n ɔ s t ɪ
досягнення	d ɔ sʲ ɑ ɦ n ɪ nʲ ɛ
ідеальний	i d ɪ ɑ lʲ n ɪ i
завдяки	z ɛ u dʲ ɛ k ɪ
тунелях	t u n ɛ lʲ ɛ x
обговорювати	ɔ b ɦ ɔ ʋ ɔ rʲ u ʋ ɛ t ɪ
лакрос	ɫ ɛ k r ɔ s
занотувати	z ɛ n ɔ t u ʋ ɑ t ɪ
епохи	ɪ p ɔ x ɪ
неприйнятний	n ɪ p r ɪ i nʲ ɛ t n ɪ i
причинний	p r ɪ t͡ʃ ɪ n ɪ i
щотижневий	ʃ t͡ʃ ɔ t ɪ ʒ n ɛ ʋ ɪ i
капітулювати	k ɛ p i t u lʲ u ʋ ɑ t ɪ
протитанковий	p r ɔ t ɪ t ɑ n k ɔ ʋ ɪ i
трактор	t r ɑ k t ɔ r
конфлікт	k ɔ n f lʲ i k t
лебединий	ɫ ɪ b ɪ d ɪ n ɪ i
пшениця	p ʃ ɪ n ɪ t͡sʲ ɛ
краб	k r ɑ b
недоступний	n ɪ d ɔ s t u p n ɪ i
роззброювати	r ɔ z b r ɔ j u ʋ ɛ t ɪ
клавіатур	k ɫ ɛ ʋ i ɛ t u r
тротуари	t r ɔ t u ɑ r ɪ
ізраїльтянин	i z r ɛ j i lʲ tʲ ɑ n ɪ n
чудовисько	t͡ʃ u d ɔ ʋ ɪ sʲ k ɔ
уста	u s t ɑ
розпочати	r ɔ z p ɔ t͡ʃ ɑ t ɪ
динаміка	d ɪ n ɑ m i k ɛ
госпіталізація	ɦ ɔ sʲ p i t ɛ lʲ i z ɑ t͡sʲ i j ɛ
африканець	ɛ f r ɪ k ɑ n ɪ t͡sʲ
повість	p ɔ ʋ i sʲ tʲ
гірський	ɦ i r sʲ k ɪ i
остаточний	ɔ s t ɛ t ɔ t͡ʃ n ɪ i
погнати	p ɔ ɦ n ɑ t ɪ
сірий	sʲ i r ɪ i
покарань	p ɔ k ɛ r ɑ nʲ
поширити	p ɔ ʃ ɪ r ɪ t ɪ
плівка	p lʲ i u k ɛ
поліціях	p ɔ lʲ i t͡sʲ i j ɛ x
потворний	p ɔ t ʋ ɔ r n ɪ i
мотоцикл	m ɔ t ɔ t͡s ɪ k ɫ
поступки	p ɔ s t u p k ɪ
позбавляти	p ɔ z b ɛ u lʲ ɑ t ɪ
виснажувати	ʋ ɪ s n ɑ ʒ u ʋ ɛ t ɪ
смертоносний	s m ɪ r t ɔ n ɔ s n ɪ i
глава	ɦ ɫ ɛ ʋ ɑ
розділ	r ɔ zʲ dʲ i ɫ
поздоровляти	p ɔ z d ɔ r ɔ u lʲ ɑ t ɪ
дорога	d ɔ r ɔ ɦ ɛ
аналізувати	ɛ n ɛ lʲ i z u ʋ ɑ t ɪ
ілюзія	i lʲ u zʲ i j ɛ
персональний	p ɪ r s ɔ n ɑ lʲ n ɪ i
коронавірус	k ɔ r ɔ n ɛ ʋ i r u s
заспокійливий	z ɛ s p ɔ k i i ɫ ɪ ʋ ɪ i
дев'яностий	d ɪ ʋ j ɛ n ɔ s t ɪ i
вступати	ʋ s t u p ɑ t ɪ
вибирати	ʋ ɪ b ɪ r ɑ t ɪ
заручати	z ɛ r u t͡ʃ ɑ t ɪ
помирати	p ɔ m ɪ r ɑ t ɪ
промовляти	p r ɔ m ɔ u lʲ ɑ t ɪ
мікроскоп	m i k r ɔ s k ɔ p
співробітник	sʲ p i u r ɔ b i t n ɪ k
номінальний	n ɔ m i n ɑ lʲ n ɪ i
прибічниця	p r ɪ b i t͡ʃ n ɪ t͡sʲ ɛ
день	d ɛ nʲ
з'ясувати	z j ɛ s u ʋ ɑ t ɪ
віртуальний	ʋ i r t u ɑ lʲ n ɪ i
пересічний	p ɪ r ɪ sʲ i t͡ʃ n ɪ i
співіснування	sʲ p i ʋ i s n u ʋ ɑ nʲ ɛ
мелодіям	m ɪ ɫ ɔ dʲ i j ɛ m
відокремити	ʋ i d ɔ k r ɛ m ɪ t ɪ
процедурний	p r ɔ t͡s ɪ d u r n ɪ i
алло	ɛ ɫ ɔ
гіпотеза	ɦ i p ɔ t ɪ z ɛ
розв'язувати	r ɔ z ʋ j ɑ z u ʋ ɛ t ɪ
ті	tʲ i
антидот	ɛ n t ɪ d ɔ t
мовознавець	m ɔ ʋ ɔ z n ɑ ʋ ɪ t͡sʲ
забобон	z ɛ b ɔ b ɔ n
оренда	ɔ r ɛ n d ɛ
етап	ɪ t ɑ p
повіки	p ɔ ʋ i k ɪ
австромарксист	ɛ u s t r ɔ m ɛ r k s ɪ s t
етика	ɛ t ɪ k ɛ
болгарин	b ɔ ɫ ɦ ɑ r ɪ n
постать	p ɔ s t ɛ tʲ
мільйон	m i lʲ j ɔ n
щі	ʃ t͡ʃʲ i
лавандовий	ɫ ɛ ʋ ɑ n d ɔ ʋ ɪ i
шведський	ʃ ʋ ɛ d͡zʲ sʲ k ɪ i
оцими	ɔ t͡s ɪ m ɪ
вчитель	ʋ t͡ʃ ɪ t ɪ lʲ
безжурний	b ɪ ʒ u r n ɪ i
хотітися	x ɔ tʲ i t ɪ sʲ ɛ
слина	s ɫ ɪ n ɛ
варіантами	ʋ ɛ rʲ i ɑ n t ɛ m ɪ
відчути	ʋ i d͡ʒ t͡ʃ u t ɪ
перлина	p ɪ r ɫ ɪ n ɛ
релігійний	r ɪ lʲ i ɦ i i n ɪ i
стать	s t ɑ tʲ
стримати	s t r ɪ m ɛ t ɪ
випроменити	ʋ ɪ p r ɔ m ɪ n ɪ t ɪ
нагромаджувати	n ɛ ɦ r ɔ m ɑ d͡ʒ u ʋ ɛ t ɪ
корінь	k ɔ rʲ i nʲ
класовий	k ɫ ɑ s ɔ ʋ ɪ i
ворота	ʋ ɔ r ɔ t ɛ
й	j
дивний	d ɪ u n ɪ i
відпочивати	ʋ i d p ɔ t͡ʃ ɪ ʋ ɑ t ɪ
жодний	ʒ ɔ d n ɪ i
змова	z m ɔ ʋ ɛ
відданий	ʋ i d ɛ n ɪ i
теплота	t ɪ p ɫ ɔ t ɑ
хрест	x r ɛ s t
овід	ɔ ʋ i d
козел	k ɔ z ɛ ɫ
борщ	b ɔ r ʃ t͡ʃ
роділля	r ɔ dʲ i lʲ ɛ
періодизаціям	p ɪ rʲ i ɔ d ɪ z ɑ t͡sʲ i j ɛ m
органічна	ɔ r ɦ ɛ nʲ i t͡ʃ n ɛ
вирізнятися	ʋ ɪ rʲ i zʲ nʲ ɑ t ɪ sʲ ɛ
дріжджі	dʲ rʲ i ʒ d͡ʒ i
крикливий	k r ɪ k ɫ ɪ ʋ ɪ i
вимикати	ʋ ɪ m ɪ k ɑ t ɪ
уособити	u ɔ s ɔ b ɪ t ɪ
видатний	ʋ ɪ d ɛ t n ɪ i
інтенсивність	i n t ɪ n s ɪ u nʲ i sʲ tʲ
тощо	t ɔ ʃ t͡ʃ ɔ
повсюдний	p ɔ u sʲ u d n ɪ i
перезаписати	p ɪ r ɪ z ɛ p ɪ s ɑ t ɪ
феє	f ɛ j ɪ
менше	m ɛ n ʃ ɪ
чарівник	t͡ʃ ɛ rʲ i u n ɪ k
зимовий	z ɪ m ɔ ʋ ɪ i
ламати	ɫ ɛ m ɑ t ɪ
зара	z ɑ r ɛ
науковий	n ɛ u k ɔ ʋ ɪ i
авіапідживлення	ɛ ʋ i ɛ p i d͡ʒ ɪ u ɫ ɪ nʲ ɛ
принизити	p r ɪ n ɪ z ɪ t ɪ
брест	b r ɛ s t
японіє	j ɛ p ɔ nʲ i j ɪ
диктатор	d ɪ k t ɑ t ɔ r
шестигранник	ʃ ɪ s t ɪ ɦ r ɑ n ɪ k
авіапасажир	ɛ ʋ i ɛ p ɛ s ɛ ʒ ɪ r
бельгійський	b ɪ lʲ ɦ i i sʲ k ɪ i
легеня	ɫ ɪ ɦ ɛ nʲ ɛ
сюди	sʲ u d ɪ
охопити	ɔ x ɔ p ɪ t ɪ
шинок	ʃ ɪ n ɔ k
трагічний	t r ɛ ɦ i t͡ʃ n ɪ i
вкус	ʋ k u s
брехнями	b r ɛ x nʲ ɛ m ɪ
високосний	ʋ ɪ s ɔ k ɔ s n ɪ i
блокадою	b ɫ ɔ k ɑ d ɔ j u
трав'яний	t r ɛ ʋ j ɛ n ɪ i
заявити	z ɛ j ɛ ʋ ɪ t ɪ
біржа	b i r ʒ ɛ
пінистий	p i n ɪ s t ɪ i
щоку	ʃ t͡ʃ ɔ k u
відважний	ʋ i d ʋ ɑ ʒ n ɪ i
бойко	b ɔ i k ɔ
технократичний	t ɪ x n ɔ k r ɛ t ɪ t͡ʃ n ɪ i
михайло	m ɪ x ɑ i ɫ ɔ
упасти	u p ɑ s t ɪ
таємницями	t ɛ j ɪ m n ɪ t͡sʲ ɛ m ɪ
компактний	k ɔ m p ɑ k t n ɪ i
епідеміологія	ɪ p i d ɪ m i ɔ ɫ ɔ ɦ i j ɛ
страх	s t r ɑ x
речі	r ɛ t͡ʃʲ i
споживчий	s p ɔ ʒ ɪ u t͡ʃ ɪ i
скаржитися	s k ɑ r ʒ ɪ t ɪ sʲ ɛ
біологія	b i ɔ ɫ ɔ ɦ i j ɛ
коханий	k ɔ x ɛ n ɪ i
водосховище	ʋ ɔ d ɔ s x ɔ ʋ ɪ ʃ t͡ʃ ɪ
атеїстичний	ɛ t ɪ j i s t ɪ t͡ʃ n ɪ i
звідкись	zʲ ʋ i d k ɪ sʲ
липа	ɫ ɪ p ɛ
стіна	sʲ tʲ i n ɑ
класти	k ɫ ɑ s t ɪ
мислити	m ɪ s ɫ ɪ t ɪ
аброгація	ɛ b r ɔ ɦ ɑ t͡sʲ i j ɛ
джгут	d͡ʒ ɦ u t
глек	ɦ ɫ ɛ k
досьє	d ɔ sʲ j ɛ
вулиця	ʋ u ɫ ɪ t͡sʲ ɛ
еволюціонувати	ɪ ʋ ɔ lʲ u t͡sʲ i ɔ n u ʋ ɑ t ɪ
цнотливий	t͡s n ɔ t ɫ ɪ ʋ ɪ i
організаціє	ɔ r ɦ ɛ nʲ i z ɑ t͡sʲ i j ɪ
добувати	d ɔ b u ʋ ɑ t ɪ
перемир'я	p ɪ r ɪ m ɪ r j ɛ
сплачувати	s p ɫ ɑ t͡ʃ u ʋ ɛ t ɪ
ресторан	r ɪ s t ɔ r ɑ n
мріями	m rʲ i j ɛ m ɪ
паузу	p ɑ u z u
емігрувати	ɪ m i ɦ r u ʋ ɑ t ɪ
наймати	n ɛ i m ɑ t ɪ
почати	p ɔ t͡ʃ ɑ t ɪ
мікрофон	m i k r ɔ f ɔ n
границя	ɦ r ɛ n ɪ t͡sʲ ɛ
бидло	b ɪ d ɫ ɔ
піраміда	p i r ɛ m i d ɛ
бере	b ɪ r ɛ
херсон	x ɪ r s ɔ n
легітимація	ɫ ɪ ɦ i t ɪ m ɑ t͡sʲ i j ɛ
рукою	r u k ɔ j u
благий	b ɫ ɛ ɦ ɪ i
позаземний	p ɔ z ɛ z ɛ m n ɪ i
бувати	b u ʋ ɑ t ɪ
рослина	r ɔ s ɫ ɪ n ɛ
дитсадків	d ɪ t͡s ɛ dʲ k i u
революція	r ɪ ʋ ɔ lʲ u t͡sʲ i j ɛ
фірма	f i r m ɛ
рейтузи	r ɪ i t u z ɪ
легеневий	ɫ ɪ ɦ ɪ n ɛ ʋ ɪ i
каштан	k ɛ ʃ t ɑ n
підвищувати	p i d ʋ ɪ ʃ t͡ʃ u ʋ ɛ t ɪ
спланувати	s p ɫ ɛ n u ʋ ɑ t ɪ
мовити	m ɔ ʋ ɪ t ɪ
турнір	t u r nʲ i r
песимістичний	p ɪ s ɪ m i s t ɪ t͡ʃ n ɪ i
церковний	t͡s ɪ r k ɔ u n ɪ i
шаповал	ʃ ɛ p ɔ ʋ ɑ ɫ
підхожий	p i d x ɔ ʒ ɪ i
переорієнтувати	p ɪ r ɪ ɔ rʲ i j ɪ n t u ʋ ɑ t ɪ
відсвяткувати	ʋ i d͡z sʲ ʋ ɛ t k u ʋ ɑ t ɪ
тригліцерид	t r ɪ ɦ lʲ i t͡s ɪ r ɪ d
безперебійний	b ɪ z p ɪ r ɪ b i i n ɪ i
пісня	p i sʲ nʲ ɛ
портфелях	p ɔ r t f ɛ lʲ ɛ x
велосипед	ʋ ɪ ɫ ɔ s ɪ p ɛ d
кончина	k ɔ n t͡ʃ ɪ n ɛ
міфологія	m i f ɔ ɫ ɔ ɦ i j ɛ
домашнє	d ɔ m ɑ ʃ nʲ ɪ
роман	r ɔ m ɑ n
патріотизмі	p ɛ tʲ rʲ i ɔ t ɪ zʲ m i
авіатраса	ɛ ʋ i ɛ t r ɑ s ɛ
порівняння	p ɔ rʲ i u nʲ ɑ nʲ ɛ
стабільний	s t ɛ b i lʲ n ɪ i
прибічник	p r ɪ b i t͡ʃ n ɪ k
відвага	ʋ i d ʋ ɑ ɦ ɛ
згодний	z ɦ ɔ d n ɪ i
герцогиня	ɦ ɪ r t͡s ɔ ɦ ɪ nʲ ɛ
акул	ɛ k u ɫ
гони	ɦ ɔ n ɪ
риба	r ɪ b ɛ
відрізнятися	ʋ i dʲ rʲ i zʲ nʲ ɑ t ɪ sʲ ɛ
навігаційний	n ɛ ʋ i ɦ ɛ t͡sʲ i i n ɪ i
рушниця	r u ʃ n ɪ t͡sʲ ɛ
афганістан	ɛ f ɦ ɛ nʲ i s t ɑ n
освіжити	ɔ sʲ ʋ i ʒ ɪ t ɪ
перевага	p ɪ r ɪ ʋ ɑ ɦ ɛ
арістотель	ɛ rʲ i s t ɔ t ɪ lʲ
квадратний	k ʋ ɛ d r ɑ t n ɪ i
вибиратися	ʋ ɪ b ɪ r ɑ t ɪ sʲ ɛ
змагатися	z m ɛ ɦ ɑ t ɪ sʲ ɛ
абсолютно	ɛ b s ɔ lʲ u t n ɔ
довоєнний	d ɔ ʋ ɔ j ɛ n ɪ i
різноманітний	rʲ i z n ɔ m ɛ nʲ i t n ɪ i
злочинець	z ɫ ɔ t͡ʃ ɪ n ɪ t͡sʲ
веретено	ʋ ɪ r ɪ t ɛ n ɔ
постійно	p ɔ sʲ tʲ i i n ɔ
брухт	b r u x t
звернення	z ʋ ɛ r n ɪ nʲ ɛ
мева	m ɛ ʋ ɛ
внаслідок	ʋ n ɑ sʲ lʲ i d ɔ k
другові	d r u ɦ ɔ ʋ i
феях	f ɛ j ɛ x
чверті	t͡ʃ ʋ ɛ r tʲ i
кишенькові	k ɪ ʃ ɪ nʲ k ɔ ʋ i
дивізіях	d ɪ ʋ i zʲ i j ɛ x
цікавий	t͡sʲ i k ɑ ʋ ɪ i
критеріям	k r ɪ t ɛ rʲ i j ɛ m
аероскопія	ɛ ɪ r ɔ s k ɔ p i j ɛ
завершення	z ɛ ʋ ɛ r ʃ ɪ nʲ ɛ
вільнодумець	ʋ i lʲ n ɔ d u m ɪ t͡sʲ
скловидний	s k ɫ ɔ ʋ ɪ d n ɪ i
довічний	d ɔ ʋ i t͡ʃ n ɪ i
нирка	n ɪ r k ɛ
ковзкий	k ɔ u z k ɪ i
доброчесний	d ɔ b r ɔ t͡ʃ ɛ s n ɪ i
обстежувати	ɔ b s t ɛ ʒ u ʋ ɛ t ɪ
танцювати	t ɛ nʲ t͡sʲ u ʋ ɑ t ɪ
опитати	ɔ p ɪ t ɑ t ɪ
ради	r ɑ d ɪ
слимак	s ɫ ɪ m ɑ k
зелен	z ɛ ɫ ɪ n
епох	ɪ p ɔ x
румунський	r u m u nʲ sʲ k ɪ i
грізний	ɦ rʲ i z n ɪ i
ситуаціях	s ɪ t u ɑ t͡sʲ i j ɛ x
безжальний	b ɪ ʒ ɑ lʲ n ɪ i
така	t ɛ k ɑ
драматургічний	d r ɛ m ɛ t u r ɦ i t͡ʃ n ɪ i
автовласник	ɛ u t ɔ u ɫ ɑ s n ɪ k
українськими	u k r ɛ j i nʲ sʲ k ɪ m ɪ
город	ɦ ɔ r ɔ d
унікальний	u nʲ i k ɑ lʲ n ɪ i
споживання	s p ɔ ʒ ɪ ʋ ɑ nʲ ɛ
посуд	p ɔ s u d
нас	n ɑ s
діафрагмами	dʲ i ɛ f r ɑ ɦ m ɛ m ɪ
критикувати	k r ɪ t ɪ k u ʋ ɑ t ɪ
болниця	b ɔ ɫ n ɪ t͡sʲ ɛ
привітати	p r ɪ ʋ i t ɑ t ɪ
ворожнеча	ʋ ɔ r ɔ ʒ n ɛ t͡ʃ ɛ
недооцінювати	n ɪ d ɔ ɔ t͡sʲ i nʲ u ʋ ɛ t ɪ
стілець	sʲ tʲ i ɫ ɛ t͡sʲ
туризм	t u r ɪ z m
албанія	ɛ ɫ b ɑ nʲ i j ɛ
глід	ɦ lʲ i d
медитація	m ɪ d ɪ t ɑ t͡sʲ i j ɛ
діафрагмі	dʲ i ɛ f r ɑ ɦ m i
засновник	z ɛ s n ɔ u n ɪ k
скло	s k ɫ ɔ
дошках	d ɔ ʃ k ɛ x
кільце	k i lʲ t͡s ɛ
ізумрудний	i z u m r u d n ɪ i
келих	k ɛ ɫ ɪ x
антибіотики	ɛ n t ɪ b i ɔ t ɪ k ɪ
сукня	s u k nʲ ɛ
кишенях	k ɪ ʃ ɛ nʲ ɛ x
радість	r ɑ dʲ i sʲ tʲ
портфеля	p ɔ r t f ɛ lʲ ɛ
можна	m ɔ ʒ n ɛ
різноманіття	rʲ i z n ɔ m ɛ nʲ i tʲ ɛ
амбіція	ɛ m b i t͡sʲ i j ɛ
родзинка	r ɔ d͡z ɪ n k ɛ
ненароджений	n ɪ n ɛ r ɔ d͡ʒ ɪ n ɪ i
щоко	ʃ t͡ʃ ɔ k ɔ
карась	k ɛ r ɑ sʲ
суспільство	s u sʲ p i lʲ s t ʋ ɔ
прати	p r ɑ t ɪ
серцевий	s ɪ r t͡s ɛ ʋ ɪ i
щавель	ʃ t͡ʃ ɛ ʋ ɛ lʲ
термометричний	t ɪ r m ɔ m ɪ t r ɪ t͡ʃ n ɪ i
для	dʲ lʲ ɑ
шовковий	ʃ ɔ u k ɔ ʋ ɪ i
склянка	s k lʲ ɑ n k ɛ
волейболістка	ʋ ɔ ɫ ɪ i b ɔ lʲ i s t k ɛ
зима	z ɪ m ɑ
змі	zʲ m i
помста	p ɔ m s t ɛ
кара	k ɑ r ɛ
пархоменко	p ɛ r x ɔ m ɪ n k ɔ
енергій	ɪ n ɛ r ɦ i i
терпеливість	t ɪ r p ɪ ɫ ɪ ʋ i sʲ tʲ
здогадуватися	z d ɔ ɦ ɑ d u ʋ ɛ t ɪ sʲ ɛ
яловичину	j ɑ ɫ ɔ ʋ ɪ t͡ʃ ɪ n u
динамічно	d ɪ n ɛ m i t͡ʃ n ɔ
ягода	j ɑ ɦ ɔ d ɛ
дієвий	dʲ i j ɛ ʋ ɪ i
вижлоктати	ʋ ɪ ʒ ɫ ɔ k t ɛ t ɪ
трагедія	t r ɛ ɦ ɛ dʲ i j ɛ
підприємство	p i d p r ɪ j ɛ m s t ʋ ɔ
теща	t ɛ ʃ t͡ʃ ɛ
дебютувати	d ɪ b u t u ʋ ɑ t ɪ
відчиняти	ʋ i d͡ʒ t͡ʃ ɪ nʲ ɑ t ɪ
упевненість	u p ɛ u n ɪ nʲ i sʲ tʲ
наявний	n ɛ j ɑ u n ɪ i
комора	k ɔ m ɔ r ɛ
подібність	p ɔ dʲ i b nʲ i sʲ tʲ
суб'єкт	s u b j ɛ k t
звідси	zʲ ʋ i d͡z s ɪ
неврологія	n ɪ u r ɔ ɫ ɔ ɦ i j ɛ
долонях	d ɔ ɫ ɔ nʲ ɛ x
мексиканка	m ɪ k s ɪ k ɑ n k ɛ
побачення	p ɔ b ɑ t͡ʃ ɪ nʲ ɛ
маскат	m ɛ s k ɑ t
обідати	ɔ b i d ɛ t ɪ
цегла	t͡s ɛ ɦ ɫ ɛ
трансформаціях	t r ɛ n s f ɔ r m ɑ t͡sʲ i j ɛ x
двадцятиоднокутник	d ʋ ɛ d͡zʲ t͡sʲ ɛ t ɪ ɔ d n ɔ k u t n ɪ k
підняти	p i dʲ nʲ ɑ t ɪ
постатях	p ɔ s t ɛ tʲ ɛ x
білий	b i ɫ ɪ i
підвіконня	p i dʲ ʋ i k ɔ nʲ ɛ
візовий	ʋ i z ɔ ʋ ɪ i
антагонізм	ɛ n t ɛ ɦ ɔ nʲ i z m
синтезувати	s ɪ n t ɪ z u ʋ ɑ t ɪ
зоровий	z ɔ r ɔ ʋ ɪ i
сприйняття	s p r ɪ i nʲ ɛ tʲ ɑ
концепт	k ɔ n t͡s ɛ p t
шанувальник	ʃ ɛ n u ʋ ɑ lʲ n ɪ k
положення	p ɔ ɫ ɔ ʒ ɪ nʲ ɛ
забороняти	z ɛ b ɔ r ɔ nʲ ɑ t ɪ
помідор	p ɔ m i d ɔ r
аборт	ɛ b ɔ r t
обчислювати	ɔ b t͡ʃ ɪ sʲ lʲ u ʋ ɛ t ɪ
галстук	ɦ ɑ ɫ s t u k
друг	d r u ɦ
скоро	s k ɔ r ɔ
акцентувати	ɛ k t͡s ɪ n t u ʋ ɑ t ɪ
частка	t͡ʃ ɑ s t k ɛ
скроні	s k r ɔ nʲ i
комедія	k ɔ m ɛ dʲ i j ɛ
позиція	p ɔ z ɪ t͡sʲ i j ɛ
міф	m i f
ліцензія	lʲ i t͡s ɛ nʲ zʲ i j ɛ
команда	k ɔ m ɑ n d ɛ
арка	ɑ r k ɛ
аероліт	ɛ ɪ r ɔ lʲ i t
приймати	p r ɪ i m ɑ t ɪ
добривечір	d ɔ b r ɪ ʋ ɛ t͡ʃʲ i r
схематизувати	s x ɪ m ɛ t ɪ z u ʋ ɑ t ɪ
колись	k ɔ ɫ ɪ sʲ
жасмин	ʒ ɛ s m ɪ n
авіаметеослужба	ɛ ʋ i ɛ m ɪ t ɪ ɔ s ɫ u ʒ b ɛ
категоричний	k ɛ t ɪ ɦ ɔ r ɪ t͡ʃ n ɪ i
гуцульщина	ɦ u t͡s u lʲ ʃ t͡ʃ ɪ n ɛ
масть	m ɑ sʲ tʲ
портативний	p ɔ r t ɛ t ɪ u n ɪ i
репресивний	r ɪ p r ɪ s ɪ u n ɪ i
просьба	p r ɔ zʲ b ɛ
убогий	u b ɔ ɦ ɪ i
безпілотний	b ɪ zʲ p i ɫ ɔ t n ɪ i
лисиця	ɫ ɪ s ɪ t͡sʲ ɛ
гладіатор	ɦ ɫ ɛ dʲ i ɑ t ɔ r
гуманістка	ɦ u m ɛ nʲ i s t k ɛ
пласт	p ɫ ɑ s t
єврейський	j ɪ u r ɛ i sʲ k ɪ i
волокти	ʋ ɔ ɫ ɔ k t ɪ
нідерланди	nʲ i d ɪ r ɫ ɑ n d ɪ
органи	ɔ r ɦ ɛ n ɪ
щитоподібна	ʃ t͡ʃ ɪ t ɔ p ɔ dʲ i b n ɛ
руку	r u k u
тісний	tʲ i s n ɪ i
журнал	ʒ u r n ɑ ɫ
ліс	lʲ i s
наблизити	n ɛ b ɫ ɪ z ɪ t ɪ
квантова	k ʋ ɑ n t ɔ ʋ ɛ
нестерпний	n ɪ s t ɛ r p n ɪ i
плавець	p ɫ ɛ ʋ ɛ t͡sʲ
виборами	ʋ ɪ b ɔ r ɛ m ɪ
неперервний	n ɪ p ɪ r ɛ r ʋ n ɪ i
тяжкий	tʲ ɛ ʒ k ɪ i
експонат	ɪ k s p ɔ n ɑ t
артеріям	ɛ r t ɛ rʲ i j ɛ m
богослов'я	b ɔ ɦ ɔ s ɫ ɔ ʋ j ɛ
парашутизм	p ɛ r ɛ ʃ u t ɪ z m
родитися	r ɔ d ɪ t ɪ sʲ ɛ
молекулярна	m ɔ ɫ ɪ k u lʲ ɑ r n ɛ
авторизувати	ɛ u t ɔ r ɪ z u ʋ ɑ t ɪ
поєднання	p ɔ j ɪ d n ɑ nʲ ɛ
листопад	ɫ ɪ s t ɔ p ɑ d
ікра	i k r ɑ
працівниці	p r ɛ t͡sʲ i u n ɪ t͡sʲ i
самоціль	s ɛ m ɔ t͡sʲ i lʲ
тренер	t r ɛ n ɪ r
болото	b ɔ ɫ ɔ t ɔ
існуючий	i s n u j u t͡ʃ ɪ i
сприятливий	s p r ɪ j ɑ t ɫ ɪ ʋ ɪ i
можливість	m ɔ ʒ ɫ ɪ ʋ i sʲ tʲ
родовий	r ɔ d ɔ ʋ ɪ i
стимул	s t ɪ m u ɫ
населити	n ɛ s ɪ ɫ ɪ t ɪ
терем	t ɛ r ɪ m
крим	k r ɪ m
аркуш	ɑ r k u ʃ
гнати	ɦ n ɑ t ɪ
вівсів	ʋ i u sʲ i u
прислівниковий	p r ɪ sʲ lʲ i u n ɪ k ɔ ʋ ɪ i
безвідсотковий	b ɪ zʲ ʋ i d͡z s ɔ t k ɔ ʋ ɪ i
навруз	n ɛ u r u z
пень	p ɛ nʲ
дзиґа	d͡z ɪ ɡ ɛ
блокадами	b ɫ ɔ k ɑ d ɛ m ɪ
гаманець	ɦ ɛ m ɛ n ɛ t͡sʲ
шведка	ʃ ʋ ɛ d k ɛ
поема	p ɔ ɛ m ɛ
чайна	t͡ʃ ɛ i n ɑ
коровай	k ɔ r ɔ ʋ ɑ i
календарем	k ɛ ɫ ɪ n d ɛ r ɛ m
орнітологія	ɔ r nʲ i t ɔ ɫ ɔ ɦ i j ɛ
різновид	rʲ i z n ɔ ʋ ɪ d
бонусом	b ɔ n u s ɔ m
досвідчений	d ɔ sʲ ʋ i d͡ʒ t͡ʃ ɪ n ɪ i
геймплей	ɦ ɪ i m p ɫ ɛ i
гривень	ɦ r ɪ ʋ ɪ nʲ
вжити	ʋ ʒ ɪ t ɪ
корчма	k ɔ r t͡ʃ m ɛ
ензим	ɪ n z ɪ m
поступці	p ɔ s t u p t͡sʲ i
морозиво	m ɔ r ɔ z ɪ ʋ ɔ
батяри	b ɛ tʲ ɑ r ɪ
благо	b ɫ ɑ ɦ ɔ
уособлювати	u ɔ s ɔ b lʲ u ʋ ɛ t ɪ
ідеалістичний	i d ɪ ɛ lʲ i s t ɪ t͡ʃ n ɪ i
пропорції	p r ɔ p ɔ r t͡sʲ i j i
промокнути	p r ɔ m ɔ k n u t ɪ
монополіст	m ɔ n ɔ p ɔ lʲ i s t
собівартість	s ɔ b i ʋ ɑ r tʲ i sʲ tʲ
швидкість	ʃ ʋ ɪ dʲ k i sʲ tʲ
слухач	s ɫ u x ɑ t͡ʃ
позбутися	p ɔ z b u t ɪ sʲ ɛ
тістечко	tʲ i s t ɪ t͡ʃ k ɔ
соня	s ɔ nʲ ɛ
нейтралітет	n ɪ i t r ɛ lʲ i t ɛ t
кіш	k i ʃ
фільтр	f i lʲ t r
текстовий	t ɪ k s t ɔ ʋ ɪ i
імперія	i m p ɛ rʲ i j ɛ
хмельницький	x m ɪ lʲ n ɪ t͡sʲ k ɪ i
фактичний	f ɛ k t ɪ t͡ʃ n ɪ i
тисяч	t ɪ sʲ ɛ t͡ʃ
відданість	ʋ i d ɛ nʲ i sʲ tʲ
пріоритет	p rʲ i ɔ r ɪ t ɛ t
маніпулювати	m ɛ nʲ i p u lʲ u ʋ ɑ t ɪ
академічний	ɛ k ɛ d ɪ m i t͡ʃ n ɪ i
гриб	ɦ r ɪ b
україною	u k r ɛ j i n ɔ j u
аґрусівка	ɛ ɡ r u sʲ i u k ɛ
супругою	s u p r u ɦ ɔ j u
аб'юрація	ɛ b j u r ɑ t͡sʲ i j ɛ
дисбаланс	d ɪ z b ɛ ɫ ɑ n s
переоцінювати	p ɪ r ɪ ɔ t͡sʲ i nʲ u ʋ ɛ t ɪ
позбавити	p ɔ z b ɑ ʋ ɪ t ɪ
гібридний	ɦ i b r ɪ d n ɪ i
душ	d u ʃ
філософія	f i ɫ ɔ s ɔ f i j ɛ
сусідка	s u sʲ i d k ɛ
першість	p ɛ r ʃ i sʲ tʲ
інтенсифікувати	i n t ɪ n s ɪ f i k u ʋ ɑ t ɪ
феміністичний	f ɪ m i nʲ i s t ɪ t͡ʃ n ɪ i
дати	d ɑ t ɪ
підмет	p i d m ɪ t
прамова	p r ɛ m ɔ ʋ ɛ
каплицею	k ɛ p ɫ ɪ t͡s ɪ j u
систематичний	s ɪ s t ɪ m ɛ t ɪ t͡ʃ n ɪ i
росіянин	r ɔ sʲ i j ɑ n ɪ n
тополі	t ɔ p ɔ lʲ i
активність	ɛ k t ɪ u nʲ i sʲ tʲ
авіасалон	ɛ ʋ i ɛ s ɛ ɫ ɔ n
даремність	d ɛ r ɛ m nʲ i sʲ tʲ
головний	ɦ ɔ ɫ ɔ u n ɪ i
спортивний	s p ɔ r t ɪ u n ɪ i
кліматичний	k lʲ i m ɛ t ɪ t͡ʃ n ɪ i
вищий	ʋ ɪ ʃ t͡ʃ ɪ i
відпочилий	ʋ i d p ɔ t͡ʃ ɪ ɫ ɪ i
чабер	t͡ʃ ɛ b ɛ r
психологічний	p s ɪ x ɔ ɫ ɔ ɦ i t͡ʃ n ɪ i
мізерний	m i z ɪ r n ɪ i
токар	t ɔ k ɛ r
угорськомовний	u ɦ ɔ r sʲ k ɔ m ɔ u n ɪ i
шоколад	ʃ ɔ k ɔ ɫ ɑ d
яма	j ɑ m ɛ
дані	d ɑ nʲ i
зовні	z ɔ u nʲ i
сумніватися	s u m nʲ i ʋ ɑ t ɪ sʲ ɛ
вітебськ	ʋ i t ɪ b sʲ k
друже	d r u ʒ ɪ
називати	n ɛ z ɪ ʋ ɑ t ɪ
концепція	k ɔ n t͡s ɛ p t͡sʲ i j ɛ
конлі	k ɔ nʲ lʲ i
рости	r ɔ s t ɪ
будда	b u d ɛ
активувати	ɛ k t ɪ ʋ u ʋ ɑ t ɪ
візантійський	ʋ i z ɛ nʲ tʲ i i sʲ k ɪ i
судно	s u d n ɔ
фразеологічний	f r ɛ z ɪ ɔ ɫ ɔ ɦ i t͡ʃ n ɪ i
артеріє	ɛ r t ɛ rʲ i j ɪ
міжвоєнний	m i ʒ ʋ ɔ j ɛ n ɪ i
зекономити	z ɪ k ɔ n ɔ m ɪ t ɪ
апатичний	ɛ p ɛ t ɪ t͡ʃ n ɪ i
дислокація	d ɪ s ɫ ɔ k ɑ t͡sʲ i j ɛ
щонайменше	ʃ t͡ʃ ɔ n ɛ i m ɛ n ʃ ɪ
куток	k u t ɔ k
несподіваний	n ɪ s p ɔ dʲ i ʋ ɛ n ɪ i
матеріальний	m ɛ t ɪ rʲ i ɑ lʲ n ɪ i
хворіти	x ʋ ɔ rʲ i t ɪ
кошуля	k ɔ ʃ u lʲ ɛ
продавати	p r ɔ d ɛ ʋ ɑ t ɪ
петиція	p ɪ t ɪ t͡sʲ i j ɛ
абластика	ɛ b ɫ ɑ s t ɪ k ɛ
авіаучилище	ɛ ʋ i ɛ u t͡ʃ ɪ ɫ ɪ ʃ t͡ʃ ɪ
довг	d ɔ u ɦ
обмеження	ɔ b m ɛ ʒ ɪ nʲ ɛ
жолудь	ʒ ɔ ɫ u dʲ
плювати	p lʲ u ʋ ɑ t ɪ
салон	s ɛ ɫ ɔ n
розуміння	r ɔ z u m i nʲ ɛ
світанок	sʲ ʋ i t ɑ n ɔ k
неформальний	n ɪ f ɔ r m ɑ lʲ n ɪ i
продавщиця	p r ɔ d ɛ u ʃ t͡ʃ ɪ t͡sʲ ɛ
трок	t r ɔ k
декларацію	d ɪ k ɫ ɛ r ɑ t͡sʲ i j u
лихоманка	ɫ ɪ x ɔ m ɑ n k ɛ
матрьошка	m ɛ tʲ rʲ ɔ ʃ k ɛ
дитсадок	d ɪ t͡s ɛ d ɔ k
симпатичний	s ɪ m p ɛ t ɪ t͡ʃ n ɪ i
повідомлення	p ɔ ʋ i d ɔ m ɫ ɪ nʲ ɛ
довгий	d ɔ u ɦ ɪ i
репродуктивний	r ɪ p r ɔ d u k t ɪ u n ɪ i
погрожувати	p ɔ ɦ r ɔ ʒ u ʋ ɛ t ɪ
батальйон	b ɛ t ɛ lʲ j ɔ n
травень	t r ɑ ʋ ɪ nʲ
напружити	n ɛ p r u ʒ ɪ t ɪ
третій	t r ɛ tʲ i i
стрічки	s tʲ rʲ i t͡ʃ k ɪ
працівниками	p r ɛ t͡sʲ i u n ɪ k ɑ m ɪ
розмова	r ɔ z m ɔ ʋ ɛ
офіра	ɔ f i r ɛ
литва	ɫ ɪ t ʋ ɑ
начиння	n ɛ t͡ʃ ɪ nʲ ɛ
слух	s ɫ u x
південь	p i u d ɪ nʲ
абразія	ɛ b r ɑ zʲ i j ɛ
цвях	t͡sʲ ʋ ɑ x
реконструкція	r ɪ k ɔ n s t r u k t͡sʲ i j ɛ
хороший	x ɔ r ɔ ʃ ɪ i
зовнішній	z ɔ u nʲ i ʃ nʲ i i
установа	u s t ɛ n ɔ ʋ ɛ
присвійний	p r ɪ sʲ ʋ i i n ɪ i
власті	ʋ ɫ ɑ sʲ tʲ i
законослухняний	z ɛ k ɔ n ɔ s ɫ u x nʲ ɑ n ɪ i
пришвидшити	p r ɪ ʃ ʋ ɪ d͡ʒ ʃ ɪ t ɪ
слівця	sʲ lʲ i u t͡sʲ ɛ
житній	ʒ ɪ tʲ nʲ i i
оточувати	ɔ t ɔ t͡ʃ u ʋ ɛ t ɪ
здатен	z d ɑ t ɪ n
негативно	n ɪ ɦ ɛ t ɪ u n ɔ
інфікування	i nʲ f i k u ʋ ɑ nʲ ɛ
теорію	t ɪ ɔ rʲ i j u
еротика	ɪ r ɔ t ɪ k ɛ
федерації	f ɪ d ɪ r ɑ t͡sʲ i j i
проблема	p r ɔ b ɫ ɛ m ɛ
брехню	b r ɪ x nʲ u
психіка	p s ɪ x i k ɛ
білок	b i ɫ ɔ k
лист	ɫ ɪ s t
австралопітек	ɛ u s t r ɛ ɫ ɔ p i t ɛ k
кайман	k ɛ i m ɑ n
ніготь	nʲ i ɦ ɔ tʲ
марія	m ɛ rʲ i j ɛ
звикнути	z ʋ ɪ k n u t ɪ
бонусами	b ɔ n u s ɛ m ɪ
конкурс	k ɔ n k u r s
птиця	p t ɪ t͡sʲ ɛ
кота	k ɔ t ɑ
могутній	m ɔ ɦ u tʲ nʲ i i
дитсадки	d ɪ t͡s ɛ d k ɪ
авіамаяк	ɛ ʋ i ɛ m ɛ j ɑ k
новини	n ɔ ʋ ɪ n ɪ
безпритульний	b ɪ z p r ɪ t u lʲ n ɪ i
скандинавія	s k ɛ n d ɪ n ɑ ʋ i j ɛ
кишенею	k ɪ ʃ ɛ n ɪ j u
жона	ʒ ɔ n ɑ
працівницям	p r ɛ t͡sʲ i u n ɪ t͡sʲ ɛ m
індустріалізувати	i n d u s tʲ rʲ i ɛ lʲ i z u ʋ ɑ t ɪ
цією	t͡sʲ i j ɛ j u
катастрофи	k ɛ t ɛ s t r ɔ f ɪ
в'язниця	ʋ j ɛ z n ɪ t͡sʲ ɛ
козирок	k ɔ z ɪ r ɔ k
дорогий	d ɔ r ɔ ɦ ɪ i
потилице	p ɔ t ɪ ɫ ɪ t͡s ɪ
грязь	ɦ rʲ ɑ zʲ
бацяр	b ɑ t͡sʲ ɛ r
абрикос	ɛ b r ɪ k ɔ s
заєць	z ɑ j ɪ t͡sʲ
школа	ʃ k ɔ ɫ ɛ
курити	k u r ɪ t ɪ
імпортувати	i m p ɔ r t u ʋ ɑ t ɪ
тисячоліттями	t ɪ sʲ ɛ t͡ʃ ɔ lʲ i tʲ ɛ m ɪ
фіскальний	f i s k ɑ lʲ n ɪ i
абсанс	ɛ b s ɑ n s
автобусик	ɛ u t ɔ b u s ɪ k
утомлений	u t ɔ m ɫ ɪ n ɪ i
ізраїльтянка	i z r ɛ j i lʲ tʲ ɑ n k ɛ
повернути	p ɔ ʋ ɪ r n u t ɪ
позичати	p ɔ z ɪ t͡ʃ ɑ t ɪ
район	r ɛ j ɔ n
більшати	b i lʲ ʃ ɛ t ɪ
заїр	z ɛ j i r
масштаб	m ɛ ʃ t ɑ b
золото	z ɔ ɫ ɔ t ɔ
феями	f ɛ j ɛ m ɪ
снідати	sʲ nʲ i d ɛ t ɪ
втручання	ʋ t r u t͡ʃ ɑ nʲ ɛ
бюрократка	b u r ɔ k r ɑ t k ɛ
трансформаціям	t r ɛ n s f ɔ r m ɑ t͡sʲ i j ɛ m
білоруський	b i ɫ ɔ r u sʲ k ɪ i
невидимий	n ɪ ʋ ɪ d ɪ m ɪ i
смак	s m ɑ k
наприкінці	n ɛ p r ɪ k i nʲ t͡sʲ i
автобіограф	ɛ u t ɔ b i ɔ ɦ r ɛ f
небога	n ɪ b ɔ ɦ ɛ
заохотити	z ɛ ɔ x ɔ t ɪ t ɪ
конфета	k ɔ n f ɛ t ɛ
логістичний	ɫ ɔ ɦ i s t ɪ t͡ʃ n ɪ i
вирішення	ʋ ɪ rʲ i ʃ ɪ nʲ ɛ
театр	t ɪ ɑ t r
кубічний	k u b i t͡ʃ n ɪ i
додатках	d ɔ d ɑ t k ɛ x
америка	ɛ m ɛ r ɪ k ɛ
ними	n ɪ m ɪ
виконання	ʋ ɪ k ɔ n ɑ nʲ ɛ
абстракція	ɛ b s t r ɑ k t͡sʲ i j ɛ
чотирикутний	t͡ʃ ɔ t ɪ r ɪ k u t n ɪ i
п'ятдесят	p j ɛ d d ɪ sʲ ɑ t
гуманістичний	ɦ u m ɛ nʲ i s t ɪ t͡ʃ n ɪ i
батьківщина	b ɛ tʲ k i u ʃ t͡ʃ ɪ n ɛ
пропорціях	p r ɔ p ɔ r t͡sʲ i j ɛ x
повечеряти	p ɔ ʋ ɪ t͡ʃ ɛ rʲ ɛ t ɪ
невідворотний	n ɪ ʋ i d ʋ ɔ r ɔ t n ɪ i
інна	i n ɛ
система	s ɪ s t ɛ m ɛ
геометричний	ɦ ɪ ɔ m ɪ t r ɪ t͡ʃ n ɪ i
забагти	z ɛ b ɑ ɦ t ɪ
гомосексуалізм	ɦ ɔ m ɔ s ɪ k s u ɛ lʲ i z m
троє	t r ɔ j ɪ
вмерти	ʋ m ɛ r t ɪ
альбатрос	ɛ lʲ b ɛ t r ɔ s
ратифікація	r ɛ t ɪ f i k ɑ t͡sʲ i j ɛ
тож	t ɔ ʒ
співпереживання	sʲ p i u p ɪ r ɪ ʒ ɪ ʋ ɑ nʲ ɛ
діагностика	dʲ i ɛ ɦ n ɔ s t ɪ k ɛ
відвернути	ʋ i d ʋ ɪ r n u t ɪ
кубинець	k u b ɪ n ɪ t͡sʲ
вимкнути	ʋ ɪ m k n u t ɪ
своєрідний	s ʋ ɔ j ɪ rʲ i d n ɪ i
пропорціям	p r ɔ p ɔ r t͡sʲ i j ɛ m
янтар	j ɛ n t ɑ r
станіслав	s t ɛ nʲ i s ɫ ɑ u
меланія	m ɪ ɫ ɑ nʲ i j ɛ
багато	b ɛ ɦ ɑ t ɔ
цитрина	t͡s ɪ t r ɪ n ɛ
розпізнавання	r ɔ zʲ p i z n ɛ ʋ ɑ nʲ ɛ
свекруха	s ʋ ɪ k r u x ɛ
тисячоліттях	t ɪ sʲ ɛ t͡ʃ ɔ lʲ i tʲ ɛ x
батько	b ɑ tʲ k ɔ
неправді	n ɪ p r ɑ u dʲ i
діаграма	dʲ i ɛ ɦ r ɑ m ɛ
дзеркало	d͡z ɛ r k ɛ ɫ ɔ
мур	m u r
молодий	m ɔ ɫ ɔ d ɪ i
візуальний	ʋ i z u ɑ lʲ n ɪ i
зоопарк	z ɔ ɔ p ɑ r k
авіапарк	ɛ ʋ i ɛ p ɑ r k
плюш	p lʲ u ʃ
п'ятниця	p j ɑ t n ɪ t͡sʲ ɛ
письменний	p ɪ sʲ m ɛ n ɪ i
українських	u k r ɛ j i nʲ sʲ k ɪ x
хліб	x lʲ i b
залежний	z ɛ ɫ ɛ ʒ n ɪ i
мовознавство	m ɔ ʋ ɔ z n ɑ u s t ʋ ɔ
участь	u t͡ʃ ɛ sʲ tʲ
сауна	s ɑ u n ɛ
місяць	m i sʲ ɛ t͡sʲ
фольклор	f ɔ lʲ k ɫ ɔ r
успішний	u sʲ p i ʃ n ɪ i
засмутити	z ɛ s m u t ɪ t ɪ
тацею	t ɑ t͡s ɪ j u
критерієм	k r ɪ t ɛ rʲ i j ɪ m
авіавиставка	ɛ ʋ i ɛ ʋ ɪ s t ɛ u k ɛ
підкреслювати	p i d k r ɛ sʲ lʲ u ʋ ɛ t ɪ
тільки	tʲ i lʲ k ɪ
возити	ʋ ɔ z ɪ t ɪ
зменшень	z m ɛ n ʃ ɪ nʲ
тріска	tʲ rʲ i s k ɛ
рішити	rʲ i ʃ ɪ t ɪ
інтуїтивно	i n t u j i t ɪ u n ɔ
хлопчик	x ɫ ɔ p t͡ʃ ɪ k
коліно	k ɔ lʲ i n ɔ
жорстокий	ʒ ɔ r s t ɔ k ɪ i
амфібія	ɛ m f i b i j ɛ
транзит	t r ɛ n z ɪ t
виявитися	ʋ ɪ j ɛ ʋ ɪ t ɪ sʲ ɛ
спростити	s p r ɔ s t ɪ t ɪ
криголам	k r ɪ ɦ ɔ ɫ ɑ m
мокнути	m ɔ k n u t ɪ
ростити	r ɔ s t ɪ t ɪ
зрости	z r ɔ s t ɪ
куди	k u d ɪ
відродження	ʋ i d r ɔ d͡ʒ ɪ nʲ ɛ
посталий	p ɔ s t ɑ ɫ ɪ i
його	j ɔ ɦ ɔ
кривавий	k r ɪ ʋ ɑ ʋ ɪ i
нескладовий	n ɪ s k ɫ ɛ d ɔ ʋ ɪ i
автодидакт	ɛ u t ɔ d ɪ d ɑ k t
їжакевич	j i ʒ ɛ k ɛ ʋ ɪ t͡ʃ
мем	m ɛ m
холандски	x o ɫ a n t s kʲ i
браташ	b r ɐ t a ʃ
овластителен	o v ɫ ɐ s t i t ɛ lʲ ɛ n
саламандър	s ɐ ɫ ɐ m a n d ɐ r
легла	lʲ ɛ ɡ ɫ a
лакът	ɫ a k ɐ t
липа	lʲ i p a
съзра	s ɐ z r ɤ
състояние	s ɐ s t o j a n i ɛ
викам	v i k ɐ m
хидроелектричен	xʲ i d r o ɛ lʲ ɛ k t r i t͡ʃ ɛ n
диона	d i ɔ n ɐ
събудя	s ɐ b u dʲ ɐ
хомосексуалистка	x ɔ m o s ɛ k s u ɐ lʲ i s k ɐ
морелетник	m o r ɛ lʲ ɛ t n i k
панпсихизъм	p ɐ n p s i xʲ i z ɐ m
абанос	ɐ b ɐ n ɔ s
кои	k o i
улица	u lʲ i t͡s ɐ
вашта	v a ʃ t ɐ
туркменистан	t u r k m ɛ n i s t a n
къжлица	k ɐ ʒ lʲ i t͡s ɐ
бида	b i d ɐ
материя	m ɐ t ɛ r i j ɐ
узаконяваха	u z ɐ k o nʲ a v ɐ x ɐ
зрян	z rʲ a n
лавка	ɫ a f k ɐ
андора	ɐ n d ɔ r ɐ
стръмнина	s t r ɐ m n i n a
работилница	r ɐ b o t i ɫ n i t͡s ɐ
съобщавам	s ɐ o p ʃ t a v ɐ m
върху	v ɐ r x u
съветвам	s ɐ v ɛ t v ɐ m
драка	d r a k ɐ
цезий	t͡s ɛ z i
начало	n ɐ t͡ʃ a ɫ o
протека	p r o t ɛ k ɤ
париж	p ɐ r i ʃ
примирам	p r i m i r ɐ m
галба	ɡ ɐ ɫ b a
щирица	ʃ t i r i t͡s ɐ
въстание	v ɐ s t a n i ɛ
художник	x u d ɔ ʒ n i k
доверчив	d o v ɛ r t͡ʃ i f
чешма	t͡ʃ ɛ ʃ m a
успех	u s p ɛ x
катерица	k a t ɛ r i t͡s ɐ
трепетлика	t r ɛ p ɛ t lʲ i k ɐ
видра	v i d r ɐ
врабче	v r ɐ p t͡ʃ ɛ
светлосянка	s v ɛ t ɫ o sʲ a n k ɐ
щастие	ʃ t a s t i ɛ
живот	ʒ i v ɔ t
проститутка	p r o s t i t u t k ɐ
крехък	k r ɛ x ɐ k
сивкав	s i f k ɐ f
модел	m o d ɛ ɫ
липък	lʲ i p ɐ k
случаен	s ɫ u t͡ʃ ɐ ɛ n
ароматен	ɐ r o m a t ɛ n
мързел	m ɤ r z ɛ ɫ
кое	k o ɛ
платя	p ɫ ɐ tʲ ɤ
цербер	t͡s ɛ r b ɛ r
печален	p ɛ t͡ʃ a lʲ ɛ n
брания	b r a n i j ɐ
първи	p ɤ r v i
зарист	z ɐ r i s t
албания	ɐ ɫ b a n i j ɐ
върша	v ɐ r ʃ a
занимая	z ɐ n i m a j ɐ
абдикиралия	ɐ b d i kʲ i r ɐ lʲ i j ɐ
ама	a m ɐ
как	k a k
декември	d ɛ kʲ ɛ m v r i
забождам	z ɐ b ɔ ʒ d ɐ m
минск	m i n s k
изпея	i s p ɛ j ɐ
стреме	s t r ɛ m ɛ
абсолютен	ɐ p s o lʲ u t ɛ n
селекционен	s ɛ lʲ ɛ k t͡s i ɔ n ɛ n
чуващ	t͡ʃ u v ɐ ʃ t
слава	s ɫ a v ɐ
смрад	s m r a t
хамбургер	x a m b u r ɡʲ ɛ r
крава	k r a v ɐ
ему	ɛ m u
мускулен	m u s k u lʲ ɛ n
ловец	ɫ o v ɛ t͡s
мръсен	m r ɤ s ɛ n
гангстер	ɡ a n k s t ɛ r
кур	k u r
мойто	m ɔ j t o
явен	j a v ɛ n
немкиня	n ɛ m kʲ i nʲ ɐ
светлана	s v ɛ t ɫ a n ɐ
опера	ɔ p ɛ r ɐ
черква	t͡ʃ ɛ r k v ɐ
околен	o k ɔ lʲ ɛ n
паткан	p ɐ t k a n
представям	p r ɛ t s t a vʲ ɐ m
холмий	x ɔ ɫ m i
какъвто	k ɐ k ɤ f t o
алка	a ɫ k ɐ
бижу	b i ʒ u
узаконили	u z ɐ k o n i lʲ i
социален	s o t͡s i a lʲ ɛ n
дъх	d ɤ x
гуждам	ɡ u ʒ d ɐ m
изслушам	i s ɫ u ʃ ɐ m
езичен	ɛ z i t͡ʃ ɛ n
вървите	v ɐ r v i t ɛ
склонен	s k ɫ ɔ n ɛ n
върволяк	v ɐ r v o lʲ a k
тъкан	t ɐ k a n
рай	r a j
панкреатит	p ɐ n k r ɛ ɐ t i t
хладък	x ɫ a d ɐ k
добре	d o b r ɛ
легален	lʲ ɛ ɡ a lʲ ɛ n
алармен	ɐ ɫ a r m ɛ n
възголям	v ɐ z ɡ o lʲ a m
кюлоти	kʲ u ɫ ɔ t i
хамбар	x ɐ m b a r
зърнест	z ɤ r n ɛ s t
нос	n ɔ s
възсин	v ɐ s s i n
побеждавам	p o b ɛ ʒ d a v ɐ m
прага	p r a ɡ ɐ
едноличен	ɛ d n o lʲ i t͡ʃ ɛ n
подпиша	p o t p i ʃ ɐ
височина	v i s o t͡ʃ i n a
наредба	n ɐ r ɛ d b ɐ
прахоляк	p r ɐ x o lʲ a k
зло	z ɫ ɔ
кожа	k ɔ ʒ ɐ
бахър	b a x ɐ r
яд	j a t
кълва	k ɐ ɫ v a
издател	i z d a t ɛ ɫ
напластяване	n ɐ p ɫ ɐ s tʲ a v ɐ n ɛ
продам	p r o d a m
членувана	t͡ʃ lʲ ɛ n u v ɐ n ɐ
изгреба	i z ɡ r ɛ b ɐ
държава	d ɐ r ʒ a v ɐ
изучаем	i z u t͡ʃ a ɛ m
кошара	k o ʃ a r ɐ
пеганка	p ɛ ɡ a n k ɐ
кожарница	k o ʒ a r n i t͡s ɐ
икона	i k ɔ n ɐ
ядяхте	j a dʲ a x t ɛ
затворен	z ɐ t v ɔ r ɛ n
свойство	s v ɔ j s t v o
абдоминалния	ɐ b d o m i n a ɫ n i j ɐ
гледам	ɡ lʲ ɛ d ɐ m
поп	p ɔ p
история	i s t ɔ r i j ɐ
повтор	p o f t ɔ r
данък	d a n ɐ k
граната	ɡ r ɐ n a t ɐ
предприемач	p r ɛ t p r i ɛ m a t͡ʃ
каца	k a t͡s ɐ
абонаментен	ɐ b o n ɐ m ɛ n t ɛ n
бекон	b ɛ k ɔ n
технеций	t ɛ x n ɛ t͡s i
кокоши	k o k ɔ ʃ i
пропаст	p r ɔ p ɐ s t
авиобомба	a v i o b ɔ m b ɐ
прекален	p r ɛ k ɐ lʲ ɛ n
кофа	k ɔ f ɐ
чия	t͡ʃ i j a
вашия	v a ʃ i j ɐ
забележа	z ɐ b ɛ lʲ ɛ ʒ ɐ
щъркел	ʃ t ɤ r kʲ ɛ ɫ
резултат	r ɛ z u ɫ t a t
неразбория	n ɛ r ɐ z b o r i j ɐ
ноември	n o ɛ m v r i
пафкам	p a f k ɐ m
миг	m i k
сияехте	s i j a ɛ x t ɛ
патица	p a t i t͡s ɐ
преда	p r ɛ d ɤ
длан	d ɫ a n
готов	ɡ ɔ t o f
блед	b lʲ ɛ t
век	v ɛ k
поилка	p o i ɫ k ɐ
досега	d o s ɛ ɡ a
ядящото	j a dʲ a ʃ t o t o
извадя	i z v a dʲ ɐ
повторим	p o f t o r i m
глупост	ɡ ɫ u p o s t
завинаги	z ɐ v i n ɐ ɡʲ i
бърне	b ɐ r n ɛ
сврачи	s v r a t͡ʃ i
хидра	xʲ i d r ɐ
завивка	z ɐ v i f k ɐ
читателка	t͡ʃ i t a t ɛ ɫ k ɐ
плен	p lʲ ɛ n
цупя	t͡s u pʲ ɐ
швейцарски	ʃ v ɛ j t͡s a r s kʲ i
гадина	ɡ ɐ d i n ɐ
девойка	d ɛ v ɔ j k ɐ
ерида	ɛ r i d ɐ
зрящ	z rʲ a ʃ t
инакво	i n a k v o
деймос	d ɛ j m o s
служа	s ɫ u ʒ ɐ
надолу	n ɐ d ɔ ɫ u
шифър	ʃ i f ɐ r
предупредя	p r ɛ d u p r ɛ dʲ ɤ
карти	k a r t i
ищай	i ʃ t a j
среда	s r ɛ d a
буляк	b u lʲ ɐ k
стоя	s t o j ɤ
възхищение	v ɐ s xʲ i ʃ t ɛ n i ɛ
яла	j a ɫ ɐ
пруст	p r u s t
волфрам	v ɔ ɫ f r ɐ m
премяна	p r ɛ mʲ a n ɐ
кавал	k ɐ v a ɫ
юрод	j u r o t
блия	b lʲ i j ɐ
рог	r ɔ k
тухла	t u x ɫ ɐ
мечок	m ɛ t͡ʃ ɔ k
нека	n ɛ k ɐ
зрител	z r i t ɛ ɫ
апологет	ɐ p o ɫ o ɡʲ ɛ t
почти	p o t͡ʃ t i
техничен	t ɛ x n i t͡ʃ ɛ n
анархия	ɐ n a r xʲ i j ɐ
свра	s v r ɤ
индий	i n d i
супермаркет	s u p ɛ r m a r kʲ ɛ t
меч	m ɛ t͡ʃ
парещ	p a r ɛ ʃ t
русалия	r u s a lʲ i j ɐ
щене	ʃ t ɛ n ɛ
зареждам	z ɐ r ɛ ʒ d ɐ m
дрозен	d r ɔ z ɛ n
тъпочовка	t ɐ p o t͡ʃ ɔ f k ɐ
отнеса	o t n ɛ s ɤ
говно	ɡ o v n ɔ
харамия	x ɐ r ɐ m i j ɐ
ваше	v a ʃ ɛ
абстрактен	ɐ p s t r a k t ɛ n
зреше	z r ɛ ʃ ɛ
творя	t v o rʲ a
спомня	s p ɔ m nʲ ɐ
панкреас	p a n k r ɛ ɐ s
дърволазка	d ɐ r v o ɫ a s k ɐ
пек	p ɛ k
чутура	t͡ʃ u t u r ɐ
дъхна	d ɤ x n ɐ
население	n ɐ s ɛ lʲ ɛ n i ɛ
сък	s ɤ k
апология	ɐ p o ɫ ɔ ɡʲ i j ɐ
тон	t ɔ n
керамика	kʲ ɛ r a m i k ɐ
билото	b i ɫ o t o
трева	t r ɛ v a
доказателство	d o k ɐ z a t ɛ ɫ s t v o
абсорбирания	ɐ p s o r b i r ɐ n i j ɐ
сладко	s ɫ a t k o
отделен	o d d ɛ lʲ ɛ n
стихия	s t i xʲ i j ɐ
чиито	t͡ʃ i i t o
пролом	p r o ɫ ɔ m
лидер	lʲ i d ɛ r
дотичам	d o t i t͡ʃ ɐ m
дигна	d i ɡ n ɐ
нет	n ɛ t
какаду	k ɐ k ɐ d u
текстилен	t ɛ k s t i lʲ ɛ n
обсъждам	o p s ɤ ʒ d ɐ m
корморан	k o r m o r a n
местност	m ɛ s n o s t
членувам	t͡ʃ lʲ ɛ n u v ɐ m
тарос	t a r o s
небеса	n ɛ b ɛ s a
анкетен	ɐ n kʲ ɛ t ɛ n
имала	i m a ɫ ɐ
внезапен	v n ɛ z a p ɛ n
конгрес	k o n ɡ r ɛ s
пепеляв	p ɛ p ɛ lʲ a f
август	a v ɡ u s t
гяур	ɡʲ ɐ u r
стърга	s t ɤ r ɡ ɐ
софийски	s o f i s kʲ i
неопределен	n ɛ o p r ɛ d ɛ lʲ ɛ n
кайгана	k ɐ j ɡ ɐ n a
швейцарка	ʃ v ɛ j t͡s a r k ɐ
заплитам	z ɐ p lʲ i t ɐ m
летя	lʲ ɛ tʲ a
зърнен	z ɤ r n ɛ n
мартеница	m a r t ɛ n i t͡s ɐ
средновековие	s r ɛ d n o v ɛ k ɔ v i ɛ
градус	ɡ r a d u s
отвор	o t v ɔ r
проклитичен	p r o k lʲ i t i t͡ʃ ɛ n
чуя	t͡ʃ u j ɐ
зрак	z r a k
мирта	m i r t ɐ
март	m a r t
напека	n ɐ p ɛ k ɤ
карам	k a r ɐ m
палав	p a ɫ ɐ f
зашивам	z ɐ ʃ i v ɐ m
шум	ʃ u m
накаже	n ɐ k a ʒ ɛ
управителен	u p r a v i t ɛ lʲ ɛ n
автобиографично	ɐ f t o b i o ɡ r ɐ f i t͡ʃ n o
лъжи	ɫ ɐ ʒ i
показвам	p o k a z v ɐ m
къртица	k ɐ r t i t͡s ɐ
южнячка	j u ʒ nʲ a t͡ʃ k ɐ
обърна	o b ɤ r n ɐ
зор	z ɔ r
град	ɡ r a t
обесвам	o b ɛ s v ɐ m
зярвам	zʲ a r v ɐ m
русе	r u s ɛ
биографичен	b i o ɡ r ɐ f i t͡ʃ ɛ n
чествам	t͡ʃ ɛ s t v ɐ m
връст	v r ɤ s t
сплав	s p ɫ a f
гургулица	ɡ u r ɡ u lʲ i t͡s ɐ
намака	n ɐ m a k ɐ
противоречив	p r o t i v o r ɛ t͡ʃ i f
куфар	k u f ɐ r
парфюм	p ɐ r fʲ u m
ден	d ɛ n
спя	s pʲ ɤ
затека	z ɐ t ɛ k ɤ
корист	k ɔ r i s t
азот	ɐ z ɔ t
театър	t ɛ a t ɐ r
гемия	ɡʲ ɛ m i j ɐ
предполагам	p r ɛ t p o ɫ a ɡ ɐ m
мишца	m i ʃ t͡s ɐ
пека	p ɛ k ɤ
инстинкт	i n s t i n k t
вестник	v ɛ s n i k
абсциса	ɐ p s t͡s i s ɐ
пигментен	p i ɡ m ɛ n t ɛ n
свалям	s v a lʲ ɐ m
ласка	ɫ a s k ɐ
кимна	kʲ i m n ɐ
пасох	p a s o x
дизя	d i zʲ ɐ
роднина	r o d n i n ɐ
пакет	p ɐ kʲ ɛ t
богиня	b o ɡʲ i nʲ ɐ
щяхме	ʃ tʲ a x m ɛ
исландски	i s ɫ a n t s kʲ i
жужел	ʒ u ʒ ɛ ɫ
феникс	f ɛ n i k s
хирургически	xʲ i r u r ɡʲ i t͡ʃ ɛ s kʲ i
имахте	i m a x t ɛ
апс	a p s
мъгла	m ɐ ɡ ɫ a
тъмница	t ɐ m n i t͡s ɐ
авлия	ɐ v lʲ i j ɐ
става	s t a v ɐ
индикативен	i n d i k ɐ t i v ɛ n
взривен	v z r i v ɛ n
лук	ɫ u k
бургас	b u r ɡ a s
нагриза	n ɐ ɡ r i z ɐ
дрехи	d r ɛ xʲ i
токачка	t o k a t͡ʃ k ɐ
моля	m ɔ lʲ ɐ
бълха	b ɐ ɫ x a
основателност	o s n o v a t ɛ ɫ n o s t
защо	z ɐ ʃ t ɔ
брегът	b r ɛ ɡ ɤ t
кубик	k u b i k
строг	s t r ɔ k
черта	t͡ʃ ɛ r t a
котка	k ɔ t k ɐ
узаконях	u z ɐ k o nʲ a x
сой	s ɔ j
юрган	j u r ɡ a n
острие	o s t r i ɛ
мрящото	m rʲ a ʃ t o t o
ледовит	lʲ ɛ d o v i t
конкретен	k o n k r ɛ t ɛ n
огромен	o ɡ r ɔ m ɛ n
махам	m a x ɐ m
разлог	r ɐ z ɫ ɔ k
арка	a r k ɐ
лава	ɫ a v ɐ
мушитрънка	m u ʃ i t r ɤ n k ɐ
дрипав	d r i p ɐ f
изтребя	i s t r ɛ bʲ ɐ
узаконяваше	u z ɐ k o nʲ a v ɐ ʃ ɛ
узаконяват	u z ɐ k o nʲ a v ɐ t
авиационен	a v i ɐ t͡s i ɔ n ɛ n
узаконените	u z ɐ k o n ɛ n i t ɛ
офис	ɔ f i s
прям	p rʲ a m
зависим	z ɐ v i s i m
пуйка	p u j k ɐ
шествие	ʃ ɛ s t v i ɛ
тръгна	t r ɐ ɡ n a
операция	o p ɛ r a t͡s i j ɐ
надонеса	n ɐ d o n ɛ s ɤ
оръдие	o r ɤ d i ɛ
продавам	p r o d a v ɐ m
безсмъртен	b ɛ s s m ɤ r t ɛ n
солен	s o lʲ ɛ n
ухапете	u x a p ɛ t ɛ
арестувахме	a r ɛ s t u v a x m ɛ
спътник	s p ɤ t n i k
долар	d ɔ ɫ ɐ r
жертва	ʒ ɛ r t v ɐ
падина	p ɐ d i n a
забранявам	z ɐ b r ɐ nʲ a v ɐ m
допринасям	d o p r i n a sʲ ɐ m
литий	lʲ i t i
градовете	ɡ r ɐ d o v ɛ t ɛ
трудно	t r u d n o
физичен	f i z i t͡ʃ ɛ n
отпущам	o t p u ʃ t ɐ m
тук	t u k
вашто	v a ʃ t o
освен	o s v ɛ n
боже	b ɔ ʒ ɛ
свитък	s v i t ɐ k
странен	s t r a n ɛ n
сквозе	s k v ɔ z ɛ
основателно	o s n o v a t ɛ ɫ n o
къделя	k ɐ d ɛ lʲ ɐ
река	r ɛ k a
у	u
съединител	s ɐ ɛ d i n i t ɛ ɫ
горест	ɡ ɔ r ɛ s t
отново	o t n ɔ v o
дворец	d v o r ɛ t͡s
чък	t͡ʃ ɤ k
боец	b o ɛ t͡s
дилянка	d i lʲ a n k ɐ
четири	t͡ʃ ɛ t i r i
затресе	z ɐ t r ɛ s ɛ
маниак	m ɐ n i a k
изковавам	i s k o v a v ɐ m
екип	ɛ kʲ i p
адет	ɐ d ɛ t
фабрика	f a b r i k ɐ
законен	z ɐ k ɔ n ɛ n
помолвам	p o m ɔ ɫ v ɐ m
бивам	b i v ɐ m
учителски	u t͡ʃ i t ɛ ɫ s kʲ i
отвес	o t v ɛ s
такава	t ɐ k a v ɐ
прозорче	p r o z ɔ r t͡ʃ ɛ
британия	b r i t a n i j ɐ
костница	k ɔ s n i t͡s ɐ
кожух	k o ʒ u x
аварски	ɐ v a r s kʲ i
бъди	b ɐ d i
пари	p a r i
книжен	k n i ʒ ɛ n
гадолиний	ɡ ɐ d o lʲ i n i
твойто	t v ɔ j t o
заема	z ɐ ɛ m ɐ
глас	ɡ ɫ a s
единица	ɛ d i n i t͡s ɐ
стилистка	s t i lʲ i s k ɐ
пате	p a t ɛ
ирландски	i r ɫ a n t s kʲ i
депонентен	d ɛ p o n ɛ n t ɛ n
тайна	t a j n ɐ
купи	k u p i
вирус	v i r u s
ламаринен	ɫ ɐ m ɐ r i n ɛ n
бележит	b ɛ lʲ ɛ ʒ i t
експедиция	ɛ k s p ɛ d i t͡s i j ɐ
любов	lʲ u b ɔ f
танц	t a n t͡s
граждански	ɡ r a ʒ d ɐ n s kʲ i
енциклопедия	ɛ n t͡s i k ɫ o p ɛ d i j ɐ
антре	ɐ n t r ɛ
шибой	ʃ i b ɔ j
почва	p o t͡ʃ v a
венера	v ɛ n ɛ r ɐ
ален	a lʲ ɛ n
авантюристически	ɐ v ɐ n tʲ u r i s t i t͡ʃ ɛ s kʲ i
свойто	s v ɔ j t o
калай	k ɐ ɫ a j
сатанински	s ɐ t ɐ n i n s kʲ i
елементарен	ɛ lʲ ɛ m ɛ n t a r ɛ n
як	j a k
прочут	p r o t͡ʃ u t
пристоен	p r i s t ɔ ɛ n
писмо	p i s m ɔ
узаконилото	u z ɐ k o n i ɫ o t o
алигатор	ɐ lʲ i ɡ a t o r
въоръжавам	v ɐ o r ɐ ʒ a v ɐ m
полуостров	p o ɫ u ɔ s t r o f
коноп	k o n ɔ p
подчертавам	p o t t͡ʃ ɛ r t a v ɐ m
пречупвам	p r ɛ t͡ʃ u p v ɐ m
лебедица	lʲ ɛ b ɛ d i t͡s ɐ
философия	f i ɫ o s ɔ f i j ɐ
полувреме	p o ɫ u v r ɛ m ɛ
кино	kʲ i n o
регистрационен	r ɛ ɡʲ i s t r ɐ t͡s i ɔ n ɛ n
любопитен	lʲ u b o p i t ɛ n
жаба	ʒ a b ɐ
родителен	r o d i t ɛ lʲ ɛ n
майтнерий	m ɐ j t n ɛ r i
игрив	i ɡ r i f
чужденец	t͡ʃ u ʒ d ɛ n ɛ t͡s
извикам	i z v i k ɐ m
отдел	o d d ɛ ɫ
жълтеникав	ʒ ɐ ɫ t ɛ n i k ɐ f
никта	n i k t ɐ
чушле	t͡ʃ u ʃ lʲ ɛ
ядящо	j a dʲ a ʃ t o
имате	i m ɐ t ɛ
монако	m o n a k o
вид	v i t
фалшив	f ɐ ɫ ʃ i f
водород	v o d o r ɔ t
лимони	lʲ i m ɔ n i
тербий	t ɛ r b i
дойда	d ɔ j d ɐ
разпределение	r ɐ s p r ɛ d ɛ lʲ ɛ n i ɛ
бруя	b r u j ɐ
бъдеш	b ɤ d ɛ ʃ
начален	n ɐ t͡ʃ a lʲ ɛ n
червеношийка	t͡ʃ ɛ r v ɛ n o ʃ i k ɐ
хокам	x ɔ k ɐ m
октомври	o k t ɔ m v r i
тигър	t i ɡ ɐ r
ватикана	v ɐ t i k a n ɐ
магаре	m ɐ ɡ a r ɛ
мир	m i r
смущение	s m u ʃ t ɛ n i ɛ
средище	s r ɛ d i ʃ t ɛ
узаконеният	u z ɐ k o n ɛ n i j ɐ t
оженя	o ʒ ɛ nʲ ɐ
българка	b ɤ ɫ ɡ ɐ r k ɐ
торба	t o r b a
за	z a
акумулатор	ɐ k u m u ɫ a t o r
мразовит	m r ɐ z o v i t
брош	b r ɔ ʃ
звънлив	z v ɐ n lʲ i f
йерарх	j ɛ r a r x
промеждутък	p r o m ɛ ʒ d u t ɐ k
фир	f i r
ладия	ɫ ɐ d i j ɐ
понапека	p o n ɐ p ɛ k ɤ
абисински	ɐ b i s i n s kʲ i
членувано	t͡ʃ lʲ ɛ n u v ɐ n o
чивия	t͡ʃ i v i j ɐ
чук	t͡ʃ u k
кукувица	k u k u v i t͡s ɐ
избия	i z b i j ɐ
мазен	m a z ɛ n
лактационен	ɫ ɐ k t ɐ t͡s i ɔ n ɛ n
мрели	m r ɛ lʲ i
случай	s ɫ u t͡ʃ a j
шоколад	ʃ o k o ɫ a t
узаконявахте	u z ɐ k o nʲ a v ɐ x t ɛ
разлат	r ɐ z ɫ a t
всякаква	f sʲ a k ɐ k v ɐ
мъжкар	m ɐ ʃ k a r
бедя	b ɛ dʲ ɤ
кон	k ɔ n
беларус	b ɛ ɫ ɐ r u s
двойствен	d v ɔ j s t v ɛ n
толкоз	t ɔ ɫ k o s
машина	m ɐ ʃ i n ɐ
дърводелец	d ɐ r v o d ɛ lʲ ɛ t͡s
мощ	m ɔ ʃ t
техни	t ɛ x n i
драгой	d r ɐ ɡ ɔ j
откриваем	o t k r i v a ɛ m
загивам	z ɐ ɡʲ i v ɐ m
съдебен	s ɐ d ɛ b ɛ n
сеизмичен	s ɛ i z m i t͡ʃ ɛ n
дайка	d a j k ɐ
вадя	v a dʲ ɐ
благоевград	b ɫ ɐ ɡ ɔ ɛ v ɡ r ɐ t
лиляк	lʲ i lʲ ɐ k
пирон	p i r ɔ n
швеция	ʃ v ɛ t͡s i j ɐ
ядящата	j a dʲ a ʃ t ɐ t ɐ
право	p r a v o
робия	r o b i j ɐ
странноприемница	s t r ɐ n n o p r i ɛ m n i t͡s ɐ
дръвце	d r ɐ f t͡s ɛ
вина	v i n a
оцветявам	o t͡s v ɛ tʲ a v ɐ m
варшава	v ɐ r ʃ a v ɐ
израстък	i z r a s t ɐ k
електронен	ɛ lʲ ɛ k t r ɔ n ɛ n
съществувам	s ɐ ʃ t ɛ s t v u v ɐ m
мренетата	m r ɛ n ɛ t ɐ t ɐ
подозра	p o d o z r ɤ
говорете	ɡ o v o r ɛ t ɛ
било	b i ɫ o
разум	r a z u m
абдоминален	ɐ b d o m i n a lʲ ɛ n
клоун	k ɫ ɔ u n
вероятно	v ɛ r o j a t n o
кадифе	k ɐ d i f ɛ
едновременен	ɛ d n o v r ɛ m ɛ n ɛ n
дреха	d r ɛ x ɐ
шугав	ʃ u ɡ ɐ f
мастит	m ɐ s t i t
тайван	t ɐ j v a n
матрак	m ɐ t r a k
раждане	r a ʒ d ɐ n ɛ
чедо	t͡ʃ ɛ d o
избоде	i z b o d ɛ
черешарка	t͡ʃ ɛ r ɛ ʃ a r k ɐ
доверие	d o v ɛ r i ɛ
архитектурен	ɐ r xʲ i t ɛ k t u r ɛ n
сияехме	s i j a ɛ x m ɛ
грънчарница	ɡ r ɐ n t͡ʃ a r n i t͡s ɐ
гълъбица	ɡ ɐ ɫ ɐ b i t͡s ɐ
ястребов	j a s t r ɛ b o f
щем	ʃ t ɛ m
напълно	n ɐ p ɤ ɫ n o
неголям	n ɛ ɡ o lʲ ɐ m
зрете	z r ɛ t ɛ
кей	kʲ ɛ j
лейди	lʲ ɛ j d i
трескав	t r ɛ s k ɐ f
иглика	i ɡ lʲ i k ɐ
поличба	p o lʲ i d͡ʒ b ɐ
бъдете	b ɐ d ɛ t ɛ
пошъл	p ɔ ʃ ɐ ɫ
изговори	i z ɡ o v o r i
носия	n o s i j ɐ
боб	b ɔ p
криеница	k r i ɛ n i t͡s ɐ
членестоного	t͡ʃ lʲ ɛ n ɛ s t o n ɔ ɡ o
хлорофил	x ɫ o r o f i ɫ
луча	ɫ u t͡ʃ ɐ
жираф	ʒ i r a f
особняк	o s o b nʲ a k
неговото	n ɛ ɡ o v o t o
единайсет	ɛ d i n a j s ɛ t
нещастие	n ɛ ʃ t a s t i ɛ
снощи	s n ɔ ʃ t i
мряхме	m rʲ a x m ɛ
ясмин	j ɐ s m i n
протоме	p r o t ɔ m ɛ
панаир	p ɐ n ɐ i r
шести	ʃ ɛ s t i
струга	s t r u ɡ ɐ
често	t͡ʃ ɛ s t o
волан	v o ɫ a n
срака	s r a k ɐ
работничка	r ɐ b ɔ t n i t͡ʃ k ɐ
ваште	v a ʃ t ɛ
школа	ʃ k ɔ ɫ ɐ
въвра	v ɐ v r ɤ
бог	b ɔ k
тези	t ɛ z i
къртичи	k ɐ r t i t͡ʃ i
пасохме	p a s o x m ɛ
принц	p r i n t͡s
съчетавам	s ɐ t͡ʃ ɛ t a v ɐ m
равен	r a v ɛ n
нейни	n ɛ j n i
дори	d o r i
прощален	p r o ʃ t a lʲ ɛ n
оцет	o t͡s ɛ t
храм	x r a m
джийн	d ʒ i n
шептя	ʃ ɛ p tʲ ɤ
стилов	s t i ɫ o f
рухо	r u x o
управителка	u p r a v i t ɛ ɫ k ɐ
разшифровам	r ɐ ʃ ʃ i f r ɔ v ɐ m
киноцентър	kʲ i n o t͡s ɛ n t ɐ r
телефон	t ɛ lʲ ɛ f ɔ n
пасящия	p ɐ sʲ a ʃ t i j ɐ
чукундур	t͡ʃ u k u n d u r
оберон	ɔ b ɛ r o n
запреда	z ɐ p r ɛ d ɤ
татко	t a t k o
плавей	p ɫ a v ɛ j
канара	k ɐ n ɐ r a
ганимед	ɡ ɐ n i m ɛ t
къщо	k ɤ ʃ t o
коля	k ɔ lʲ ɐ
хулиганство	x u lʲ i ɡ a n s t v o
собол	s o b ɔ ɫ
деспотизъм	d ɛ s p o t i z ɐ m
движа	d v i ʒ ɐ
би	b i
отличим	o t lʲ i t͡ʃ i m
доя	d o j ɤ
дециметър	d ɛ t͡s i m ɛ t ɐ r
акушерка	ɐ k u ʃ ɛ r k ɐ
злъч	z ɫ ɤ t͡ʃ
долина	d o lʲ i n a
загреб	z a ɡ r ɛ p
рунтав	r u n t ɐ f
радвам	r a d v ɐ m
тоалет	t o ɐ lʲ ɛ t
превъзхождам	p r ɛ v ɐ s x ɔ ʒ d ɐ m
атентат	ɐ t ɛ n t a t
гълъб	ɡ ɤ ɫ ɐ p
гостилница	ɡ o s t i ɫ n i t͡s ɐ
изгубя	i z ɡ u bʲ ɐ
преперец	p r ɛ p ɛ r ɛ t͡s
панталон	p ɐ n t ɐ ɫ ɔ n
серен	s ɛ r ɛ n
вегав	v ɛ ɡ ɐ f
бодил	b o d i ɫ
плащ	p ɫ a ʃ t
лютив	lʲ u t i f
определен	o p r ɛ d ɛ lʲ ɛ n
плащам	p ɫ a ʃ t ɐ m
саксия	s ɐ k s i j ɐ
пищен	p i ʃ t ɛ n
озаглавя	o z ɐ ɡ ɫ ɐ vʲ ɤ
невъзможно	n ɛ v ɐ z m ɔ ʒ n o
бастилия	b ɐ s t i lʲ i j ɐ
узаконяването	u z ɐ k o nʲ a v ɐ n ɛ t o
щедър	ʃ t ɛ d ɐ r
огорча	o ɡ o r t͡ʃ a
много	m n ɔ ɡ o
бразилия	b r ɐ z i lʲ i j ɐ
ярък	j a r ɐ k
клюн	k lʲ u n
абдикиралата	ɐ b d i kʲ i r ɐ ɫ ɐ t ɐ
мях	mʲ a x
извиквам	i z v i k v ɐ m
апсида	ɐ p s i d ɐ
напредък	n ɐ p r ɛ d ɐ k
култура	k u ɫ t u r ɐ
братски	b r a t s kʲ i
азе	a z ɛ
зърна	z ɤ r n ɐ
годинак	ɡ o d i n a k
раждам	r a ʒ d ɐ m
глух	ɡ ɫ u x
лют	lʲ u t
очен	ɔ t͡ʃ ɛ n
фикус	f i k u s
парк	p a r k
посетител	p o s ɛ t i t ɛ ɫ
мегаметър	m ɛ ɡ ɐ m ɛ t ɐ r
сценарий	s t͡s ɛ n a r i
камшик	k ɐ m ʃ i k
вашето	v a ʃ ɛ t o
смрадливец	s m r ɐ d lʲ i v ɛ t͡s
университет	u n i v ɛ r s i t ɛ t
матерен	m a t ɛ r ɛ n
краен	k r a ɛ n
нар	n a r
картал	k ɐ r t a ɫ
дрозд	d r ɔ s t
петрол	p ɛ t r ɔ ɫ
пасене	p ɐ s ɛ n ɛ
извличам	i z v lʲ i t͡ʃ ɐ m
ищах	i ʃ t a x
колибри	k o lʲ i b r i
русло	r u s ɫ o
редя	r ɛ dʲ a
институт	i n s t i t u t
труден	t r u d ɛ n
кралски	k r a ɫ s kʲ i
ексалитър	ɐ t o lʲ i t ɐ r
гнилоч	ɡ n i ɫ ɔ t͡ʃ
двуличен	d v u lʲ i t͡ʃ ɛ n
сърбин	s ɤ r b i n
трици	t r i t͡s i
миризма	m i r i z m a
деепричастие	d ɛ ɛ p r i t͡ʃ a s t i ɛ
прегиня	p r ɛ ɡʲ i nʲ ɐ
щяла	ʃ tʲ a ɫ ɐ
мамут	m ɐ m u t
узаконят	u z ɐ k o nʲ ɤ t
леко	lʲ ɛ k o
пръчица	p r ɤ t͡ʃ i t͡s ɐ
гигантски	ɡʲ i ɡ a n t s kʲ i
дума	d u m ɐ
изток	i s t o k
усмихвам	u s m i x v ɐ m
благословия	b ɫ ɐ ɡ o s ɫ o v i j ɐ
сви	s v i
германски	ɡʲ ɛ r m a n s kʲ i
гибел	ɡʲ i b ɛ ɫ
багър	b a ɡ ɐ r
безплатен	b ɛ s p ɫ a t ɛ n
корона	k o r ɔ n ɐ
аерометър	a ɛ r o m ɛ t ɐ r
суровина	s u r o v i n a
