აგდებს	ɑ ɡ d ɛ b s
აგენტის	ɑ ɡ ɛ n tʼ i s
აგრესიულობა	ɑ ɡ r ɛ s i u l ɔ b ɑ
ადამიანს	ɑ d ɑ m i ɑ n s
ადამიანური	ɑ d ɑ m i ɑ n u r i
ადაპტაცია	ɑ d ɑ pʼ tʼ ɑ t͡s i ɑ
ავადმყოფობა	ɑ v ɑ d m qʼ ɔ pʰ ɔ b ɑ
ავადმყოფობს	ɑ v ɑ d m qʼ ɔ pʰ ɔ b s
ავალდებულებს	ɑ v ɑ l d ɛ b u l ɛ b s
ავსტრია	ɑ v s tʼ r i ɑ
ავტოკოლონა	ɑ v tʼ ɔ kʼ ɔ l ɔ n ɑ
ავტომატური	ɑ v tʼ ɔ m ɑ tʼ u r i
ავღანეთი	ɑ v ɣ ɑ n ɛ tʰ i
აზრი	ɑ z r i
აზრის	ɑ z r i s
აზღუდი	ɑ z ɣ u d i
ათბობს	ɑ tʰ b ɔ b s
ათენი	ɑ tʰ ɛ n i
აკრძალვითად	ɑ kʼ r d͡z ɑ l v i tʰ ɑ d
აკუსტიკური	ɑ kʼ u s tʼ i kʼ u r i
ალექსანდრე	ɑ l ɛ kʰ s ɑ n d r ɛ
ამაო	ɑ m ɑ ɔ
ამერიკელი	ɑ m ɛ r i kʼ ɛ l i
ამთავრებს	ɑ m tʰ ɑ v r ɛ b s
ამინდი	ɑ m i n d i
ამნისტია	ɑ m n i s tʼ i ɑ
ამომწურავად	ɑ m ɔ m t͡sʼ u r ɑ v ɑ d
ანაბარი	ɑ n ɑ b ɑ r i
ანბანი	ɑ n b ɑ n i
ანომალურად	ɑ n ɔ m ɑ l u r ɑ d
აპარატის	ɑ pʼ ɑ r ɑ tʼ i s
აპოკალიფსური	ɑ pʼ ɔ kʼ ɑ l i pʰ s u r i
აპრილმა	ɑ pʼ r i l m ɑ
არაბიძე	ɑ r ɑ b i d͡z ɛ
არაბუნებრივი	ɑ r ɑ b u n ɛ b r i v i
არაზუსტი	ɑ r ɑ z u s tʼ i
არათანაბარი	ɑ r ɑ tʰ ɑ n ɑ b ɑ r i
არაპროფესიონალური	ɑ r ɑ pʼ r ɔ pʰ ɛ s i ɔ n ɑ l u r i
არასწორი	ɑ r ɑ s t͡sʼ ɔ r i
არგენტინა	ɑ r ɡ ɛ n tʼ i n ɑ
არგუმენტაცია	ɑ r ɡ u m ɛ n tʼ ɑ t͡s i ɑ
არდი	ɑ r d i
არის	ɑ r i s
არნახული	ɑ r n ɑ x u l i
არსენალი	ɑ r s ɛ n ɑ l i
არსით	ɑ r s i tʰ
არტისტული	ɑ r tʼ i s tʼ u l i
არქიტექტურულად	ɑ r kʰ i tʼ ɛ kʰ tʼ u r u l ɑ d
არყოფნა	ɑ r qʼ ɔ pʰ n ɑ
არცერთი	ɑ r t͡s ɛ r tʰ i
არხი	ɑ r x i
ასწლიანი	ɑ s t͡sʼ l i ɑ n i
ატენიანებს	ɑ tʼ ɛ n i ɑ n ɛ b s
აუდიტი	ɑ u d i tʼ i
აქანე	ɑ kʰ ɑ n ɛ
აქეთ	ɑ kʰ ɛ tʰ
აქტიურად	ɑ kʰ tʼ i u r ɑ d
აღბეჭდილი	ɑ ɣ b ɛ t͡ʃʼ d i l i
აღგზნებული	ɑ ɣ ɡ z n ɛ b u l i
აღმოაჩინე	ɑ ɣ m ɔ ɑ t͡ʃ i n ɛ
აღნიშნავს	ɑ ɣ n i ʃ n ɑ v s
აღწერა	ɑ ɣ t͡sʼ ɛ r ɑ
აღწერით	ɑ ɣ t͡sʼ ɛ r i tʰ
აყრუებს	ɑ qʼ r u ɛ b s
აცდენილი	ɑ t͡s d ɛ n i l i
აცხობს	ɑ t͡s x ɔ b s
აწყვეტინებს	ɑ t͡sʼ qʼ v ɛ tʼ i n ɛ b s
ახალგაზრდა	ɑ x ɑ l ɡ ɑ z r d ɑ
ახარისხებს	ɑ x ɑ r i s x ɛ b s
აჯიკა	ɑ d͡ʒ i kʼ ɑ
ბადმინტონი	b ɑ d m i n tʼ ɔ n i
ბაზელი	b ɑ z ɛ l i
ბაირამი	b ɑ i r ɑ m i
ბანკირი	b ɑ n kʼ i r i
ბარდი	b ɑ r d i
ბარიკადა	b ɑ r i kʼ ɑ d ɑ
ბარსელონა	b ɑ r s ɛ l ɔ n ɑ
ბასკი	b ɑ s kʼ i
ბატარეა	b ɑ tʼ ɑ r ɛ ɑ
ბეგი	b ɛ ɡ i
ბელა	b ɛ l ɑ
ბერძნული	b ɛ r d͡z n u l i
ბეწვი	b ɛ t͡sʼ v i
ბინა	b i n ɑ
ბიურო	b i u r ɔ
ბიჭი	b i t͡ʃʼ i
ბომბავს	b ɔ m b ɑ v s
ბორკილი	b ɔ r kʼ i l i
ბორტზე	b ɔ r tʼ z ɛ
ბრძენი	b r d͡z ɛ n i
ბრძოლა	b r d͡z ɔ l ɑ
ბრძოლამ	b r d͡z ɔ l ɑ m
ბურდღა	b u r d ɣ ɑ
ბუქსირი	b u kʰ s i r i
გააგრძელებს	ɡ ɑ ɑ ɡ r d͡z ɛ l ɛ b s
გაამდიდრებს	ɡ ɑ ɑ m d i d r ɛ b s
გაზქურა	ɡ ɑ z kʰ u r ɑ
გამოადგება	ɡ ɑ m ɔ ɑ d ɡ ɛ b ɑ
გამოითქმის	ɡ ɑ m ɔ i tʰ kʰ m i s
გამომდინარე	ɡ ɑ m ɔ m d i n ɑ r ɛ
გამონაყარი	ɡ ɑ m ɔ n ɑ qʼ ɑ r i
გამოსასყიდი	ɡ ɑ m ɔ s ɑ s qʼ i d i
გამოსაცდელი	ɡ ɑ m ɔ s ɑ t͡s d ɛ l i
გამოსყიდვა	ɡ ɑ m ɔ s qʼ i d v ɑ
გამოცდილი	ɡ ɑ m ɔ t͡s d i l i
გამძლეობა	ɡ ɑ m d͡z l ɛ ɔ b ɑ
განათლების	ɡ ɑ n ɑ tʰ l ɛ b i s
განაჩენი	ɡ ɑ n ɑ t͡ʃ ɛ n i
განგაში	ɡ ɑ n ɡ ɑ ʃ i
განსახლება	ɡ ɑ n s ɑ x l ɛ b ɑ
განხილვა	ɡ ɑ n x i l v ɑ
განხორციელება	ɡ ɑ n x ɔ r t͡s i ɛ l ɛ b ɑ
გარდერობი	ɡ ɑ r d ɛ r ɔ b i
გასასვლელი	ɡ ɑ s ɑ s v l ɛ l i
გასვლა	ɡ ɑ s v l ɑ
გასწორება	ɡ ɑ s t͡sʼ ɔ r ɛ b ɑ
გაუშვებს	ɡ ɑ u ʃ v ɛ b s
გაქრობა	ɡ ɑ kʰ r ɔ b ɑ
გაშორდა	ɡ ɑ ʃ ɔ r d ɑ
გაძლევთ	ɡ ɑ d͡z l ɛ v tʰ
გედი	ɡ ɛ d i
გვანცა	ɡ v ɑ n t͡s ɑ
გვწყურია	ɡ v t͡sʼ qʼ u r i ɑ
გზა	ɡ z ɑ
გინდა	ɡ i n d ɑ
გმირობა	ɡ m i r ɔ b ɑ
გოგირდი	ɡ ɔ ɡ i r d i
გოგრა	ɡ ɔ ɡ r ɑ
გოიმი	ɡ ɔ i m i
გოლგოთა	ɡ ɔ l ɡ ɔ tʰ ɑ
გონიო	ɡ ɔ n i ɔ
გრძელი	ɡ r d͡z ɛ l i
გრძნობთ	ɡ r d͡z n ɔ b tʰ
გულუხვად	ɡ u l u x v ɑ d
გულწრფელად	ɡ u l t͡sʼ r pʰ ɛ l ɑ d
გულწრფელობა	ɡ u l t͡sʼ r pʰ ɛ l ɔ b ɑ
გურიად	ɡ u r i ɑ d
დაბლობი	d ɑ b l ɔ b i
დაბნელება	d ɑ b n ɛ l ɛ b ɑ
დაგეზარებათ	d ɑ ɡ ɛ z ɑ r ɛ b ɑ tʰ
დაეთმო	d ɑ ɛ tʰ m ɔ
დავა	d ɑ v ɑ
დავიწყეთ	d ɑ v i t͡sʼ qʼ ɛ tʰ
დაზგა	d ɑ z ɡ ɑ
დათმობა	d ɑ tʰ m ɔ b ɑ
დაინახავს	d ɑ i n ɑ x ɑ v s
დაისი	d ɑ i s i
დაკვირვებული	d ɑ kʼ v i r v ɛ b u l i
დალია	d ɑ l i ɑ
დამაკმაყოფილებლად	d ɑ m ɑ kʼ m ɑ qʼ ɔ pʰ i l ɛ b l ɑ d
დამიჭერია	d ɑ m i t͡ʃʼ ɛ r i ɑ
დამოუკიდებელი	d ɑ m ɔ u kʼ i d ɛ b ɛ l i
დასასრული	d ɑ s ɑ s r u l i
დასვენება	d ɑ s v ɛ n ɛ b ɑ
დასკვნითი	d ɑ s kʼ v n i tʰ i
დაუბრუნდება	d ɑ u b r u n d ɛ b ɑ
დაუთმობს	d ɑ u tʰ m ɔ b s
დაუსჯელად	d ɑ u s d͡ʒ ɛ l ɑ d
დაუფლება	d ɑ u pʰ l ɛ b ɑ
დაქირავებული	d ɑ kʰ i r ɑ v ɛ b u l i
დაძაბულობა	d ɑ d͡z ɑ b u l ɔ b ɑ
დაწესებულება	d ɑ t͡sʼ ɛ s ɛ b u l ɛ b ɑ
დევნება	d ɛ v n ɛ b ɑ
დეზინფექცია	d ɛ z i n pʰ ɛ kʰ t͡s i ɑ
დეკორაცია	d ɛ kʼ ɔ r ɑ t͡s i ɑ
დელფინი	d ɛ l pʰ i n i
დემაგოგია	d ɛ m ɑ ɡ ɔ ɡ i ɑ
დემოგრაფია	d ɛ m ɔ ɡ r ɑ pʰ i ɑ
დერეფანი	d ɛ r ɛ pʰ ɑ n i
დესერტი	d ɛ s ɛ r tʼ i
დესპოტიზმი	d ɛ s pʼ ɔ tʼ i z m i
დიაგონალი	d i ɑ ɡ ɔ n ɑ l i
დიეზი	d i ɛ z i
დივიდენდი	d i v i d ɛ n d i
დინი	d i n i
დისერტაცია	d i s ɛ r tʼ ɑ t͡s i ɑ
დისკი	d i s kʼ i
დისკრეტული	d i s kʼ r ɛ tʼ u l i
დიქტორი	d i kʰ tʼ ɔ r i
დოკუმენტური	d ɔ kʼ u m ɛ n tʼ u r i
დოყლაპია	d ɔ qʼ l ɑ pʼ i ɑ
დრაკონი	d r ɑ kʼ ɔ n i
დროდ	d r ɔ d
დრომოჭმული	d r ɔ m ɔ t͡ʃʼ m u l i
დროშა	d r ɔ ʃ ɑ
ეგზემა	ɛ ɡ z ɛ m ɑ
ევა	ɛ v ɑ
ევგენი	ɛ v ɡ ɛ n i
ევოლუციური	ɛ v ɔ l u t͡s i u r i
ეთიოპიელი	ɛ tʰ i ɔ pʼ i ɛ l i
ეთნიკურად	ɛ tʰ n i kʼ u r ɑ d
ეთნიკური	ɛ tʰ n i kʼ u r i
ეკატერინე	ɛ kʼ ɑ tʼ ɛ r i n ɛ
ეკოლოგიური	ɛ kʼ ɔ l ɔ ɡ i u r i
ეკონომიური	ɛ kʼ ɔ n ɔ m i u r i
ელემენტარულად	ɛ l ɛ m ɛ n tʼ ɑ r u l ɑ d
ელექტორატი	ɛ l ɛ kʰ tʼ ɔ r ɑ tʼ i
ელჩი	ɛ l t͡ʃ i
ემილი	ɛ m i l i
ერაყი	ɛ r ɑ qʼ i
ერთდროული	ɛ r tʰ d r ɔ u l i
ერთხელ	ɛ r tʰ x ɛ l
ერიკი	ɛ r i kʼ i
ესკორტი	ɛ s kʼ ɔ r tʼ i
ესპანეთი	ɛ s pʼ ɑ n ɛ tʰ i
ექსპერიმენტულად	ɛ kʰ s pʼ ɛ r i m ɛ n tʼ u l ɑ d
ექსტაზი	ɛ kʰ s tʼ ɑ z i
ვარდანიძე	v ɑ r d ɑ n i d͡z ɛ
ვარდისფერი	v ɑ r d i s pʰ ɛ r i
ვარშავა	v ɑ r ʃ ɑ v ɑ
ვატერლოო	v ɑ tʼ ɛ r l ɔ ɔ
ვაფლი	v ɑ pʰ l i
ვაქცინაცია	v ɑ kʰ t͡s i n ɑ t͡s i ɑ
ვახ	v ɑ x
ველურობა	v ɛ l u r ɔ b ɑ
ვერტმფრენი	v ɛ r tʼ m pʰ r ɛ n i
ვერცხლის	v ɛ r t͡s x l i s
ვთქვა	v tʰ kʰ v ɑ
ვიბრატორი	v i b r ɑ tʼ ɔ r i
ვიზიტი	v i z i tʼ i
ვიზუალური	v i z u ɑ l u r i
ვნებიანად	v n ɛ b i ɑ n ɑ d
ზანგურაშვილი	z ɑ n ɡ u r ɑ ʃ v i l i
ზეგანაკვეთურად	z ɛ ɡ ɑ n ɑ kʼ v ɛ tʰ u r ɑ d
ზეპირი	z ɛ pʼ i r i
ზერელედ	z ɛ r ɛ l ɛ d
ზომიერება	z ɔ m i ɛ r ɛ b ɑ
ზღაპარი	z ɣ ɑ pʼ ɑ r i
თავისებურება	tʰ ɑ v i s ɛ b u r ɛ b ɑ
თავისთვის	tʰ ɑ v i s tʰ v i s
თავისი	tʰ ɑ v i s i
თამაში	tʰ ɑ m ɑ ʃ i
თანაგრძნობა	tʰ ɑ n ɑ ɡ r d͡z n ɔ b ɑ
თანამედროვე	tʰ ɑ n ɑ m ɛ d r ɔ v ɛ
თანამედროვედ	tʰ ɑ n ɑ m ɛ d r ɔ v ɛ d
თანამემამულე	tʰ ɑ n ɑ m ɛ m ɑ m u l ɛ
თანასწორობა	tʰ ɑ n ɑ s t͡sʼ ɔ r ɔ b ɑ
თანაშემწე	tʰ ɑ n ɑ ʃ ɛ m t͡sʼ ɛ
თანდათან	tʰ ɑ n d ɑ tʰ ɑ n
თაობა	tʰ ɑ ɔ b ɑ
თარგი	tʰ ɑ r ɡ i
თაყვანისცემა	tʰ ɑ qʼ v ɑ n i s t͡s ɛ m ɑ
თევზები	tʰ ɛ v z ɛ b i
თერმომეტრი	tʰ ɛ r m ɔ m ɛ tʼ r i
თვითმარქვია	tʰ v i tʰ m ɑ r kʰ v i ɑ
თვითმფრინავი	tʰ v i tʰ m pʰ r i n ɑ v i
თვითნებურად	tʰ v i tʰ n ɛ b u r ɑ d
თოკი	tʰ ɔ kʼ i
თურქეთს	tʰ u r kʰ ɛ tʰ s
თხილი	tʰ x i l i
იაპონიით	i ɑ pʼ ɔ n i i tʰ
იგავი	i ɡ ɑ v i
იგებს	i ɡ ɛ b s
იდენტური	i d ɛ n tʼ u r i
იდეოლოგიურად	i d ɛ ɔ l ɔ ɡ i u r ɑ d
იდუმალი	i d u m ɑ l i
იზოლაცია	i z ɔ l ɑ t͡s i ɑ
იმამი	i m ɑ m i
იმპროვიზაცია	i m pʼ r ɔ v i z ɑ t͡s i ɑ
ინდაური	i n d ɑ u r i
ინდექსი	i n d ɛ kʰ s i
ინდონეზიური	i n d ɔ n ɛ z i u r i
ინდური	i n d u r i
ინერტული	i n ɛ r tʼ u l i
ინვენტარი	i n v ɛ n tʼ ɑ r i
ინკვიზიცია	i n kʼ v i z i t͡s i ɑ
ინსტინქტური	i n s tʼ i n kʰ tʼ u r i
ინსტიტუტის	i n s tʼ i tʼ u tʼ i s
ინსტრუქტაჟი	i n s tʼ r u kʰ tʼ ɑ ʒ i
ინტენსიური	i n tʼ ɛ n s i u r i
ინფლაცია	i n pʰ l ɑ t͡s i ɑ
ინფორმატორი	i n pʰ ɔ r m ɑ tʼ ɔ r i
ირემი	i r ɛ m i
ირლანდიელი	i r l ɑ n d i ɛ l i
იტალიელი	i tʼ ɑ l i ɛ l i
იხდი	i x d i
იხდიდა	i x d i d ɑ
კავკასიამ	kʼ ɑ v kʼ ɑ s i ɑ m
კავკასიელი	kʼ ɑ v kʼ ɑ s i ɛ l i
კათედრა	kʼ ɑ tʰ ɛ d r ɑ
კანი	kʼ ɑ n i
კაპიკი	kʼ ɑ pʼ i kʼ i
კაპრალი	kʼ ɑ pʼ r ɑ l i
კარები	kʼ ɑ r ɛ b i
კაცს	kʼ ɑ t͡s s
კაცური	kʼ ɑ t͡s u r i
კახა	kʼ ɑ x ɑ
კახეთი	kʼ ɑ x ɛ tʰ i
კბილი	kʼ b i l i
კეთება	kʼ ɛ tʰ ɛ b ɑ
კეთილსინდისიერად	kʼ ɛ tʰ i l s i n d i s i ɛ r ɑ d
კიბერნეტიკა	kʼ i b ɛ r n ɛ tʼ i kʼ ɑ
კლდე	kʼ l d ɛ
კლივლენდი	kʼ l i v l ɛ n d i
კოლა	kʼ ɔ l ɑ
კოლონია	kʼ ɔ l ɔ n i ɑ
კოლორატურა	kʼ ɔ l ɔ r ɑ tʼ u r ɑ
კომბოსტო	kʼ ɔ m b ɔ s tʼ ɔ
კომინგსი	kʼ ɔ m i n ɡ s i
კომპანიონი	kʼ ɔ m pʼ ɑ n i ɔ n i
კომპიუტერულად	kʼ ɔ m pʼ i u tʼ ɛ r u l ɑ d
კომპრესორი	kʼ ɔ m pʼ r ɛ s ɔ r i
კომუნიზმი	kʼ ɔ m u n i z m i
კონკრეტული	kʼ ɔ n kʼ r ɛ tʼ u l i
კონსერვატიულად	kʼ ɔ n s ɛ r v ɑ tʼ i u l ɑ d
კონსტანტინე	kʼ ɔ n s tʼ ɑ n tʼ i n ɛ
კონსტიტუცია	kʼ ɔ n s tʼ i tʼ u t͡s i ɑ
კონსტრუქცია	kʼ ɔ n s tʼ r u kʰ t͡s i ɑ
კონტინენტური	kʼ ɔ n tʼ i n ɛ n tʼ u r i
კონტროლიორი	kʼ ɔ n tʼ r ɔ l i ɔ r i
კოორდინაცია	kʼ ɔ ɔ r d i n ɑ t͡s i ɑ
კოროზია	kʼ ɔ r ɔ z i ɑ
კორპორაციული	kʼ ɔ r pʼ ɔ r ɑ t͡s i u l i
კოტეჯი	kʼ ɔ tʼ ɛ d͡ʒ i
კრემაცია	kʼ r ɛ m ɑ t͡s i ɑ
კრისტალი	kʼ r i s tʼ ɑ l i
კუბა	kʼ u b ɑ
კუდი	kʼ u d i
ლაილაი	l ɑ i l ɑ i
ლარისა	l ɑ r i s ɑ
ლატარია	l ɑ tʼ ɑ r i ɑ
ლაღად	l ɑ ɣ ɑ d
ლაშა	l ɑ ʃ ɑ
ლეიბი	l ɛ i b i
ლიბანი	l i b ɑ n i
ლიკვიდატორი	l i kʼ v i d ɑ tʼ ɔ r i
ლიცეუმი	l i t͡s ɛ u m i
ლმობიერება	l m ɔ b i ɛ r ɛ b ɑ
ლოგიკურად	l ɔ ɡ i kʼ u r ɑ d
ლოტოსი	l ɔ tʼ ɔ s i
ლპობა	l pʼ ɔ b ɑ
ლუკმა	l u kʼ m ɑ
მადლიერად	m ɑ d l i ɛ r ɑ d
მადრიდი	m ɑ d r i d i
მავზოლეუმი	m ɑ v z ɔ l ɛ u m i
მათემატიკურად	m ɑ tʰ ɛ m ɑ tʼ i kʼ u r ɑ d
მათთვის	m ɑ tʰ tʰ v i s
მათი	m ɑ tʰ i
მაისურაძე	m ɑ i s u r ɑ d͡z ɛ
მაკრატელა	m ɑ kʼ r ɑ tʼ ɛ l ɑ
მალამო	m ɑ l ɑ m ɔ
მალი	m ɑ l i
მამამისმა	m ɑ m ɑ m i s m ɑ
მანდ	m ɑ n d
მანიპულაცია	m ɑ n i pʼ u l ɑ t͡s i ɑ
მანქანა	m ɑ n kʰ ɑ n ɑ
მართავს	m ɑ r tʰ ɑ v s
მართვე	m ɑ r tʰ v ɛ
მარყუჟი	m ɑ r qʼ u ʒ i
მარცვლეული	m ɑ r t͡s v l ɛ u l i
მატლი	m ɑ tʼ l i
მატყუარა	m ɑ tʼ qʼ u ɑ r ɑ
მაქსიმუმი	m ɑ kʰ s i m u m i
მაჩალიკაშვილი	m ɑ t͡ʃ ɑ l i kʼ ɑ ʃ v i l i
მახე	m ɑ x ɛ
მდედრი	m d ɛ d r i
მეგობრები	m ɛ ɡ ɔ b r ɛ b i
მედროშე	m ɛ d r ɔ ʃ ɛ
მეთოთხმეტე	m ɛ tʰ ɔ tʰ x m ɛ tʼ ɛ
მენჯი	m ɛ n d͡ʒ i
მეორედ	m ɛ ɔ r ɛ d
მერკანტილური	m ɛ r kʼ ɑ n tʼ i l u r i
მერყეობა	m ɛ r qʼ ɛ ɔ b ɑ
მეტალურგიული	m ɛ tʼ ɑ l u r ɡ i u l i
მეტაფიზიკური	m ɛ tʼ ɑ pʰ i z i kʼ u r i
მეტოქე	m ɛ tʼ ɔ kʰ ɛ
მეუღლე	m ɛ u ɣ l ɛ
მეცნიერული	m ɛ t͡s n i ɛ r u l i
მეხუთე	m ɛ x u tʰ ɛ
მზარეული	m z ɑ r ɛ u l i
მზრუნველობა	m z r u n v ɛ l ɔ b ɑ
მთავრობით	m tʰ ɑ v r ɔ b i tʰ
მთვარე	m tʰ v ɑ r ɛ
მიაყოლებს	m i ɑ qʼ ɔ l ɛ b s
მიაყოლეთ	m i ɑ qʼ ɔ l ɛ tʰ
მითითება	m i tʰ i tʰ ɛ b ɑ
მითითებით	m i tʰ i tʰ ɛ b i tʰ
მილიცია	m i l i t͡s i ɑ
მიმდინარე	m i m d i n ɑ r ɛ
მიმზიდველად	m i m z i d v ɛ l ɑ d
მირონმდინარე	m i r ɔ n m d i n ɑ r ɛ
მისტიკა	m i s tʼ i kʼ ɑ
მიტროპოლიტი	m i tʼ r ɔ pʼ ɔ l i tʼ i
მიწისძვრა	m i t͡sʼ i s d͡z v r ɑ
მკვდარი	m kʼ v d ɑ r i
მლიქვნელობა	m l i kʰ v n ɛ l ɔ b ɑ
მოასულიერებს	m ɔ ɑ s u l i ɛ r ɛ b s
მოდელი	m ɔ d ɛ l i
მოვლენა	m ɔ v l ɛ n ɑ
მოთეთრო	m ɔ tʰ ɛ tʰ r ɔ
მოკლედ	m ɔ kʼ l ɛ d
მოლეკულური	m ɔ l ɛ kʼ u l u r i
მომგებიანად	m ɔ m ɡ ɛ b i ɑ n ɑ d
მომჟავო	m ɔ m ʒ ɑ v ɔ
მონურად	m ɔ n u r ɑ d
მორგი	m ɔ r ɡ i
მოურიდებლობა	m ɔ u r i d ɛ b l ɔ b ɑ
მოქალაქე	m ɔ kʰ ɑ l ɑ kʰ ɛ
მოქმედება	m ɔ kʰ m ɛ d ɛ b ɑ
მოქმედი	m ɔ kʰ m ɛ d i
მოშლა	m ɔ ʃ l ɑ
მოშლის	m ɔ ʃ l i s
მოწყენილობა	m ɔ t͡sʼ qʼ ɛ n i l ɔ b ɑ
მოხერხებულად	m ɔ x ɛ r x ɛ b u l ɑ d
მრიცხველი	m r i t͡s x v ɛ l i
მრუდე	m r u d ɛ
მსუბუქი	m s u b u kʰ i
მტრობა	m tʼ r ɔ b ɑ
მუდამ	m u d ɑ m
მუნიციპალიტეტად	m u n i t͡s i pʼ ɑ l i tʼ ɛ tʼ ɑ d
მუსიკამ	m u s i kʼ ɑ m
მუსიკით	m u s i kʼ i tʰ
მუშაობა	m u ʃ ɑ ɔ b ɑ
მუხა	m u x ɑ
მფლობელობა	m pʰ l ɔ b ɛ l ɔ b ɑ
მქონდა	m kʰ ɔ n d ɑ
მცველი	m t͡s v ɛ l i
მწვავე	m t͡sʼ v ɑ v ɛ
მწვრთნელი	m t͡sʼ v r tʰ n ɛ l i
მწკრივი	m t͡sʼ kʼ r i v i
მხარით	m x ɑ r i tʰ
ნათია	n ɑ tʰ i ɑ
ნაირსახეობა	n ɑ i r s ɑ x ɛ ɔ b ɑ
ნაკელი	n ɑ kʼ ɛ l i
ნაპირი	n ɑ pʼ i r i
ნართი	n ɑ r tʰ i
ნარინჯისფერი	n ɑ r i n d͡ʒ i s pʰ ɛ r i
ნაფეხური	n ɑ pʰ ɛ x u r i
ნაყალბევი	n ɑ qʼ ɑ l b ɛ v i
ნაცისტური	n ɑ t͡s i s tʼ u r i
ნაწარმოები	n ɑ t͡sʼ ɑ r m ɔ ɛ b i
ნაწილობრივი	n ɑ t͡sʼ i l ɔ b r i v i
ნახატი	n ɑ x ɑ tʼ i
ნდობით	n d ɔ b i tʰ
ნებავს	n ɛ b ɑ v s
ნემსიწვერა	n ɛ m s i t͡sʼ v ɛ r ɑ
ნიახური	n i ɑ x u r i
ნიგერია	n i ɡ ɛ r i ɑ
ნიკოფსია	n i kʼ ɔ pʰ s i ɑ
ნიშა	n i ʃ ɑ
ნიშნავს	n i ʃ n ɑ v s
ნიჭი	n i t͡ʃʼ i
ნორვეგია	n ɔ r v ɛ ɡ i ɑ
ნოსტალგია	n ɔ s tʼ ɑ l ɡ i ɑ
ნუკრი	n u kʼ r i
ობელისკი	ɔ b ɛ l i s kʼ i
ობსერვატორია	ɔ b s ɛ r v ɑ tʼ ɔ r i ɑ
ოვაცია	ɔ v ɑ t͡s i ɑ
ოთხი	ɔ tʰ x i
ოკლაჰომა	ɔ kʼ l ɑ h ɔ m ɑ
ოპერატიული	ɔ pʼ ɛ r ɑ tʼ i u l i
ოპტიმალურად	ɔ pʼ tʼ i m ɑ l u r ɑ d
ორატორმა	ɔ r ɑ tʼ ɔ r m ɑ
ორიგინალი	ɔ r i ɡ i n ɑ l i
ორლულიანი	ɔ r l u l i ɑ n i
ორმო	ɔ r m ɔ
ორმხრივი	ɔ r m x r i v i
ორპირობა	ɔ r pʼ i r ɔ b ɑ
ორსულობა	ɔ r s u l ɔ b ɑ
ოსპი	ɔ s pʼ i
ოსტატური	ɔ s tʼ ɑ tʼ u r i
ოქრომ	ɔ kʰ r ɔ m
ოცდაათი	ɔ t͡s d ɑ ɑ tʰ i
ოცდათექვსმეტი	ɔ t͡s d ɑ tʰ ɛ kʰ v s m ɛ tʼ i
ოცდასამი	ɔ t͡s d ɑ s ɑ m i
პაემანს	pʼ ɑ ɛ m ɑ n s
პავლე	pʼ ɑ v l ɛ
პალატა	pʼ ɑ l ɑ tʼ ɑ
პაპანაქება	pʼ ɑ pʼ ɑ n ɑ kʰ ɛ b ɑ
პაპი	pʼ ɑ pʼ i
პარალელური	pʼ ɑ r ɑ l ɛ l u r i
პარაშუტი	pʼ ɑ r ɑ ʃ u tʼ i
პარიზი	pʼ ɑ r i z i
პაროლი	pʼ ɑ r ɔ l i
პარტიით	pʼ ɑ r tʼ i i tʰ
პასიური	pʼ ɑ s i u r i
პასიურობა	pʼ ɑ s i u r ɔ b ɑ
პასუხისმგებლობით	pʼ ɑ s u x i s m ɡ ɛ b l ɔ b i tʰ
პასუხობს	pʼ ɑ s u x ɔ b s
პატრიოტული	pʼ ɑ tʼ r i ɔ tʼ u l i
პენელოპე	pʼ ɛ n ɛ l ɔ pʼ ɛ
პეპელა	pʼ ɛ pʼ ɛ l ɑ
პერანგის	pʼ ɛ r ɑ n ɡ i s
პიესა	pʼ i ɛ s ɑ
პიჟონი	pʼ i ʒ ɔ n i
პირდაპირ	pʼ i r d ɑ pʼ i r
პირი	pʼ i r i
პლანეტა	pʼ l ɑ n ɛ tʼ ɑ
პლატო	pʼ l ɑ tʼ ɔ
პლენარული	pʼ l ɛ n ɑ r u l i
პოზიცია	pʼ ɔ z i t͡s i ɑ
პოლიტიკოსი	pʼ ɔ l i tʼ i kʼ ɔ s i
პოლიფონიური	pʼ ɔ l i pʰ ɔ n i u r i
პრასი	pʼ r ɑ s i
პრიალა	pʼ r i ɑ l ɑ
პრივილეგია	pʼ r i v i l ɛ ɡ i ɑ
პროგრესულად	pʼ r ɔ ɡ r ɛ s u l ɑ d
პროგრესული	pʼ r ɔ ɡ r ɛ s u l i
პროზაიკულად	pʼ r ɔ z ɑ i kʼ u l ɑ d
პროსტიტუცია	pʼ r ɔ s tʼ i tʼ u t͡s i ɑ
პროტეინი	pʼ r ɔ tʼ ɛ i n i
პროტეჟე	pʼ r ɔ tʼ ɛ ʒ ɛ
ჟოლოსფერი	ʒ ɔ l ɔ s pʰ ɛ r i
ჟურნალი	ʒ u r n ɑ l i
რადიკალი	r ɑ d i kʼ ɑ l i
რავიცი	r ɑ v i t͡s i
რაიმე	r ɑ i m ɛ
რამდენი	r ɑ m d ɛ n i
რეგიონად	r ɛ ɡ i ɔ n ɑ d
რეზიუმე	r ɛ z i u m ɛ
რეკავს	r ɛ kʼ ɑ v s
რეკომენდაცია	r ɛ kʼ ɔ m ɛ n d ɑ t͡s i ɑ
რეპლიკა	r ɛ pʼ l i kʼ ɑ
რეპორტიორი	r ɛ pʼ ɔ r tʼ i ɔ r i
რესტავრაცია	r ɛ s tʼ ɑ v r ɑ t͡s i ɑ
რვაფეხა	r v ɑ pʰ ɛ x ɑ
რიჟრაჟი	r i ʒ r ɑ ʒ i
რისკი	r i s kʼ i
რომელი	r ɔ m ɛ l i
რონდო	r ɔ n d ɔ
სააგენტო	s ɑ ɑ ɡ ɛ n tʼ ɔ
საბჭოს	s ɑ b t͡ʃʼ ɔ s
საგადასახადო	s ɑ ɡ ɑ d ɑ s ɑ x ɑ d ɔ
საენათმეცნიერო	s ɑ ɛ n ɑ tʰ m ɛ t͡s n i ɛ r ɔ
სავარცხელი	s ɑ v ɑ r t͡s x ɛ l i
საზიანო	s ɑ z i ɑ n ɔ
სათვალე	s ɑ tʰ v ɑ l ɛ
სათითე	s ɑ tʰ i tʰ ɛ
სათნო	s ɑ tʰ n ɔ
სათუო	s ɑ tʰ u ɔ
საკამათო	s ɑ kʼ ɑ m ɑ tʰ ɔ
სალათი	s ɑ l ɑ tʰ i
სამართალს	s ɑ m ɑ r tʰ ɑ l s
სამართლის	s ɑ m ɑ r tʰ l i s
სამი	s ɑ m i
სამკუთხა	s ɑ m kʼ u tʰ x ɑ
სამოქალაქო	s ɑ m ɔ kʰ ɑ l ɑ kʰ ɔ
სანაქებო	s ɑ n ɑ kʰ ɛ b ɔ
სანაქებოდ	s ɑ n ɑ kʰ ɛ b ɔ d
სანახავად	s ɑ n ɑ x ɑ v ɑ d
სანდრო	s ɑ n d r ɔ
სარტყელი	s ɑ r tʼ qʼ ɛ l i
სასარგებლოდ	s ɑ s ɑ r ɡ ɛ b l ɔ d
სასიკეთო	s ɑ s i kʼ ɛ tʰ ɔ
სასიყვარულო	s ɑ s i qʼ v ɑ r u l ɔ
სასწრაფო	s ɑ s t͡sʼ r ɑ pʰ ɔ
საფოსტო	s ɑ pʰ ɔ s tʼ ɔ
საყვედურით	s ɑ qʼ v ɛ d u r i tʰ
საშუალება	s ɑ ʃ u ɑ l ɛ b ɑ
საჩინო	s ɑ t͡ʃ i n ɔ
საცრემლე	s ɑ t͡s r ɛ m l ɛ
საჭმელი	s ɑ t͡ʃʼ m ɛ l i
სახალხო	s ɑ x ɑ l x ɔ
სახელგატეხილად	s ɑ x ɛ l ɡ ɑ tʼ ɛ x i l ɑ d
სახელის	s ɑ x ɛ l i s
სახელმწიფომ	s ɑ x ɛ l m t͡sʼ i pʰ ɔ m
სახელური	s ɑ x ɛ l u r i
სახელწოდება	s ɑ x ɛ l t͡sʼ ɔ d ɛ b ɑ
სახელწოდებას	s ɑ x ɛ l t͡sʼ ɔ d ɛ b ɑ s
სახემ	s ɑ x ɛ m
სეზონური	s ɛ z ɔ n u r i
სენსაციური	s ɛ n s ɑ t͡s i u r i
სერიოზულად	s ɛ r i ɔ z u l ɑ d
სერობა	s ɛ r ɔ b ɑ
სეროზული	s ɛ r ɔ z u l i
სვეტი	s v ɛ tʼ i
სიბინძურე	s i b i n d͡z u r ɛ
სიბრაზე	s i b r ɑ z ɛ
სიგანით	s i ɡ ɑ n i tʰ
სიგრილე	s i ɡ r i l ɛ
სივრცული	s i v r t͡s u l i
სიმდაბლე	s i m d ɑ b l ɛ
სიმრავლე	s i m r ɑ v l ɛ
სინამდვილეში	s i n ɑ m d v i l ɛ ʃ i
სინდიკატი	s i n d i kʼ ɑ tʼ i
სისტემა	s i s tʼ ɛ m ɑ
სისტემის	s i s tʼ ɛ m i s
სისხლიანი	s i s x l i ɑ n i
სიტყვაზე	s i tʼ qʼ v ɑ z ɛ
სიცოცხლე	s i t͡s ɔ t͡s x l ɛ
სიჯიუტე	s i d͡ʒ i u tʼ ɛ
სკეპტიკური	s kʼ ɛ pʼ tʼ i kʼ u r i
სკოლას	s kʼ ɔ l ɑ s
სკოლის	s kʼ ɔ l i s
სკულპტურული	s kʼ u l pʼ tʼ u r u l i
სოფელი	s ɔ pʰ ɛ l i
სოფლად	s ɔ pʰ l ɑ d
სპორტსმენი	s pʼ ɔ r tʼ s m ɛ n i
სრულყოფილი	s r u l qʼ ɔ pʰ i l i
სტაბილიზაცია	s tʼ ɑ b i l i z ɑ t͡s i ɑ
სტილისტი	s tʼ i l i s tʼ i
სტუმრობა	s tʼ u m r ɔ b ɑ
სუბორდინაცია	s u b ɔ r d i n ɑ t͡s i ɑ
სულელურად	s u l ɛ l u r ɑ d
სული	s u l i
სუნელი	s u n ɛ l i
სურს	s u r s
სუსტად	s u s tʼ ɑ d
სქელი	s kʰ ɛ l i
სქოლასტიკური	s kʰ ɔ l ɑ s tʼ i kʼ u r i
სცენარისტი	s t͡s ɛ n ɑ r i s tʼ i
სწავლება	s t͡sʼ ɑ v l ɛ b ɑ
სწავლობს	s t͡sʼ ɑ v l ɔ b s
სწორად	s t͡sʼ ɔ r ɑ d
სწორი	s t͡sʼ ɔ r i
სწორხაზოვანი	s t͡sʼ ɔ r x ɑ z ɔ v ɑ n i
ტალახიანი	tʼ ɑ l ɑ x i ɑ n i
ტარიფი	tʼ ɑ r i pʰ i
ტევადი	tʼ ɛ v ɑ d i
ტელესკოპი	tʼ ɛ l ɛ s kʼ ɔ pʼ i
ტერი	tʼ ɛ r i
ტვინის	tʼ v i n i s
ტიპოგრაფიულად	tʼ i pʼ ɔ ɡ r ɑ pʰ i u l ɑ d
ტოლუმბაში	tʼ ɔ l u m b ɑ ʃ i
ტოლფასი	tʼ ɔ l pʰ ɑ s i
ტორი	tʼ ɔ r i
ტრაბახი	tʼ r ɑ b ɑ x i
ტრაგიკომედია	tʼ r ɑ ɡ i kʼ ɔ m ɛ d i ɑ
ტურაშვილი	tʼ u r ɑ ʃ v i l i
ტურბულენტური	tʼ u r b u l ɛ n tʼ u r i
ტუჩი	tʼ u t͡ʃ i
ტყვია	tʼ qʼ v i ɑ
უგუნურად	u ɡ u n u r ɑ d
უემოციოდ	u ɛ m ɔ t͡s i ɔ d
უვნებელი	u v n ɛ b ɛ l i
უვნებლად	u v n ɛ b l ɑ d
უზენაესობა	u z ɛ n ɑ ɛ s ɔ b ɑ
უზურპატორი	u z u r pʼ ɑ tʼ ɔ r i
უთანაბრო	u tʰ ɑ n ɑ b r ɔ
უიმედო	u i m ɛ d ɔ
უიმედოდ	u i m ɛ d ɔ d
უკმაყოფილო	u kʼ m ɑ qʼ ɔ pʰ i l ɔ
ულტიმატუმი	u l tʼ i m ɑ tʼ u m i
უმაგრესი	u m ɑ ɡ r ɛ s i
უმარილო	u m ɑ r i l ɔ
უმტკივნეულო	u m tʼ kʼ i v n ɛ u l ɔ
უმჭიდროესი	u m t͡ʃʼ i d r ɔ ɛ s i
უნგრული	u n ɡ r u l i
უნებართვო	u n ɛ b ɑ r tʰ v ɔ
უნებლიეთ	u n ɛ b l i ɛ tʰ
უპირობოდ	u pʼ i r ɔ b ɔ d
ურბანიზაცია	u r b ɑ n i z ɑ t͡s i ɑ
უსაზღვრო	u s ɑ z ɣ v r ɔ
უსასრულო	u s ɑ s r u l ɔ
უსიამოვნება	u s i ɑ m ɔ v n ɛ b ɑ
უტოპია	u tʼ ɔ pʼ i ɑ
უუნარობა	u u n ɑ r ɔ b ɑ
უყურადღებოდ	u qʼ u r ɑ d ɣ ɛ b ɔ d
უძველესი	u d͡z v ɛ l ɛ s i
უძრავად	u d͡z r ɑ v ɑ d
უწესო	u t͡sʼ ɛ s ɔ
უწესრიგობაში	u t͡sʼ ɛ s r i ɡ ɔ b ɑ ʃ i
უწესრიგოდ	u t͡sʼ ɛ s r i ɡ ɔ d
უწყის	u t͡sʼ qʼ i s
უხვად	u x v ɑ d
ფარდა	pʰ ɑ r d ɑ
ფართე	pʰ ɑ r tʰ ɛ
ფეიერვერკი	pʰ ɛ i ɛ r v ɛ r kʼ i
ფეხმძიმობა	pʰ ɛ x m d͡z i m ɔ b ɑ
ფინანსისტი	pʰ i n ɑ n s i s tʼ i
ფირმა	pʰ i r m ɑ
ფიჭა	pʰ i t͡ʃʼ ɑ
ფლეგმატური	pʰ l ɛ ɡ m ɑ tʼ u r i
ფოთი	pʰ ɔ tʰ i
ფოკუსი	pʰ ɔ kʼ u s i
ფორმა	pʰ ɔ r m ɑ
ფოტოაპარატი	pʰ ɔ tʼ ɔ ɑ pʼ ɑ r ɑ tʼ i
ფოტოასლი	pʰ ɔ tʼ ɔ ɑ s l i
ფოცხი	pʰ ɔ t͡s x i
ფსკერი	pʰ s kʼ ɛ r i
ქაბული	kʰ ɑ b u l i
ქადილი	kʰ ɑ d i l i
ქათმის	kʰ ɑ tʰ m i s
ქალაქმა	kʰ ɑ l ɑ kʰ m ɑ
ქართველთა	kʰ ɑ r tʰ v ɛ l tʰ ɑ
ქართლის	kʰ ɑ r tʰ l i s
ქეთი	kʰ ɛ tʰ i
ქეთინო	kʰ ɛ tʰ i n ɔ
ქვა	kʰ v ɑ
ქვეყანას	kʰ v ɛ qʼ ɑ n ɑ s
ქვეყნის	kʰ v ɛ qʼ n i s
ქირა	kʰ i r ɑ
ქოთანი	kʰ ɔ tʰ ɑ n i
ქორწილი	kʰ ɔ r t͡sʼ i l i
ქრისტე	kʰ r i s tʼ ɛ
ქრონიკული	kʰ r ɔ n i kʼ u l i
ღვთისმშობელი	ɣ v tʰ i s m ʃ ɔ b ɛ l i
ღიმილი	ɣ i m i l i
ღიპი	ɣ i pʼ i
ყალბი	qʼ ɑ l b i
ყანწი	qʼ ɑ n t͡sʼ i
ყბედი	qʼ b ɛ d i
ყველგან	qʼ v ɛ l ɡ ɑ n
ყისმათი	qʼ i s m ɑ tʰ i
ყოფიერება	qʼ ɔ pʰ i ɛ r ɛ b ɑ
შადრევანი	ʃ ɑ d r ɛ v ɑ n i
შალვა	ʃ ɑ l v ɑ
შარიშური	ʃ ɑ r i ʃ u r i
შაშხანა	ʃ ɑ ʃ x ɑ n ɑ
შე	ʃ ɛ
შედარება	ʃ ɛ d ɑ r ɛ b ɑ
შედიან	ʃ ɛ d i ɑ n
შემაძრწუნებლად	ʃ ɛ m ɑ d͡z r t͡sʼ u n ɛ b l ɑ d
შემომეჭამო	ʃ ɛ m ɔ m ɛ t͡ʃʼ ɑ m ɔ
შენ	ʃ ɛ n
შერბილებული	ʃ ɛ r b i l ɛ b u l i
შერიგება	ʃ ɛ r i ɡ ɛ b ɑ
შესაძლოა	ʃ ɛ s ɑ d͡z l ɔ ɑ
შეუზღუდავად	ʃ ɛ u z ɣ u d ɑ v ɑ d
შეუსაბამოდ	ʃ ɛ u s ɑ b ɑ m ɔ d
შეუჩერებელი	ʃ ɛ u t͡ʃ ɛ r ɛ b ɛ l i
შეწყალების	ʃ ɛ t͡sʼ qʼ ɑ l ɛ b i s
შვრია	ʃ v r i ɑ
შთაბეჭდილება	ʃ tʰ ɑ b ɛ t͡ʃʼ d i l ɛ b ɑ
შიშველი	ʃ i ʃ v ɛ l i
შობს	ʃ ɔ b s
შორეული	ʃ ɔ r ɛ u l i
შრაპნელი	ʃ r ɑ pʼ n ɛ l i
შრომობდნენ	ʃ r ɔ m ɔ b d n ɛ n
შუადღემდე	ʃ u ɑ d ɣ ɛ m d ɛ
შუამავლობა	ʃ u ɑ m ɑ v l ɔ b ɑ
ჩაკვეტაძე	t͡ʃ ɑ kʼ v ɛ tʼ ɑ d͡z ɛ
ჩაქრება	t͡ʃ ɑ kʰ r ɛ b ɑ
ჩახუტება	t͡ʃ ɑ x u tʼ ɛ b ɑ
ჩილე	t͡ʃ i l ɛ
ჩილეს	t͡ʃ i l ɛ s
ჩირქოვანი	t͡ʃ i r kʰ ɔ v ɑ n i
ჩიტი	t͡ʃ i tʼ i
ჩიხი	t͡ʃ i x i
ჩუტყვავილა	t͡ʃ u tʼ qʼ v ɑ v i l ɑ
ცელულოზა	t͡s ɛ l u l ɔ z ɑ
ცენტნერი	t͡s ɛ n tʼ n ɛ r i
ცენტრი	t͡s ɛ n tʼ r i
ცვლადი	t͡s v l ɑ d i
ცივსისხლიანი	t͡s i v s i s x l i ɑ n i
ცისტერნა	t͡s i s tʼ ɛ r n ɑ
ციტირება	t͡s i tʼ i r ɛ b ɑ
ცოლისძმა	t͡s ɔ l i s d͡z m ɑ
ცომი	t͡s ɔ m i
ცრურწმენა	t͡s r u r t͡sʼ m ɛ n ɑ
ცხოვრებას	t͡s x ɔ v r ɛ b ɑ s
ძალაუფლება	d͡z ɑ l ɑ u pʰ l ɛ b ɑ
ძალიან	d͡z ɑ l i ɑ n
ძვალი	d͡z v ɑ l i
ძია	d͡z i ɑ
ძლიერად	d͡z l i ɛ r ɑ d
ძუკნა	d͡z u kʼ n ɑ
წალიკა	t͡sʼ ɑ l i kʼ ɑ
წალკოტი	t͡sʼ ɑ l kʼ ɔ tʼ i
წამიერად	t͡sʼ ɑ m i ɛ r ɑ d
წამოვა	t͡sʼ ɑ m ɔ v ɑ
წარმართული	t͡sʼ ɑ r m ɑ r tʰ u l i
წარმატებული	t͡sʼ ɑ r m ɑ tʼ ɛ b u l i
წარმომავლობა	t͡sʼ ɑ r m ɔ m ɑ v l ɔ b ɑ
წარმოუდგენელი	t͡sʼ ɑ r m ɔ u d ɡ ɛ n ɛ l i
წარმოუდგენლად	t͡sʼ ɑ r m ɔ u d ɡ ɛ n l ɑ d
წარუმატებელი	t͡sʼ ɑ r u m ɑ tʼ ɛ b ɛ l i
წევრი	t͡sʼ ɛ v r i
წვრილმანი	t͡sʼ v r i l m ɑ n i
წილი	t͡sʼ i l i
წინანდელი	t͡sʼ i n ɑ n d ɛ l i
წინსწრება	t͡sʼ i n s t͡sʼ r ɛ b ɑ
წუხილი	t͡sʼ u x i l i
წყალი	t͡sʼ qʼ ɑ l i
წყალმა	t͡sʼ qʼ ɑ l m ɑ
ჭაღარა	t͡ʃʼ ɑ ɣ ɑ r ɑ
ჭაღი	t͡ʃʼ ɑ ɣ i
ჭვინტი	t͡ʃʼ v i n tʼ i
ჭი	t͡ʃʼ i
ჭიქა	t͡ʃʼ i kʰ ɑ
ჭო	t͡ʃʼ ɔ
ჭურვი	t͡ʃʼ u r v i
ჭუჭყი	t͡ʃʼ u t͡ʃʼ qʼ i
ხაზინა	x ɑ z i n ɑ
ხალხმა	x ɑ l x m ɑ
ხანდახან	x ɑ n d ɑ x ɑ n
ხანჯალი	x ɑ n d͡ʒ ɑ l i
ხარბი	x ɑ r b i
ხარშვა	x ɑ r ʃ v ɑ
ხასიათი	x ɑ s i ɑ tʰ i
ხაჭაპური	x ɑ t͡ʃʼ ɑ pʼ u r i
ხედვა	x ɛ d v ɑ
ხელმწიფე	x ɛ l m t͡sʼ i pʰ ɛ
ხელობა	x ɛ l ɔ b ɑ
ხილი	x i l i
ხიწვი	x i t͡sʼ v i
ხომ	x ɔ m
ხორვატია	x ɔ r v ɑ tʼ i ɑ
ხორკლიანი	x ɔ r kʼ l i ɑ n i
ხსნა	x s n ɑ
ჯადოქარი	d͡ʒ ɑ d ɔ kʰ ɑ r i
ჯალათი	d͡ʒ ɑ l ɑ tʰ i
ჯართი	d͡ʒ ɑ r tʰ i
ჯარისკაცი	d͡ʒ ɑ r i s kʼ ɑ t͡s i
ჯიბე	d͡ʒ i b ɛ
ჯო	d͡ʒ ɔ
ჯოული	d͡ʒ ɔ u l i
ჰერალდიკური	h ɛ r ɑ l d i kʼ u r i
ჰიპოთეზა	h i pʼ ɔ tʰ ɛ z ɑ
ჰოლანდია	h ɔ l ɑ n d i ɑ
