آئورت	ɒː ʔ o ɾ t
آب	ɑː b
آبان	ɒː b ɒː n
آبدست	ɑː b d a s t
آبشار	ɑː b ʃ ɑː ɾ
آبلیمو	ɑː b l iː m uː
آبنوس	ɑː b n uː s
آبگینه	ʔ ɑː b ɡ iː n e
آبی	ɑː b iː
آتش	ɑː t a ʃ
آتنا	ɑː t i n ɑː
آجر	ɑː d͡ʒ u ɾ
آجیل	ɑː d͡ʒ iː l
آخ	ɑː x
آخر	ɑː x a ɾ
آخوند	ɑː x uː n d
آدرس	ɑː d ɾ e s
آدم	ɑː d a m
آدم‌ها	ɑː d a m h ɑː
آدینه	ɑː d iː n a
آذربایجان	ɑː z a ɾ b ɑː j d͡ʒ ɑː n
آذرخش	ɑː z a ɾ a x ʃ
آرامگاه	ɑː ɾ ɑː m ɡ ɑː h
آرامی	ɑː ɾ ɑː m iː
آرایش	ɑː ɾ ɑː j i ʃ
آرایشگاه	ɑː ɾ ɑː j i ʃ ɡ ɑː h
آرد	ɑː ɾ d
آرزو	ɑː ɾ i z uː
آرپا	ɑː ɾ p ɑː
آزاد	ɑː z ɑː d
آزردن	ɒː z o ɾ d æ n
آزمودن	ɑː z m uː d a n
آزموده	ɑː z m uː d a
آسان	ɑː s ɑː n
آسانی	ɑː s ɑː n iː
آسایش	ɑː s ɑː j i ʃ
آستانه	ɑː s t ɑː n a
آستانه‌ای	ɑː s t ɑː n a iː
آسمان	ɑː s i m ɑː n
آسمانخراش	ɑː s m ɑː n x a ɾ ɑː ʃ
آسیا	ɑː s i j ɑː
آسیاب	ɑː s i j ɑː b
آش	ʔ ɑː ʃ
آشتی	ɑː ʃ t iː
آشفته	ɑː ʃ u f t a
آشنا	ɑː ʃ i n ɑː
آشوب‌ها	ɑː ʃ uː b h ɑː
آشپز	ɑː ʃ p a z
آشپزخانه	ɑː ʃ p a z x ɑː n a
آغا	ɑː ɢ ɑː
آغاز	ɑː ɢ ɑː z
آغوش	ɑː ɢ oː ʃ
آغیل	ɑː ɢ iː l
آقا	ɑː ɢ ɑː
آلاله	ɑː l ɑː l a
آلایش	ɑː l ɑː j i ʃ
آلت	ɑː l a t
آلرژی	ɑː l i ɾ ʒ iː
آلفته	ɑː l u f t a
آلمان	ɑː l m ɑː n
آمار	ɑː m ɑː ɾ
آمارگر	ɑː m ɑː ɾ ɡ a ɾ
آمد	ɑː m a d
آمدن	ɑː m a d a n
آمرزیدن	ɑː m u ɾ z iː d a n
آموزگار	ɑː m oː z ɡ ɑː ɾ
آمیزش	ɑː m iː z e ʃ
آن	ɑː n
آنجا	ɑː n d͡ʒ ɑː
آنغوزه	ɑː n ɢ u z a
آنقدر	ɑː n ɢ a d ɾ
آنلاین	ɑː n l ɑː j n
آهار	ɑː h ɑː ɾ
آهسته	ɑː h i s t a
آهن	ɑː h a n
آهنگ	ɑː h a n ɡ
آواز	ɑː v ɑː z
آوازه	ɑː v ɑː z a
آویختن	ɑː v e x t a n
آچار	ɑː t͡ʃ ɑː ɾ
آژیر	ɑː ʔ ʒ iː ɾ
آکندن	ʔ ɑː k a n d a n
آیا	ɑː j ɑː
آیت‌الله	ɑː j a t u l l ɑː h
آینده	ɑː j a n d a
ائتلاف	e ʔ t e l ɑː f
ابتدا	e b t e d ɑː
ابتکار	e b t e k ɑː ɾ
ابد	a b a d
ابر	a b a ɾ
ابراهیم	e b ɾ ɑː h iː m
ابرش	a b ɾ a ʃ
ابرنواختر	a b a ɾ n a v a x t a ɾ
ابری	ʔ a b ɾ iː
ابریشم	a b ɾ i ʃ a m
ابریق	e b ɾ iː ɢ
ابری‌ساز	ʔ a b ɾ iː s ɑː z
ابری‌سازی	ʔ a b ɾ iː s ɑː z iː
ابزار	a b z ɑː ɾ
ابلیس	e b l iː s
ابهام	e b h ɑː m
اتاق	o t ɑː ɢ
اتراق	o t ɾ ɑː ɢ
اتصال	e t t e s ɑː l
اتفاق	e t t e f ɑː ɢ
اتفاقاً	e t t e f ɑː ɢ a n
اتلاف	e t l ɑː f
اتمام	e t m ɑː m
اتم‌ها	a t o m h ɑː
اثبات	e s b ɑː t
اثر	a s a ɾ
اجازه	e d͡ʒ ɑː z e
اجاق	o d͡ʒ ɑː ɢ
اجتماع	e d͡ʒ t e m ɑː ʔ
احترام	e h t e ɾ ɑː m
احتیاج	e h t i j ɑː d͡ʒ
احمدی‌نژاد	a h m a d i n i ʒ ɑː d
احمق	a h m a ɢ
اخبار	a x b ɑː ɾ
اخترمار	a x t a ɾ m ɑː ɾ
اختصار	e x t e s ɑː ɾ
اختیار	e x t i j ɑː ɾ
اخذ	ʔ a x z
اخراج	e x ɾ ɑː d͡ʒ
اخیرا	a x i ɾ a n
ادا	a d ɑː
اداره	e d ɑː ɾ e
ادبیات	a d a b i j ɑː t
ادغام	e d ɢ ɑː m
ادویه	a d v i j a
ادیان	a d j ɑː n
اذان	a z ɑː n
اذیت	a z i j a t
ارادت	e ɾ ɑː d a t
اراده	e ɾ ɒː d e
ارتش	a ɾ t i ʃ
ارتعاش	e ɾ t e ʔ ɑː ʃ
ارده	a ɾ d a
اردو	o ɾ d uː
اردیبهشت	o ɾ d iː b e h e ʃ t
ارزان	a ɾ z ɑː n
ارزش	a ɾ z i ʃ
ارزشمند	a ɾ z i ʃ m a n d
ارزیدن	a ɾ z i d a n
ارس	a ɾ a s
ارسطو	a ɾ a s t u
ارض	a ɾ z
ارغنون	a ɾ ɢ a n uː n
ارغوان	a ɾ ɢ a v ɑː n
ارغوانی	a ɾ ɢ a v ɑː n iː
ارمنستان	a ɾ m a n i s t ɑː n
ارگ	o ɾ ɡ
اریحا	a ɾ i h ɑː
ازاله	e z ɑː l e
ازدواج	e z d e v ɑː d͡ʒ
ازگیل	a z ɡ i l
اساتید	a s ɑː t iː d
اسب	a s b
استاد	o s t ɑː d
استان	o s t ɑː n
استخوان	o s t o x ɑː n
استراتژی	e s t ɾ ɑː t e ʒ iː
استراحت	e s t e ɾ ɑː h a t
استعداد	e s t e ʔ d ɑː d
استقبال	e s t e ɢ b ɑː l
استقلال	e s t e ɢ l ɑː l
استیون	e s t iː v e n
اسطوره	o s t uː ɾ e
اسفرزه	e s f a ɾ z e
اسفناج	e s f e n ɒː d͡ʒ
اسفند	e s f a n d
اسلامی	e s l ɑː m iː
اسلام‌گرا	e s l ɑː m ɡ a ɾ ɑː
اسلوب	o s l uː b
اسلیمی	e s l iː m iː
اسپرزه	e s p a ɾ z e
اسپریس	ʔ e s p a ɾ e s
اسپست	a s p i s t
اسپغول	e s p a ɢ uː l
اسپهسالار	ʔ e s p a h s ɑː l ɑː ɾ
اسکندر	e s k a n d a ɾ
اشتباه	e ʃ t e b ɑː h
اشتر	ʔ o ʃ t o ɾ
اشتراک	e ʃ t e ɾ ɑː k
اشترخار	o ʃ t o ɾ x ɑː ɾ
اشترغار	o ʃ t o ɾ ɢ ɑː ɾ
اشرج	a ʃ r a d ʒ
اشک	a ʃ k
اشکال	a ʃ k ɑː l
اصطبل	e s t a b l
اصفهان	e s f a h ɑː n
اصفهانی	e s f a h ɑː n iː
اصل	a s l
اصلی	a s l iː
اصیل	a s i l
اضافه	e z ɑː f e
اطمینان	e t m iː n ɑː n
اظهار	e z h ɑː ɾ
اعتدال	e ʔ t e d ɑː l
اعتقاد	e ʔ t e ɢ ɑː d
اعتیاد	e ʔ t i j ɑː d
اعدام	e ʔ d ɑː m
اعضا	a ʔ z ɑː
اعلام	e ʔ l ɑː m
اغوا	e ɢ v ɑː
افتخار	e f t e x ɑː ɾ
افرنگ	a f ɾ a n ɡ
افزایش	a f z ɑː j i ʃ
افزودن	a f z u d a n
افسانه	a f s ɑː n a
افسر	a f s a ɾ
افسردگی	a f s u ɾ d i ɡ iː
افسوس	a f s oː s
افسون	a f s oː n
افشاندن	a f ʃ ɑː n d a n
افشردن	æ f ʃ o ɾ d æ n
افطار	e f t ɑː ɾ
افغان	a f ɢ ɑː n
افغانستان	a f ɢ ɑː n i s t ɑː n
افغانی	a f ɢ ɑː n iː
افلاطون	a f l ɑː t uː n
افیون	ʔ a f j uː n
اقتصادی	e ɢ t e s ɑː d iː
اقرار	e ɢ ɾ ɑː ɾ
اقلا	a ɢ a l l a n
اقلیم	e ɢ l iː m
اقمار	a ɢ m ɑː ɾ
اقیانوس	o ɢ j ɑː n uː s
البته	a l b a t t a
البرز	ʔ a l b o ɾ z
الحاق	e l h ɑː ɢ
القاعده	a l ɢ ɑː ʔ i d a
الله‌قلی	a l l ɑː h ɢ u l iː
الماس	a l m ɑː s
الماس‌ها	a l m ɑː s h ɑː
المزده	æ l æ m z æ d e
الموت	ʔ a l a m uː t
اله	e l ɑː h
الهام	e l h ɑː m
الهه	e l ɑː h e
امامقلی	e m ɑː m ɢ o l iː
امت	o m m a t
امتحان	e m t e h ɑː n
امروز	e m ɾ uː z
امسال	e m s ɑː l
امشب	e m ʃ a b
امضاء	e m z ɑː
امکان	e m k ɑː n
امید	o m iː d
امیدیار	ʔ o m iː d j ɑː ɾ
امین	a m iː n
امین‌ها	a m iː n h ɑː
ان	ɑː n
انار	a n ɑː ɾ
انبار	ʔ a m b ɑː ɾ
انتحار	e n t e h ɑː ɾ
انتخاب	e n t e x ɑː b
انتشار	e n t e ʃ ɑː ɾ
انتقاد	e n t e ɢ ɑː d
انتقام	e n t e ɢ ɑː m
انجام	a n d͡ʒ ɑː m
انجامیدن	a n d͡ʒ ɑː m iː d a n
انجمن	ʔ a n d͡ʒ o m a n
انداختن	a n d ɑː x t a n
اندازه	a n d ɑː z a
اندی	a n d e
اندیشه	a n d e ʃ a
اندیشیدن	a n d e ʃ i d a n
انرژی	a n a ɾ ʒ iː
انزال	e n z ɑː l
انسان	e n s ɑː n
انطاکیه	a n t ɑː k i j a
انعکاس	e n ʔ e k ɑː s
انفجار	e n f e d͡ʒ ɑː ɾ
انقلاب	e n ɢ e l ɑː b
انقلابی	e n ɢ e l ɑː b iː
انکار	e n k ɑː ɾ
انگشت	a n ɡ i ʃ t
انگشتر	a n ɡ u ʃ t a ɾ
انگلستان	e n ɡ e l e s t ɑː n
انگلیس	ʔ e n ɡ e l iː s
انگور	a n ɡ u ɾ
انگیختن	æ ŋ ɡ iː x t æ n
انگیزه	a n ɡ e z a
ان‌شاءالله	e n ʃ ɑː ʔ a l l ɑː h
اهریمن	ʔ æ h ɾ iː m æ n
اهمیت	a h a m i j a t
اهواز	a h v ɑː z
اهورامزدا	a h u ɾ ɑː m a z d ɑː
اورشلیم	ʔ o ɾ ʃ æ l iː m
اورنگ	a v ɾ a n ɡ
اولی	a v v a l iː
اوکی	o kʰ e j
اوگاندا	u ɡ ɑː n d ɑː
اً	t a n v i n
اژدها	a ʒ d a h ɑː
اکثر	a k s a ɾ
اگرچه	a ɡ a ɾ t ʃ e
اگیر	a ɡ i ɾ
ای	e j
ایام	ʔ a j j ɑː m
ایدون	e d u n
ایران	e ɾ ɑː n
ایرانشهر	e ɾ ɑː n ʃ a h ɾ
ایرانی	e ɾ ɑː n iː
ایرانیان	iː ɾ ɑː n i j ɑː n
ایران‌ویج	e ɾ ɑː n v e d͡ʒ
ایستادن	i s t ɑː d a n
ایشان	e ʃ ɑː n
ایمان	i m ɑː n
ایمان‌دار	i m ɑː n d ɑː ɾ
با	b ɑː
باب	b ɑː b
بابا	b ɑː b ɑː
بابل	b ɑː b i l
بابک	b ɑː b a k
باجی	b ɒː d ʒ iː
باحال‌تر	b ɒː h ɒː l t æ ɾ
باحال‌ترین	b ɑː h ɑː l t a ɾ iː n
بادام	b ɑː d ɑː m
بادبانی	b ɑː d b ɑː n iː
بار	b ɑː ɾ
باران	b ɑː ɾ ɑː n
باردار	b ɑː ɾ d ɑː ɾ
باروت	b ɑː ɾ uː t
بارود	b ɑː ɾ uː d
باریک	b ɑː ɾ iː k
باریک‌تر	b ɑː ɾ iː k t a ɾ
باریک‌ترین	b ɑː ɾ iː k t a ɾ iː n
باز	b ɑː z
بازدید	b ɑː z d iː d
بازنشسته	b ɑː z n i ʃ a s t a
بازیچه	b ɑː z iː t ʃ e
باستان	b ɑː s t ɑː n
باستانی	b ɑː s t ɑː n iː
باستان‌شناس	b ɑː s t ɑː n ʃ i n ɑː s
باسن	b ɑː s a n
باعث	b ɑː ʔ i s
باغ	b ɑː ɢ
باغات	b ɒː ɣ ɒː t̪
باغبان	b ɑː ɢ b ɑː n
باغ‌ها	b ɒː ɣ h ɒː
باف	b ɑː f
باقلوا	b ɑː ɢ l a v ɑː
بال	b ɑː l
بالا	b ɑː l ɑː
بالاخره	b e l æ x æ ɾ e
بالغ	b ɒː l e ɣ
بام	b ɑː m
بامداد	b ɑː m d ɑː n
بامزه	b ɒː m æ z e
بامزه‌ترین	b ɑː m a z e t a ɾ iː n
بان	b ɑː n
بانو	b ɑː n uː
بانک	b ɑː n k
باهوش	b ɑː h uː ʃ
باژ	b ɑː ʒ
باژدار	b ɑː ʒ d ɑː ɾ
باید	b ɑː j a d
بایست	b ɑː j e s t
بایستن	b ɑː j i s t a n
بایستی	b ɑː j a s t iː
ببر	b a b ɾ
بحث	b a h s
بحران	b o h ɾ ɑː n
بحریه	b a h ɾ i j a
بخار	b o x ɑː ɾ
بخاطر	b a x ɑː t i ɾ i
بختر	b e x t a ɾ
بختیار	b a x t i j ɑː ɾ
بخش	b a x ʃ
بخصوص	b a x u s u s
بخور	b o x uː ɾ
بد	b a d
بدرود	b e d ɾ uː d
بدن	b a d a n
بر	b æ ɾ
برابر	b a ɾ ɑː b a ɾ
برادر	b a ɾ ɑː d a ɾ
برازیدن	b a ɾ ɑː z iː d a n
برجسته	b a ɾ d͡ʒ a s t a
برخوردار	b a ɾ x o ɾ d ɑː ɾ
برخی	b a r x iː
بردار	b a ɾ d ɑː ɾ
بردن	b o ɾ d a n
برزیستن	b a r z iː s t a n
برنامه	b a ɾ n ɑː m a
برنز	b o ɾ o n z
برهنه	b a ɾ a h n a
برهنه‌گرا	b a ɾ a h n a ɡ a ɾ ɑː
برهنگی	b a ɾ a h n a ɡ iː
برپا	b a ɾ p ɑː
برگ	b æ ɾ ɡ
برگشتن	b a ɾ ɡ a ʃ t a n
بری	b e ɾ e j
بریدن	b o ɾ iː d a n
بز	b o z
بزاق	b o z ɑː ɢ
بزرگ	b o z o ɾ ɡ
بزرگ‌امید	b o z o ɾ ɡ ʔ o m iː d
بسته	b a s t a
بسد	b e s a d
بسنده	b æ s æ n d e
بسیار	b e s j ɑː ɾ
بشقاب	b o ʃ ɢ ɑː b
بشکه	b o ʃ k e
بعث	b a ʔ s
بعد	b a ʔ d
بعدا	b a ʔ d a n
بعل	b a ʔ l
بعید	b a ʔ i d
بفرمایید	b e f æ ɾ m ɒː j iː d
بلافاصله	b e l ɑː f ɑː s e l e
بلال	b a l ɑː l
بلاگ	b l ɑː ɡ
بلد	b a l a d
بلعیدن	b a l ʔ iː d a n
بلور	b i l oː ɾ
بلگ	b a l ɡ
بلی	b a l e
بم	b ə m
بندر	b a n d a ɾ
بنگ	b æ ŋ ɡ
بنگاه	b o n ɡ ɑː h
بنیاد	b o n j ɑː d
بنیادگرا	b o n j ɑː d ɡ a ɾ ɑː
به	b a
بهاءالله	b a h ɑː ʔ u l l ɑː h
بهار	b a h ɑː ɾ
بهاری	b a h ɑː ɾ iː
بهبود	b e h b uː d
بهتان	b o h t u n
بهتر	b e h t a ɾ
بهترین	b e h t a ɾ i n
بهشت	b e h e ʃ t
بهمن	b a h m a n
به‌آفرید	b e h ɑː f a ɾ iː d
بو	b oː
بوالعجب	b o l ʔ a d͡ʒ a b
بوته	b oː t a
بوران	b uː ɾ ɑ n
بوزه	b oː z a
بوستان	b oː s t ɑː n
بوسه	b oː s a
بوسیدن	b oː s iː d a n
بوقلمون	b u ɢ a l a m u n
بوم	b u m
بون	b uː n
بوی	b oː j
بوییدن	b uː j iː d a n
بچه	b a t t͡ʃ a
بژ	b e ʒ
بکارت	b a k ɑː ɾ a t
بی	b e
بیابان	b i j ɑː b ɑː n
بیجاده	b i d͡ʒ ɑː d i
بیخودی	b i x u d iː
بیدار	b e d ɑː ɾ
بیرق	b a j ɾ a ɢ
بیرونی	b e ɾ uː n iː
بیش	b e ʃ
بیشتر	b e ʃ t a ɾ
بیشه	b e ʃ a
بیضه	b a j z a
بیل	b e l
بیمار	b e m ɑː ɾ
بیمارتر	b iː m ɑː ɾ t a ɾ
بیمارترین	b iː m ɒː ɾ t æ ɾ iː n
بیمناک	b i n m ɑː k
بیمه	b i m a
بین	b a j n
بینی	b i n iː
بین‌المللی	b a j n a l m i l a l iː
بیور	b e v a ɾ
بیچاره	b e t͡ʃ ɑː ɾ a
بیژن	b e ʒ a n
بیگانه	b e ɡ ɑː n a
بی‌سواد	b e s a v ɑː d
بی‌سیم	b e s i m
بی‌شمار	b e ʃ u m ɑː ɾ
بی‌صراط	b e s i ɾ ɑː t
بی‌طرف	b e t a ɾ a f
بی‌عرضه	b e u ɾ z a
بی‌معنی	b e m a ʔ n iː
بی‌مغز	b e m a ɢ z
بی‌میل	b e m a j l
بی‌هوش	b e h s ʃ
بی‌گناه	b e ɡ u n ɑː h
بەت	b ɑː t
تأکید	t a ʔ k i d
تا	t ɑː
تاج	t ɑː d͡ʒ
تاجور	t ɑː d ʒ v a ɾ
تاجگذاری	t ɑː d͡ʒ ɡ u z ɑː ɾ iː
تاجیکستان	t ɑː d͡ʒ iː k i s t ɑː n
تار	t ɑː ɾ
تاریخ	t ɑː ɾ iː x
تاریخچه	t ɑː ɾ iː x t͡ʃ a
تاریک‌تر	t ɑː ɾ iː k t a ɾ
تاریک‌ترین	t ɑː ɾ iː k t a ɾ iː n
تازه	t ɑː z a
تازه‌تر	t ɑː z e t a ɾ
تازه‌ترین	t ɑː z e t a ɾ iː n
تازگی	t ɑː z a ɡ iː
تاکنون	t ɑː k u n uː n
تب	t a b
تباه	t a b ɑː h
تبدیل	t a b d i l
تبر	t a b a ɾ
تبریک	t a b ɾ i k
تجربه	t a d͡ʒ ɾ i b a
تجربی	t a d ʒ ɾ o b iː
تحت	t a h t i
تحصیل	t a h s i l
تحفه	t o h f e
تحقیق	t a h ɢ i ɢ
تحویل	t a h v i l
تخت	t a x t
تختخواب	t a x t i x ɑː b
تخته	t a x t a
تخریب	t a x ɾ i b
تخم	t o x m
تدریج	t a d ɾ i d͡ʒ
تذرو	t a z a ɾ v
ترازو	t a ɾ ɑː z uː
ترجمه	t a ɾ d͡ʒ u m a
ترسایی	t æ ɾ s ɒː j iː
ترسیدن	t a ɾ s i d a n
ترش	t o ɾ ʃ
ترشه	t o ɾ ʃ e
ترشی	t o ɾ ʃ iː
ترنج	t o ɾ o n d͡ʒ
ترک	t a ɾ k
ترکیدن	t a ɾ a k iː d a n
ترگمان	t a ɾ ɡ u m ɑː n
تزیین	t a z j i n
تسخیر	t a s x i ɾ
تسو	t a s u
تشریح	t a ʃ ɾ e h
تشکر	t a ʃ a k k u ɾ
تشکیل	t a ʃ k i l
تصحیح	t a s h e h
تصمیم	t a s m i m
تصویب	t a s v i b
تصویر	t a s v i ɾ
تعارف	t a ʔ ɑː ɾ u f
تعجب	t a ʔ a d d͡ʒ u b
تعداد	t e ʔ d ɑː d
تعریف	t a ʔ ɾ i f
تعظیم	t a ʔ z i m
تعلق	t a ʔ a l l u ɢ
تعلیم	t a ʔ l i m
تغییر	t a ɢ j i ɾ
تغییرات	t a ɢ j iː ɾ ɑː t
تفاوت	t a f ɑː v u t
تفسیدن	t a f s i d a n
تفلیس	t e f l iː s
تفنگ	t o f a n ɡ
تقدیر	t a ɢ d i ɾ
تقریبا	t a ɢ ɾ iː b a n
تقریباً	t a ɢ ɾ i b a n
تقسیم	t a ɢ s i m
تقصیر	t a ɢ s iː ɾ
تقوا	t a ɢ v ɑː
تقویت	t a ɢ v i j a t
تقویم	t a ɢ v i m
تلخ	t a l x
تلف	t a l a f
تلویحی	t a l v iː h iː
تمام	t a m ɑː m
تمبر	t a m b ɾ
تمثیل	t a m s i l
تمر	t a m u ɾ
تمرین	t a m ɾ i n
تمساح	t e m s ɑː h
تمیز	t a m i z
تمیزترین	t æ m iː z t æ ɾ iː n
تنبان	t o m b ɑ n
تنبسه	t a n b a s a
تندیس	t a n d iː s
تنها	t a n h ɑː
تنیدن	t a n iː d a n
تنیسور	t e n iː s o ɾ
تنیس‌باز	t e n iː s b ɑː z
تهدید	t a h d i d
تهران	t a h ɾ ɑː n
تهرون	t e h ɾ uː n
تهیه	t a h i j j a
توجه	t a v a d d͡ʒ s h
تودری	t u d a ɾ iː
تور	t o v a ɾ
توریستی	t u ɾ i s t
توزیع	tʰ o ʊ̯ z iː ʔ
توسط	t a v a s u t i
توسعه	t a v s i ʔ a
توسی	t uː s iː
توصیه	t a v s i j a
توضیح	t a v z e h
تولد	t a v a l l u d
تولید	t a v l i d
توپ	t oː p
توپولوژی	t o p o l o ʒ iː
توپچى	t oː p t͡ʃ iː
تک	t a k
تکرار	t a k ɾ ɑː ɾ
تکفور	t æ k f uː ɾ
تکواژ	t a k v a ʒ
تکور	t a k v o ɾ
تکوک	t a k oː k
تکیدن	t a k i d a n
تکیه	t a k j a
تیرداد	t i ɾ d ɑː d
تیز	t e z
تیله	t e l a
تیهو	t i h s
ثابت	s ɒː b e tʰ
ثابت‌ها	s ɑː b e t h ɑː
ثانیه	s ɑː n i j a
ثبت	s a b t
ثروت	s a ɾ v a t
جا	d͡ʒ ɑː j
جادو	d͡ʒ ɑː d uː
جاذبه	d͡ʒ ɑː z i b a
جاری	d͡ʒ ɑː ɾ i
جام	d͡ʒ ɑː m
جامعه‌شناس	d͡ʒ ɑː m i ʔ a ʃ i n ɑː s
جامعه‌شناسی	d͡ʒ ɑː m i ʔ a ʃ i n ɑː s iː
جانباز	d͡ʒ ɑː m b ɑː z
جانورشناسی	d͡ʒ ɑː n v a ɾ ʃ i n ɑː s iː
جایگاه	d͡ʒ ɑː j ɡ ɑː h
جبار	d ʒ a b ɑː ɾ
جبران	d͡ʒ o b ɾ ɑː n
جبهه	d͡ʒ e b h e
جدید	d͡ʒ a d i d
جرم	d͡ʒ e ɾ m
جریان	d͡ʒ a ɾ a j ɑː n
جزدان	d͡ʒ o z d ɑː n
جزیره	d͡ʒ a z i ɾ a
جستجو	d͡ʒ o s t o d͡ʒ uː j
جستن	d͡ʒ a s t a n
جسور	d͡ʒ a s u ɾ
جشن	d͡ʒ a ʃ n
جعفر	d͡ʒ a ʔ f a r
جعفری	d͡ʒ æ ʔ f æ ɾ iː
جلسه	d͡ʒ a l a s a
جلوگیری	d͡ʒ e l o v ɡ iː ɾ iː
جمعه	d͡ʒ o m e
جمعیت	d͡ʒ a m ʔ i j j a t
جمله	d͡ʒ o m l e
جمهوری	d͡ʒ o m h uː ɾ iː
جنسی	d͡ʒ e n s iː
جنوب	d͡ʒ a n u b
جنون	d ʒ o n uː n
جنگجو	d͡ʒ a n ɡ d͡ʒ u
جنگل	d ʒ a n ɡ a l
جهان	d͡ʒ a h ɑː n
جهانگیر	d͡ʒ a h ɑː n ɡ iː ɾ
جو	d͡ʒ a v
جواب‌ها	d ʒ a v ɑː b h ɑː
جواری	d͡ʒ o v ɑː ɾ iː
جوان	d͡ʒ a v ɑː n
جوانی	d͡ʒ a v ɑː n iː
جور	d͡ʒ u ɾ
جوراب	d ʒ oː ɾ ɑː b
جوره	d͡ʒ oː ɾ a
جوهر	d͡ʒ a v h a ɾ
جویبار	d͡ʒ oː j b ɑː ɾ
جویدن	d͡ʒ a v i d a n
جگر	d ʒ e ɡ a ɾ
جیب	d͡ʒ e b
حاجت	h ɑː d͡ʒ a t
حاد	h ɑː d
حادثه	h ɑː d i s a
حاشیه	h ɑː ʃ i j a
حاصل	h ɑː s i l
حافظ	h ɑː f e z
حالا	h ɑː l ɑː
حتما	h a t m a n
حتی	h a t t ɑː
حج	h a d d͡ʒ
حجاب	h e d͡ʒ ɑː b
حجره	h o d͡ʒ ɾ e
حدادی	h a d ɑː d iː
حداکثر	h a d d i a k s a ɾ
حرب	h a ɾ b
حرص	h e ɾ s
حرف	h a ɾ f
حرفه	h e ɾ f e
حرکت	h a ɾ a k a t
حساب	h e s ɑː b
حسن	h a s a n
حسود	h a s u d
حسینقلی	h o s e j n ɢ o l iː
حشیش	h a ʃ i ʃ
حضور	h o z uː ɾ
حفاظت	h e f ɑː z a t
حق	h a ɢ ɢ
حقوق	h o q u q
حقیقت	h a ɢ i ɢ a t
حقیقی	h a ɢ i ɢ iː
حلال	h a l ɑː l
حلوا	h a l v ɑː
حماس	h a m ɑː s
حمام	h a m m ɑː m
حمایت	h e m ɑː j a t
حکایت	h e k ɑː j a t
حکم	h o k m
حکومت	h o k uː m a t
حیران	h a i ɾ ɑː n
حیوان	h a j v ɑː n
خات	x ɑː t
خاتم	x ɑː t a m
خاتون	x ɑː t uː n
خاده	x ɑː d a
خار	x ɑː ɾ
خارج	x ɑː ɾ i d͡ʒ
خارجه	x ɑː ɾ i d͡ʒ a
خارجی	x ɑː ɾ i d͡ʒ iː
خارگیل	x ɑː ɾ ɡ iː l
خاص	x ɑː s
خاص‌تر	x ɑː s t a ɾ
خاص‌ترین	x ɒː s tʰ æ ɾ iː n
خاطب	x ɑː t i b
خاطره	x ɑː t i ɾ a
خاقان	x ɑː ɢ ɑː n
خال	x ɑː l
خالق	x ɑː l i ɢ
خاله	x ɑː l a
خالو	x ɑː l uː
خالی	x ɑː l iː
خام	x ɑː m
خامه	x ɑː m a
خاموش	x ɑː m oː ʃ
خان	x ɑː n
خاندان	x ɑː n d ɑː n
خانقاه	x ɑː n ɢ ɑː h
خانه	x ɑː n a
خانواده	x ɑː n a v ɑː d a
خانگی	x ɑː n a ʔ ɡ iː
خاور	x ɑː v a ɾ
خاویار	x ɑː v i j ɑː ɾ
خاک	x ɑː k
خاکروبه	x ɑː k ɾ oː b a
خاکستر	x ɑː k i s t a ɾ
خاکستری	x ɑː k i s t a ɾ iː
خباز	x a b b ɑː z
خبری	x a b a ɾ j a
ختم	x a t m
ختنه	x a t n e
ختنه‌گاه	x a t n a ɡ ɑː h
ختو	x o t uː
خداحافظ	x o d ɑː h ɑː f e z
خدای	x o d ɑː j
خدایی	x o d ɑː j iː
خدشه	x a d ʃ a
خدمت	x e d m a t
خدنگ	x a d a n ɡ
خدیو	x a d e v
خراب	x a ɾ ɑː b
خراسان	x o ɾ ɑː s ɑː n
خراسانی	x o ɾ ɑː s ɑː n iː
خرامیدن	x e ɾ ɑː m iː d a n
خربز	x a ɾ b u z
خربزه	x a ɾ b u z a
خربوزه	x a ɾ b u z a
خرداد	x o ɾ d ɑː d
خرم	x o ɾ a m
خروس	x o ɾ uː s
خرگوش	x a ɾ ɡ oː ʃ
خرید	h a ɾ i d
خز	x a z
خزاعی	x a z ɑː ʔ iː
خزان	x a z ɑː n
خزنده	x æ z æ n d e
خزندگان	x a z a n d e ɡ ɑː n
خزیدن	x a z i d a n
خزینه	x a z i n a
خسته	x a s t a
خسته‌خانه	x a s t a x ɑː n a
خستگی	x a s t i ɡ iː
خسران	x o s ɾ ɑː n
خسروانی	x o s ɾ a v ɑː n iː
خسیس	x a s i s
خشاب	x e ʃ ɑː b
خشمگین	x a ʃ m ɡ i n
خشونت	x o ʃ uː n a t
خشک	x o ʃ k
خشکوندن	x o ʃ k uː n d æ n
خصوصا	x o s uː s a n
خصومت	x o s uː m a t
خط	x a t
خطا	x a t ɑː
خفگی	x a f i ɡ iː
خلاف	x e l ɑː f
خلوت	x a l v a t
خلیج	x a l i d͡ʒ
خنجر	x a n d͡ʒ a ɾ
خندان	x a n d ɑ n
خندق	x a n d a ɢ
خنده	x a n d a
خندون	x æ n d uː n
خندیدن	x a n d i d a n
خنیا	x o n i j ɑː
خو	x o
خواب	x ɑː b
خوابیدن	x ɑː b iː d a n
خواجه	x ɑː d͡ʒ a
خوار	x ɑː ɾ
خواستار	x ɑː s t ɑː ɾ
خواستن	x ɑː s t a n
خوان	x ɑː n
خواندن	x ɑː n d a n
خوانش	x ɑː n e ʃ
خواننده	x ɑː n a n d a
خوانندگان	x ɑː n a n d e ɡ ɑː n
خواه	x ɑː h
خواهر	x ɑː h a ɾ
خواهش	x ɑː h e ʃ
خود	x o d
خودنویس	x o d n e v iː s
خودکار	x o d k ɑː ɾ
خور	x o ɾ
خوراندن	x o ɾ ɑː n d a n
خوراک	x o ɾ ɑː k
خوردن	x o ɾ d a n
خورشید	x o ɾ ʃ iː d
خوره	x o r a h
خوش	x o ʃ
خوشاب	x u ʃ ɑː b
خوشبخت	x o ʃ b a x t
خوشبو	x o ʃ b uː j
خوشحال	x o ʃ h ɑː l
خوشنویس	x o ʃ n e v iː s
خوشنویسی	x o ʃ n e v iː s iː
خوشه	x oː ʃ a
خوشگل	x o ʃ ɡ e l
خوشگل‌تر	x o ʃ ɡ e l t a ɾ
خوشگل‌ترین	x o ʃ ɡ e l t a ɾ iː n
خوف	x a v f
خوفناک	x a v f n ɑː k
خون	x u n
خونه	x oː n æ
خونین	x u n i n
خون‌شناسی	x u n ʃ i n ɑː s iː
خوک	x uː k
خویش	x e ʃ
خیابان	x i j ɑː b ɑː n
خیال	x a j ɑː l
خیز	x e z
خیس	x iː s
خیلی	x a j l e
خیم	x iː m
خەر	x ɑː ɾ
داد	d ɑː d
دادار	d ɑː d ɑː r
دادگاه	d ɑː d ɡ ɑː h
دارفلفل	d ɑː ɾ f i l f i l
دارم	d ɑː ɾ a m
دارو	d ɒː ɾ uː
داروساز	d ɑː ɾ uː s ɑː z
داروسازی	d ɑː ɾ uː s ɑː z iː
داروشناس	d ɑː ɾ uː ʃ i n ɑː s
داستان	d ɑː s t ɑː n
داشتن	d ɑː ʃ t a n
داغ	d ɒː ɣ
دانستن	d uː n e s t a n
دانشجو	d ɑː n i ʃ d͡ʒ uː j
دانشمند	d ɑː n i ʃ m a n d
دانشکده	d ɑː n i ʃ k a d a
دانشگاه	d ɑː n i ʃ ɡ ɑː h
داوود	d ɑː v uː d
دجله	d e d͡ʒ l e
در	d a ɾ
درآمد	d a ɾ ɑː m a d
دراز	d a ɾ ɑː z
دراییدن	d a ɾ ɑː j iː d a n
دربار	d a ɾ b ɑː ɾ
درباره	d a ɾ b ɑː ɾ a j i
دربان	d a ɾ b ɑː n
درجه	d a ɾ a d͡ʒ a
درخت	d a ɾ a x t
درد	d a ɾ d
دردمند	d a ɾ d m a n d
دردناک	d a ɾ d n ɑː k
درزی	d æ ɾ z iː
درست	d o ɾ o s
درشت	d o ɾ o ʃ t
درفش	d a ɾ a f ʃ
درمانگاه	d a ɾ m ɑː n ɡ ɑː h
درنگ	d e ɾ a n ɡ
درها	d æ ɾ h ɒː
درود	d a ɾ oː d
درودن	d o ɾ uː d a n
دروغ	d o ɾ uː ɢ
دروغ‌ها	d o ɾ uː ɢ h ɑː
درویش	d a ɾ v e ʃ
درگاه	d a ɾ ɡ ɑː h
دری	d a ɾ iː
دریا	d a ɾ j ɑː
دریافت	d a ɾ j ɑː f t
دریدن	d a ɾ i d a n
دزد	d o z d
دس	d a s
دست	d a s t
دستار	d a s t ɑː ɾ
دستاویز	d a s t ɑː v e z
دستمال	d a s t m ɑː l
دستور	d a s t u ɾ
دستکند	d a s t k a n d
دستگاه	d a s t ɡ ɑː h
دشوار	d o ʃ v ɑː ɾ
دعا	d o ʔ ɑː
دفاع	d e f ɑː ʔ
دفتر	d a f t a r
دقت	d e ɢ ɢ a t
دل	d e l
دلاور	d e l ɑː v a ɾ
دلبستگی	d e l b a s t e ɡ iː
دلسوز	d i l s oː z
دلفین	d o l f iː n
دلگیر	d e l ɡ iː ɾ
دلگیری	d e l ɡ iː ɾ iː
دلیل	d a l i l
دم	d a m
دما	d a m ɑː
دماسنج	d a m ɑː s a n d͡ʒ
دماغ	d a m ɑː ɢ
دندان	d a n d ɑː n
دنیدن	d a n iː d a n
دنیوی	d o n j a v e
ده	d a h
دهان	d a h ɑː n
دهستان	d e h e s t ɑː n
دهقان	d e h ɢ ɑː n
دو	d o
دودل	d o d e l
دور	d a v ɾ
دوران	d a v a ɾ ɑː n
دوره	d a v ɾ a
دوست	d oː s t
دوش	d oː ʃ
دوغ	d oː ɢ
دول	d oː l
دولت	d a v l a t
دویدن	d a v i d a n
دپارتمان	d e p ɒ r tʰ e m ɒ n
دچار	d o t͡ʃ ɑː ɾ
دگر	d e ɡ a ɾ
دگرجنس‌گرا	d e ɡ a ɾ d͡ʒ e n s ɡ a ɾ ɑː
دیدن	d i d a n
دیر	d a j ɾ
دیروز	d i ɾ s z
دیس	d e s
دیسال	d i s ɑː l
دیسک	d iː s k
دیسک‌ها	d iː s k h ɑː
دیشب	d i ʃ a b
دیم	d e m
دین‌داری	d i n d ɑː ɾ iː
دیو	d e v
دیوان	d e v ɑː n
دیوانه	d e v ɑː n a
دیوشناسی	d e v ʃ i n ɑː s iː
دیگدان	d e ɡ d ɑː n
دیگر	d i ɡ a ɾ
ذات	z ɑː t
ذاتی	z ɒː t iː
ذبح	z e b h
ذرت	z o r a t
ذره	z a r r a
ذهن	z e h n
ذکر	z a k a ɾ
رأی	ɾ a ʔ j
را	ɾ ɑː
رابط	ɾ ɑː b i t
رابطه	ɾ ɑː b i t a
راجستان	ɾ ɑː d͡ʒ a s t a n
راحت	ɾ ɑː h a t
رازی	ɾ ɑː z iː
راستگو	ɾ ɑː s t ɡ uː
رام	ɾ ɑː m
ران	ɾ ɑː n
راهب	ɾ ɑː h i b
رایانه	ɾ ɑː j ɑː n a
رب	ɾ a b
رباعی	ɾ o b ɑː ʔ iː
ربع	ɾ o b ʔ
رتیل	ɾ o t e j l
رحیم	r æ h iː m
رخ	r o x
رخام	ɾ o x ɑː m
رختن	r e x t æ n
رد	ɾ a d d
رده	ɾ a d a
رسانیدن	ɾ a s ɑː n iː d a n
رستن	ɾ o s t a n
رستوران	r e s t o ɾ ɑː n
رستوران‌ها	r e s t o ɾ ɒː n h ɒː
رسیدن	ɾ a s i d a n
رشت	r o ʃ t
رشد	ɾ o ʃ d
رضا	ɾ e z ɑː
رعد	ɾ a ʔ d
رعنا	ɾ a ʔ n ɑː
رغبت	r a ɢ b a t
رفتار	ɾ a f t ɑː ɾ
رفدن	ɾ a f d a n
رقص	ɾ a ɢ s
رم	ɾ a m
رمضان	ɾ a m a z ɑː n
رنده	ɾ a n d a
رندیدن	ɾ a n d i d a n
رنگ	ɾ a n ɡ
رنگارنگ	ɾ a n ɡ ɑː ɾ a n ɡ
رنگین	ɾ a n ɡ i n
ره	r a h
رهبر	ɾ a h b a ɾ
روادید	r a v ɑː d iː d
رواق	ɾ e v ɑː ɢ
روباه	ɾ oː b ɑː h
روح	ɾ uː h
روحانی	r o ʊ h ɒː n iː
رودابه	ɾ uː d ɑː b e
رودخانه	ɾ oː d x ɑː n a
روز	ɾ oː z
روزنامه	ɾ oː z n ɑː m a
روزگار	ɾ oː z i ɡ ɑː ɾ
روس	ɾ u s
روسی	ɾ u s iː
روسیه	ɾ u s i j a
روش	ɾ a v i ʃ
روشن	ɾ a v ʃ a n
روشنگری	ɾ a v ʃ a n ɡ a ɾ iː
رومی	ɾ oː m iː
رونق	ɾ a v n a ɢ
رژیمان	ɾ e ʒ i m ɑ n
ریدک	r e j d a k
ریز	ɾ e z
ریشه	ɾ e ʃ a
ریشه‌شناسی	ɾ e ʃ a ʃ i n ɑː s iː
زئوس	z e uː s
زافه	z a f a
زال	z ɑː l
زان	z ɑː n
زانو	z ɑː n uː
زاوش	z ɑː v u ʃ
زبان	z a b ɑː n
زبان‌ها	z a b ɑː n h ɑː
زحمت	z a h m a t
زدن	z a d a n
زراوند	z a ɾ ɑː v a n d
زرشک	z e ɾ e ʃ k
زرشکی	z e ɾ e ʃ k iː
زرناپا	z u r n ɑː p ɑː
زره	z e ɾ e h
زشت	z e ʃ t
زغال	z o ɢ ɑː l
زقاق	z o ɢ ɑː ɢ
زلیخا	z o l e j x ɑː
زمان	z a m ɑː n
زمستان	z e m e s t ɑː n
زمی	z m iː
زمین‌شناسی	z a m i n ʃ i n ɑː s iː
زنانه	z a n ɑː n a
زنانگی	z a n ɑː n a ɡ iː
زنبق	z a m b a ɢ
زنجبیل	z a n d͡ʒ a b iː l
زنخ	z a n a x
زندان	z e n d ɑː n
زندانی	z e n d ɑː n iː
زندگی	z e n d e ɡ iː
زهر	z a h ɾ
زوال	z a v ɑː l
زوج	z a v d͡ʒ
زوجیت	z a v d͡ʒ i j a t
زود	z u d
زور	z a v ɾ
زورخانه	z oː ɾ x ɑː n a
زورمند	z oː ɾ m a n d
زوش	z u ʃ
زوو	z v oː
زیاد	z i j ɑː d
زیبا	z e b ɑː
زیباتر	z iː b ɑː t a ɾ
زیباترین	z iː b ɑː t a ɾ iː n
زیبیدن	z e b i d a n
زیر	z e ɾ
زیرزمین	z iː ɾ z a m iː n
زیرسیگاری	z iː ɾ s iː ɡ ɑː ɾ iː
زیره	z iː ɾ e
زیرک	z i ɾ a k
زیستن	z i s t a n
زیست‌شناس	z iː s t ʃ e n ɑː s
زیست‌شناسی	z iː s t ʃ e n ɑː s iː
زین	z i n
زیویدن	z iː v iː d a n
ساحل	s ɑː h i l
ساختمان	s ɑː x t i m ɑː n
ساختن	s ɑː x t a n
ساده	s ɑː d a
ساده‌تر	s ɑː d e t a ɾ
ساده‌ترین	s ɑː d e t a ɾ iː n
سادگی	s ɑː d a ɡ iː
ساز	s ɑː z
سازش	s ɑː z i ʃ
سازمان	s ɑː z i m ɑː n
سال	s ɑː l
سالار	s ɑː l ɑː ɾ
سالن	s ɑː l o n
سالگرد	s ɑː l ɡ a ɾ d
سالگی	s ɑː l a ɡ iː
سامان	s ɑː m ɑː n
سامانه	s ɑː m ɑː n a
سامانه‌ها	s ɒː m ɒː n e h ɒː
ساکاستان	s ɑː k ɑː s t ɑː n
سایه	s ɑː j a
سبد	s a b a d
سبزه	s e b z a
سبزی	s a b z iː
سبک	s a b k
ستاره	s e t ɑː ɾ e
ستاره‌شناس	s e t ɑː ɾ e ʃ e n ɑː s
ستان	e s t ɑː n
ستبر	s e t a b ɾ
ستوان	s o t v ɑː n
ستور	s o t uː ɾ
ستون	s o t uː n
سجستان	s a d͡ʒ a s t ɑː n
سحر	s a h a ɾ
سخت	s a x t
سختن	s o x t a n
سخن	s o x a n
سخنرانی	s o x a n ɾ ɑː n iː
سخنگو	s o x a n ɡ uː
سده	s a d a
سرانجام	s a ɾ a n d͡ʒ ɑː m
سرای	s a ɾ ɑː j
سرب	s o ɾ b
سرجوخه	s a ɾ d͡ʒ u x a
سرحد	s a ɾ h a d
سرخ	s o ɾ x
سرداب	s a ɾ d ɑː b
سردار	s a ɾ d ɑː ɾ
سرعت	s o ɾ ʔ a t
سرفراز	s a ɾ f a ɾ ɑː z
سرمایه	s a ɾ m ɑː j a
سرمه	s a ɾ m a
سرندیپ	s a r a n d iː p
سرنشین	s a ɾ n i ʃ i n
سرهنگ	s a ɾ h a n ɡ
سرودن	s o ɾ uː d a n
سرور	s a ɾ v a ɾ
سرپرستی	s a ɾ p a ɾ a s t iː
سرپوش	s a ɾ p oː ʃ
سرچشمه	s a ɾ t͡ʃ a ʃ m a
سرکار	s a ɾ k ɑː ɾ
سرکه	s e ɾ k e
سرگیجه	s a ɾ ɡ i d͡ʒ a
سری	s a ɾ iː
سریانی	s o ɾ j ɑː n iː
سریدن	s o ɾ iː d a n
سطح	s a t h
سعی	s a ʔ j
سعید	s a ʔ i d
سفارش	s e f ɑː ɾ e ʃ
سفارشی	s e f ɑː ɾ e ʃ iː
سفر	s a f a ɾ
سفره	s o f ɾ e
سفید	s a f e d
سفینه	s a f i n a
سقرلات	s a ɢ i ɾ l ɑː t
سقف	s a ɢ f
سقوط	s o ɢ uː t
سلاح	s e l ɑː h
سلجوق	s a l d͡ʒ u ɢ
سلسله	s e l s e l e
سلماس	s a l m ɑː s
سلیمان	s o l e j m ɑː n
سلیمانی	s o l e j m ɑː n iː
سمع	s a m ʔ
سمفونی	s a m f oː n iː
سمند	s a m a n d
سمور	s a m oː ɾ
سنان	s e n ɑː n
سنبه	s o m b e
سنبوسه	s a m b oː s a
سنجاب	s a n d͡ʒ ɑː b
سند	s e n d
سنگ	s a n ɡ
سنگسار	s a n ɡ s ɑː ɾ
سنگواره	s a n ɡ v ɑː ɾ a
سنگین	s a n ɡ i n
سه	s e
سهل	s a h l
سهم	s a h m
سهمگین	s a h m ɡ i n
سه‌بعدی	s e b o ʔ d iː
سه‌شنبه	s e ʃ a n b e
سوت	s oː t
سوخ	s oː x
سوخته	s uː x t e
سورپرایز	s u r p e ɾ ɑ j z
سورپریز	s u r p i ɾ i z
سوز	s oː z
سوزش	s oː z i ʃ
سوزن	s u z a n
سوسمار	s uː s m ɑː r
سوسن	s oː s a n
سوگ	s oː ɡ
سوگند	s a v ɡ a n d
سوی	s oː j
سپاه	s e p ɑː h
سپاهی	s e p ɑː h iː
سپر	s e p a ɾ
سپندان	s e p a n d ɑː n
سپهسالار	s e p a h s ɑː l ɑː ɾ
سکه	s e k e
سگ	s a ɡ
سگالیدن	s e ɡ ɑː l iː d a n
سیاح	s a j j ɑː h
سیاره‌ها	s a j ɑː ɾ e h ɑː
سیاست	s i j ɑː s a t
سیاه‌گوش	s i j ɑː h ɡ oː ʃ
سیب	s e b
سیبویه	s i b u j a
سیستم	s iː s t e m
سیل	s a j l
سیلاب	s a j l ɑː b
سیلابی	s a j l ɑː b e
سیلاس	s iː l ɑː s
سیلو	s i l u
سیم	s e j o m
سیماب	s i m ɑː b
سیمرغ	s i m u ɾ ɢ
سینا	s iː n ɑː
سینه	s i n a
شات	ʃ ɑː t
شاخ	ʃ ɑ x
شاخه	ʃ ɑː x e
شاد	ʃ ɑː d
شاداب	ʃ ɑː d ɑː b
شادمان	ʃ ɑː d m ɑː n
شاذ	ʃ ɑː z
شاعر	ʃ ɑː ʔ i ɾ
شام	ʃ ɑː m
شامل	ʃ ɑː m i l
شاه	ʃ ɑː h
شاهان	ʃ ɑː h ɑː n
شاهانشاه	ʃ ɑː h ɑː n ʃ ɑː h
شاهد	ʃ ɑː h i d
شاهدخت	ʃ ɑː h d u x t
شاهزاده	ʃ ɑː h z ɑː d a
شاهزادگان	ʃ ɑː h z ɑː d e ɡ ɑː n
شاهقلی	ʃ ɑː h ɢ u l iː
شاهنامه	ʃ ɑː h n ɑː m a
شاهنشاه	ʃ ɑː h a n ʃ ɑː h
شاهکار	ʃ ɑː h k ɑː ɾ
شاهین	ʃ ɑː h iː n
شاه‌دانه	ʃ ɑː h d ɑː n a
شاپور	ʃ ɒː p uː ɾ
شاید	ʃ ɑː j a d
شایعه	ʃ ɑː j i ʔ a
شب	ʃ a b
شبانه	ʃ a b ɑː n a
شباهت	ʃ a b ɑː h a t
شبنم	ʃ a b n a m
شترخار	ʃ o t o ɾ x ɑː ɾ
شترغار	ʃ o t o ɾ ɢ ɑː ɾ
شترمرغ	ʃ o t o ɾ m o ɾ ɢ
شترگاوپلنگ	ʃ o t o ɾ ɡ ɑː v p a l a n ɡ
شجاعت	ʃ a d͡ʒ ɑ ʔ a t
شجر	ʃ æ d ʒ æ r
شخص	ʃ a x s
شخصیت	ʃ a x s i j a t
شد	ʃ o d
شدن	ʃ o d a n
شدنی	ʃ o d a n iː
شدید	ʃ a d i d
شراب	ʃ a ɾ ɑː b
شرط	ʃ a ɾ t
شروع	ʃ o r uː ʔ
شرک	ʃ e ɾ e k
شرکت	ʃ e ɾ k a t
شریک	ʃ a ɾ i k
شستن	ʃ o s t a n
شش	ʃ a ʃ
شطرنج‌باز	ʃ a t ɾ a n d͡ʒ b ɑː z
شعب	ʃ o ʔ a b
شعبه	ʃ o ʔ b e
شعر	ʃ e ʔ ɾ
شعله	ʃ o ʔ l e
شغال	ʃ o ɢ ɑː l
شغال‌ها	ʃ o ɢ ɑː l ɑː
شغل	ʃ o ɢ l
شفقت	ʃ a f a ɢ a t
شلغم	ʃ a l ɢ a m
شلوار	ʃ a l v ɑː ɾ
شلوغ	ʃ o l uː ɢ
شلوغ‌تر	ʃ o l uː ɣ t æ ɾ
شلوغ‌ترین	ʃ o l uː ɢ t a ɾ iː n
شماره	ʃ o m ɑː ɾ e
شماریدن	ʃ o m ɑː ɾ iː d a n
شمال	ʃ o m ɑː l
شمسی	ʃ a m s iː
شمعدان	ʃ a m ʔ d ɑː n
شناختن	ʃ e n ɑː x t a n
شناسی	ʃ e n ɑː s iː
شنبه	ʃ a n b a
شنفتن	ʃ e n o f t a n
شنیدن	ʃ e n iː d a n
شهادت	ʃ a h ɑː d a t
شهد	ʃ a h d
شهر	ʃ a h ɾ
شهرت	ʃ o h ɾ a t
شهرزاد	ʃ a h ɾ z ɑː d
شهری	ʃ a h ɾ iː
شهریور	ʃ a h ɾ iː v a ɾ
شهنشاه	ʃ a h a n ʃ ɑː h
شهوت	ʃ a h v a t
شهوتی	ʃ a h v a t iː
شهود	ʃ o h uː d
شو	ʃ o v
شوخی	ʃ oː x iː
شور	ʃ oː ɾ
شوربا	ʃ oː ɾ b ɑː
شوره	ʃ oː ɾ e
شوروی	ʃ uː ɾ æ v iː
شوریدن	ʃ oː ɾ iː d a n
شوق	ʃ a v ɢ
شوهر	ʃ a v h a ɾ
شوکران	ʃ a v k a ɾ ɑː n
شوید	ʃ e v iː d
شپش	ʃ e p e ʃ
شپش‌ها	ʃ e p e ʃ h ɑː
شک	ʃ ɑː k k
شکافتن	ʃ e k ɑː f t a n
شکال	ʃ e k ɑː l
شکایت	ʃ e k ɑː j a t
شکستن	ʃ e k a s t a n
شکستنی	ʃ i k a s t a n iː
شکسته‌نستعلیق	ʃ e k a s t e n a s t a ʔ l iː ɢ
شکلاتی	ʃ o k o l ɑ t i
شکم	ʃ e k a m
شکوفه	ʃ e k uː f e
شکیفتن	ʃ e k iː f t a n
شگفت	ʃ e ɡ e f t
شیدا	ʃ e j d ɑː
شیراز	ʃ e ɾ ɑː z
شیردال	ʃ e ɾ d ɑː l
شیرین	ʃ i ɾ i n
شیرین‌تر	ʃ iː ɾ iː n t a ɾ
شیرین‌ترین	ʃ iː ɾ iː n t a ɾ iː n
شیشه	ʃ i ʃ a
شیطان	ʃ a j t ɑː n
شیطانی	ʃ a j t ɑː n iː
شیمی	ʃ iː m iː
شیوا	ʃ e v ɑː
شیک	ʃ iː k
صاحب	s ɑː h i b
صادق	s ɑː d i ɢ
صاعقه	s ɑː ʔ i ɢ a
صبحانه	s o b h ɑː n e
صبور	s a b u ɾ
صحبت	s o h b a t
صحنه	s a h n e
صحیح	s a h e h
صدا	s æ d ɒː
صدمه	s a d a m a
صرع	s a ɾ ʔ
صرف	s e ɾ f
صفت	s e f a t
صفحه‌کلید	s a f h a k a l i d
صلح	s u l h
صمیمی	s a m i m iː
صندلی	s a n d a l iː
صنعت	s a n ʔ a t
صنعتی	s a n ʔ a t iː
صنف	s a n f
صنم	s a n a m
صنوبر	s a n a v b a ɾ
صهیونی	s a h j u n iː
صهیونیسم	s a h j u n i s m
صوت	s a v t
صورت	s u ɾ a t
صورتى	s u ɾ a t iː
صورتی	s uː ɾ a t iː
صیغه	s iː ɢ a
ضخیم	z a x iː m
ضربان	z æ ɾ æ b ɒː n
ضعف	z a ʔ f
ضلع	z e l ʔ
ضمیر	z a m i ɾ
طاس	t ɒː s
طاقت	t ɑː ɢ a t
طب	t e b
طبق	t a b a ɢ
طبقه	t a b a ɢ a
طرح	t a ɾ h
طرف	t a ɾ a f
طعم	t a ʔ m
طلا	t e l ɑː
طلاق	t a l ɑː ɢ
طلایی	t a l ɑː j iː
طمطراق	t o m t o ɾ ɑː ɢ
طور	t a v ɾ
طوفان	t u f ɑː n
طول	t u l
ظاهر	z ɑː h i ɾ
ظرف	z a ɾ f
ظهر	z o h ɾ
ظهور	z o h uː ɾ
عادی	ʔ ɑː d iː
عاصی	ʔ ɒː s iː
عالی	ɑː l iː
عام‌المنفعه	ʔ ɑː m o l m a n f a ʔ e
عباء	a b ɑː
عباسی	ʔ a b b ɑː s iː
عثمان	o s m ɑː n
عجان	ʔ e d ʒ ɑː n
عجب	ʔ a d͡ʒ a b
عجیب‌تر	a d ʒ iː b t a ɾ
عجیب‌ترین	a d ʒ iː b t a ɾ iː n
عدس	ʔ a d a s
عربستان	a ɾ a b i s t ɑː n
عربی	ʔ a ɾ a b iː
عرفان	ʔ e ɾ f ɑː n
عروس	ʔ a ɾ u s
عسل	a s a l
عشق	e ʃ ɢ
عشق‌آباد	e ʃ ɢ ɑː b ɑː d
عصبانی	a s a b ɑː n iː
عصمت	e s m a t
عضوها	o z v h ɒ
عطر	ʔ e t ɾ
عفت	ʔ e f f a t
عفو	ʔ a f v
عقرب	ʔ a ɢ ɾ a b
عقل	a ɢ l
علاءالدین	a l ɑː ʔ u d d i n
علاوه	a l ɑː v a
علت	e l l a t
علف	ʔ æ l æ f
عمر	o m a ɾ
عمق	o m ɢ
عمو	a m u
عمیق	a m iː ɢ
عنابی	a n ɑː b iː
عنایت	ʔ e n ɑː j a t
عنوان	o n v ɑː n
عکس	a k s
عیب	a j b
غار	ɢ ɑː ɾ
غارت	ɢ ɑː ɾ a t
غافت	ɢ ɑː f e t
غافث	ɢ ɑː f e s
غالب	ɢ ɑː l e b
غایب	ɢ ɑː j e b
غذا	ɢ e z ɑː
غرق	ɢ a ɾ ɢ
غریب	ɢ a ɾ iː b
غزال	ɢ a z ɑː l
غسل	ɢ o s l
غصه	ɢ o s s e
غلام	ɢ o l ɑː m
غلامی	ɢ o l ɑː m iː
غم	ɢ a m
غمناک	ɢ a m n ɑː k
غمگین	ɢ a m ɡ iː n
غمگینی	ɢ a m ɡ iː n iː
غور	ɢ o v ɾ
غژب	ɢ o ʒ b
غیرت	ɢ e j ɾ a t
ـی	e
ـیسم	i s m
فائده	f ɑː ʔ e d e
فاحش	f ɑː h e ʃ
فاخره	f ɑː x i ɾ a
فارسی	f ɑː ɾ s iː
فاس	f ɑː s
فاصله	f ɑː s i l a
فاعل	f ɑː ʔ i l
فامیل	f ɑː m iː l
فانوس	f ɑː n uː s
فانی	f ɑː n iː
فاک	f ɑː k
فایده	f ɑː j i d a
فر	f o ɾ
فرآیند	f a ɾ ɑː j a n d
فرارود	f a ɾ ɑː ɾ uː d
فرازمینی	f a ɾ ɑː z a m iː n iː
فراصوت	f a ɾ ɑː s a v t
فراموشی	f a ɾ ɑː m oː ʃ iː
فراموشیدن	f a ɾ ɑː m uː ʃ iː d a n
فرانسه	f a ɾ ɑː n s a
فرانسوی	f a ɾ ɑː n s a v iː
فرد	f a ɾ d
فردا	f a ɾ d ɑː
فردوس	f e ɾ d o v s
فرزندخوانده	f a ɾ z a n d x ɑː n d a
فرشته	f a ɾ i ʃ t a
فرق	f a ɾ ɢ
فرمان	f a ɾ m ɑː n
فرمانده	f a ɾ m ɑː n d i h
فرمایش	f a ɾ m ɑː j i ʃ
فرهنگ	f a ɾ h a n ɡ
فرودگاه	f o ɾ uː d ɡ ɑː h
فروردین	f a ɾ v a ɾ d iː n
فروغ	f o ɾ uː ɢ
فروهر	f o ɾ uː h a ɾ
فریب	f a ɾ e b
فریبا	f a ɾ e b ɑː
فریدون	f e ɾ e i d uː n
فریفتن	f a ɾ e f t a n
فسیل	f o s iː l
فشار	f e ʃ ɑː ɾ
فصل	f a s l
فصیح	f a s e h
فضا	f a z ɑː
فضازمان	f a z ɑː z a m ɑː n
فعالیت	f a ʔ ɑː l i j j a t
فعلا	f e ʔ l a n
فغفور	f a ɢ f uː ɾ
فقرا	f o ɢ a ɾ ɑː
فقط	f a ɢ a t
فقیر	f a ɢ i ɾ
فلاخن	f a l ɑː x a n
فن	f a n
فنجان	f e n d͡ʒ uː n
فهرست	f e h ɾ e s t
فهم	f a h m
فهماندن	f a h m ɑː n d a n
فهمیدن	f a h m i d a n
فوت	f a v t
فوج	f a v d͡ʒ
فوق‌العاده	f a v ɢ o l ʔ ɑ d a
فولاد	f oː l ɑː d
فک	f a k
فکاهی	f o k ɑː h iː
فکر	f e k
فیلیپ	f i l i p
قابل	ɢ ɑː b i l
قاتل	ɢ ɑː t i l
قاره	ɢ ɑː ɾ a
قاسم	ɢ ɑː s e m
قاشق	ɢ ɑː ʃ u ɢ
قاصدک	ɢ ɑː s i d a k
قاضی	ɢ ɑː z iː
قاطر	ɢ ɑː t i ɾ
قاقم	ɢ ɑː ɢ o m
قالب	ɢ ɑː l i b
قاموس	ɢ ɑː m uː s
قانون	ɢ ɑː n uː n
قاچاق	ɢ ɑː t͡ʃ ɑː ɢ
قاچاقچی	ɢ ɑː t͡ʃ ɑː ɢ t͡ʃ iː
قایق	ɢ ɒː j e ɣ
قبر	ɢ a b ɾ
قبرستان	ɢ a b ɾ i s t ɑː n
قبض	ɢ a b z
قبلا	ɢ a b l a n
قبول	ɢ a b u l
قبیح	ɢ a b e h
قدر	ɢ a d a ɾ
قدرت	ɢ u d ɾ a t
قدرتمند	ɢ u d ɾ a t m a n d
قدمت	ɢ i d m a t
قدومه	ɢ u d u m a
قدیمی	ɢ a d i m iː
قرآن	ɢ u ɾ ʔ ɑː n
قربک	ɢ o ɾ b a k
قرغیزستان	ɢ i ɾ ɢ iː z i s t ɑː n
قرمز	ɢ i ɾ m i z
قرمزی	ɢ i ɾ m i z iː
قرن	ɢ a ɾ n
قزاق	q æ z z ɒː q
قزوین	ɢ a z v i n
قسطنطنیه	ɢ u s t a n t a n i j a
قسم	ɢ a s a m
قسمت	ɢ i s m a t
قشنگ	ɢ e ʃ a n ɡ
قشنگی	q æ ʃ æ n ɡ iː
قصد	ɢ a s d
قصه	ɢ i s s a
قطار	ɢ a t ɑː ɾ
قطر	ɢ a t a ɾ
قطره	ɢ a t ɾ a
قطع	ɢ a t ʔ
قفس	ɢ a f a s
قفسه	ɢ æ f æ s e
قفل	ɢ u f l
ققنس	ɢ u ɢ n u s
ققنوس	ɢ u ɢ n u s
قلاوز	ɢ u l ɑː v u z
قلاووز	ɢ u l ɑː v uː z
قلبی	ɢ a l b iː
قلع	ɢ a l ʔ
قلعه	ɢ a l ʔ a
قلم	ɢ a l a m
قلمدان	ɢ a l a m d ɑː n
قلیان	ɢ a l j ɑː n
قمر	ɢ a m a ɾ
قند	ɢ a n d
قندهار	ɢ a n d a h ɑː ɾ
قندوز	ɢ o n d uː z
قهرمان	ɢ a h ɾ a m ɑː n
قهوه	ɢ a h v a
قهوه‌ای	ɢ a h v a ʔ iː
قهوه‌خانه	ɢ a h v a x ɑː n a
قو	ɢ u
قوم	ɢ a v m
قونیه	ɢ u n i j a
قید	ɢ e j d
قیصر	ɢ a j s a ɾ
قیمت	ɢ a j m a t
قیمتی	ɢ a j m a t iː
قیمه	ɢ a j m a
قیچی	ɢ a j t͡ʃ iː
كنج	k o n d͡ʒ
لابد	l ɑː b u d
لات	l ɑː t
لازم	l ɑː z i m
لاعلاج	l ɑː ʔ i l ɑː d͡ʒ
لاف	l ɑː f
لاله	l ɑː l e
لایه	l ɑː j e
لب	l a b
لبخند	l a b x a n d
لبی	l a b iː
لثه	l a s e
لجن	l a d͡ʒ a n
لحظه	l a h z a
لزوماً	l o z uː m a n
لسان	l e s ɑː n
لشکر	l a ʃ k a ɾ
لعل	l a ʔ l
لله	l a l a
لندن	l a n d a n
لنگر	l a n ɡ a ɾ
لهذا	l e h ɑː z ɑː
لهستان	l a h i s t ɑː n
لوبیا	l oː b i i ɑː
لوترا	l u t a ɾ ɑː
لوخن	l oː x a n
لوز	l a v z
لک	l a k
لی	l iː
لیمو	l i m u
لیو	l e v
لیوان	l iː v ɑː n
مؤدب	m o ʔ a d d e b
مؤسسه	m o ʔ a s s a s e
مؤمن	m o ʔ m e n
ما	m ɑː
ماجرا	m ɑː d͡ʒ a ɾ ɑː
مادر	m ɑː d a ɾ
مادرانه	m ɑː d a ɾ ɑː n a
مادربزرگ	m ɑː d a ɾ b u z u ɾ ɡ
مادیان	m ɑː d i i ɑː n
مارس	m ɑː ɾ s
مارمولک	m ɑː ɾ m uː l a k
مازندرانی	m ɑː z a n d a ɾ ɑː n iː
مازو	m ɑː z uː
مازوج	m ɑː z uː d͡ʒ
ماشین	m ɒː ʃ iː n
ماله	m ɑː l a
مالک	m ɑː l i k
مالی	m ɑː l iː
مالیات	m ɑː l iː j ɑː t
مامانی	m ɒː m ɒː n iː
ماندن	m ɑː n d a n
مانند	m ɑː n a n d i
ماهر	m ɑː h i ɾ
ماهواره	m ɑː h v ɑː ɾ a
ماهور	m ɑː h uː ɾ
ماک	m ɑː k
مایه	m ɒː j æ
مبهم	m o b h a m
متحد	m o t t a h e d
متخلف	m o t a x a l l e f
مترجم	m o t a ɾ d͡ʒ e m
متعلق	m o t a ʔ a l l e ɢ
متفاوت	m o t a f ɑː v e t
متوجه	m o t a v a d d͡ʒ e h
متوسط	m o t a v a s s e t
مثال	m e s ɑː l
مثلا	m a s a l a n
مجازات	m o d ʒ ɑː z ɑː t
مجازات‌ها	m o d ʒ ɒː z ɒː t h ɒː
مجبور	m a d͡ʒ b u ɾ
مجرد	m o d͡ʒ a ɾ ɾ a d
مجروح	m a d͡ʒ ɾ uː h
مجسمه	m o d͡ʒ a s s a m e
مجلس	m a d͡ʒ l i s
مجموعه	m a d͡ʒ m u ʔ a
مجید	m a d͡ʒ iː d
محافظه‌کار	m o h ɑː f e z e k ɑː ɾ
محبت	m a h a b b a t
محبوب	m a h b u b
محقق	m o h a ɢ ɢ e ɢ
محل	m a h a l l
محلی	m a h a l l iː
محمدقلی	m o h a m m a d ɢ o l iː
محیط	m o h iː t
مخاطب	m o x ɑː t a b
مخالف	m o x ɑː l e f
مختار	m o x t ɑː ɾ
مختل	m o x t a l
مختلط	m o x t a l e t
مخصوص	m a x s u s
مخمل	m a x m a l
مد	m o d
مدت	m o d d a t
مدرسه	m a d ɾ a s a
مدهوش	m a d h u ʃ
مذهبی	m a z h a b iː
مراسم	m a ɾ ɑː s i m
مربا	m o r a b b ɑ
مربوط	m a ɾ b u t
مرتب	m o ɾ a t t a b
مرتبه	m a ɾ t a b a
مرجان	m a ɾ d͡ʒ ɑː n
مرحله	m a ɾ h a l a
مرد	m a ɾ d
مرداد	m o ɾ d ɑː d
مردان	m a ɾ d ɑː n
مردانه	m a ɾ d ɑː n a
مردانگی	m a ɾ d ɑː n a ɡ iː
مردم	m a ɾ d u m
مردم‌سالاری	m a ɾ d u m s ɑː l ɑː ɾ iː
مردم‌شناس	m a ɾ d u m ʃ i n ɑː s
مردن	m o ɾ d a n
مردها	m a ɾ d h ɑː
مرشدقلی	m o ɾ ʃ e d ɢ o l iː
مرغ	m o ɾ ɢ
مرغاب	m o ɾ ɢ ɑː b
مرغان	m o ɾ ɢ ɑː n
مرغ‌ها	m o ɾ ɢ h ɑː
مرمی	m a r m iː
مرند	m a ɾ a n d
مرو	m a ɾ v
مرکب	m o ɾ a k k a b
مرکزی	m a ɾ k a z iː
مرگ	m a ɾ ɡ
مریض	m a ɾ i z
مریضی	m a ɾ iː z iː
مزنه	m o z n e
مزه	m a z z a
مس	m e s
مسئول	m a s ʔ u l
مسافت	m a s ɑː f a t
مسافر	m o s ɑː f e ɾ
مسافرت	m o s ɑː f e ɾ a t
مستعمره	m o s t a ʔ m a ɾ e
مستقیم	m o s t a ɢ iː m
مسجد	m a s d͡ʒ i d
مسعود	m æ s ʔ uː d
مسلحانه	m o s a l l a h ɑː n e
مسلمان	m o s a l m ɑː n
مسلمون	m o s a l m uː n
مسیح	m a s e h
مشارکت	m o ʃ ɑː ɾ e k a t
مشاهده	m o ʃ ɑː h a d e
مشاور	m o ʃ ɑː v e ɾ
مشتق	m o ʃ t a ɢ
مشرقی	m a ʃ ɾ i ɢ iː
مشرک	m o ʃ ɾ e k
مشعل	m a ʃ ʔ a l
مشغول	m a ʃ ɢ u l
مشق	m a ʃ ɢ
مشهور	m a ʃ h u ɾ
مشکل	m u ʃ k i l
مشکل‌تر	m o ʃ k e l t a ɾ
مشکل‌ترین	m o ʃ k e l t a ɾ iː n
مشکل‌ها	m o ʃ k e l h ɑː
مشکی	m e ʃ k iː
مصدر	m a s d a ɾ
مصر	m e s ɾ
مصون	m æ s uː n
مضحک	m o z h e k
مطبوعات	m a t b u ʔ ɑː t
مظهر	m a z h a ɾ
معادل	m o ʔ ɑː d e l
معالجه	m o ʔ ɒː l e d͡ʒ e
معاون	m o ʔ ɑː v e n
معتدل	m o ʔ t a d e l
معجزه	m o ʔ d͡ʒ e z e
معدنی	m a ʔ d a n iː
معده	m e ʔ d a
معراج	m e ʔ ɾ ɑː d͡ʒ
معروف	m a ʔ ɾ u f
معشوق	m a ʔ ʃ u ɢ
معلم	m o ʔ a l l e m
معمار	m e ʔ m ɑː ɾ
معماری	m e ʔ m ɑː ɾ iː
معمول	m a ʔ m u l
مغ	m a ɢ
مغازه	m a ɢ ɑː z a
مغرب	m a ɢ ɾ i b
مغرور	m æ ɣ ɾ uː ɾ
مغز	m a ɢ z
مفرط	m o f ɾ e t
مفعول	m a f ʔ u l
مقداد	m e ɢ d ɑː d
مقدار	m e ɢ d ɑː ɾ
مقدس	m o ɢ a d d a s
مقدماتی	m o ɢ a d d a m ɑː t iː
مقصد	m a ɢ s a d
مقعد	m a ɢ ʔ a d
مقعدی	m a ɢ ʔ a d iː
ملا	m o l ɑː
ملاقات	m o l ɑː ɢ ɑː t
ملت	m e l l a t
مله	m a l a
ملکه	m a l i k a
ملیت	m e l l i j a t
مملکت	m a m l a k a t
من	m a n
منازل	m a n ɑː z i l
مناسبت	m o n ɑː s e b a t
منبع	m a n b a ʔ
منتظر	m o n t a z e ɾ
منتقد	m o n t a ɢ e d
مند	m a n d
منزل	m a n z i l
منشار	m e n ʃ ɑː ɾ
منشی	m u n ʃ iː
منطقه	m i n t a ɢ a
منظور	m a n z u ɾ
منظومه	m a n z u m a
منع	m a n ʔ
منفور	m a n f u ɾ
منفی	m a n f iː
منگنه	m a n ɡ a n a
منیژه	m a n iː ʒ a
مهارت	m a h ɑː ɾ a t
مهبل	m a h b a l
مهر	m a h ɾ
مهربان	m e h ɾ a b ɑː n
مهربانی	m e h ɾ a b ɑː n iː
مهرداد	m e h ɾ d ɑː d
مهره	m o h ɾ e
مهم	m o h e m m
مهمان	m e h m ɑː n
مهندسی	m o h a n d e s iː
مواظب	m o v ɑː z e b
موافق	m o v ɑː f e ɢ
موتر	m oː t a ɾ
موج	m a v d͡ʒ
موجود	m a v d͡ʒ u d
مورچه	m oː ɾ t͡ʃ a
موز	m a v z
موزه	m oː z a
موسم	m a v s i m
موسیقی	m u s i ɢ iː
موسیقی‌شناسی	m u s i ɢ i ʃ i n ɑː s iː
موضوع	m a v z s ʔ
موقع	m a v ɢ e ʔ
مولانا	m o v l ɑː n ɑː
موم	m uː m
مومیا	m oː m i j ɑː
مومیایی	m oː m i j ɑː j iː
موی	m uː j
مژده	m o ʒ d e
مک	m a k
مکتب	m a k t a b
می	m a j
میان	m i j ɑː n
میانجیگری	m i j ɑː n d͡ʒ i ɡ a ɾ iː
میخانه	m a j x ɑː n a
میخی	m iː x iː
میدان	m a j d ɑː n
میزان	m i z ɑ n
میشین	m e ʃ i n
میغ	m e ɢ
میلاد	m e l ɑː d
میلادی	m iː l ɑː d iː
مین	m iː n
مینو	m i n s
میهن	m e h a n
میهن‌پرست	m i h a n p a ɾ a s t
میوه	m e v a
می‌خواهم	m iː x ɑː h a m
می‌دوم	m i d a v a m
می‌گم	m iː ɡ a m
ناتمام	n ɑː t a m ɑː m
ناتوان	n ɑː t a v ɑː n
ناخدا	n ɑː x u d ɑː
ناخن	n ɑː x u n
ناخواسته	n ɑː x ɑː s t a
نار	n ɑː ɾ
ناراحت	n ɑː ɾ ɑː h a t
نارسنگ	n ɑː ɾ s a n ɡ
نارنج	n ɑː ɾ a n d͡ʒ
نارون	n ɑː ɾ v a n
نارگیله	n ɑː ɾ ɡ iː l a
ناز	n ɒː z
نازک	n ɑː z u k
نازی	n ɑː z iː
ناشنوا	n ɑː ʃ i n a v ɑː
ناف	n ɑː f
نافرمان	n ɑː f a ɾ m ɑː n
ناقص	n ɑː ɢ i s
نالان	n ɒː l ɒː n
نالون	n ɒː l uː n
نام	n ɑː m
نامور	n ɑː m v a ɾ
نامیدن	n ɑː m iː d a n
نان	n ɑː n
نانوائی	n ɑː n v ɑː j e
نانوشته	n ɑː n i v i ʃ t a
ناهید	n ɑː h iː d
ناو	n ɑː v
ناوخدا	n ɑː v x o d ɑː
ناپاز	n ɑː p ɑː z
ناپدید	n ɑː p a d iː d
ناپسند	n ɑː p a s a n d
ناژو	n ɑː ʒ uː
ناک	n ɑː k
نتیجه	n a t i d͡ʒ a
نجس‌تر	n a d ʒ a s t a ɾ
نجس‌ترین	n a d ʒ a s t a ɾ iː n
نجومی	n o d͡ʒ uː m iː
نخیر	n a x a j ɾ
ندا	n e d ɑː
ندارد	n a d ɑː ɾ a d
نده	a n d a
نذل	n a z l
نر	n a ɾ
نریمان	n a ɾ e m ɑː n
نزد	n a z d
نزدیک	n a z d i k
نزدیک‌تر	n a z d iː k t a ɾ
نزدیک‌ترین	n a z d iː k t a ɾ iː n
نستعلیق	n a s t a ʔ l i ɢ
نسخه	n o s x e
نسرین	n a s ɾ iː n
نسیم	n a s i m
نشاط	n e ʃ ɑː t
نشان	n e ʃ ɑː n
نشاندن	n e ʃ ɑː n d a n
نشستن	n e ʃ a s t a n
نشلیدن	n e ʃ e l iː d a n
نشور	n o ʃ uː ɾ
نصف	n e s f
نظام	n e z ɑː m
نظر	n a z a ɾ
نعناع	n æ ʔ n ɒː ʔ
نعوظ	n o ʔ uː z
نغز	n a ɢ z
نغمه	n a ɢ m a
نفت	n a f t
نفر	n a f a ɾ
نفرین	n e f ɾ iː n
نقاش	n a ɢ ɢ ɑː ʃ
نقد	n a ɢ d
نقره	n o ɢ ɾ e
نقشه	n a ɢ ʃ a
نقطه	n o ɢ t e
نماز	n a m ɑː z
نمایان	n e m ɑː j ɑː n
نمایش	n a m ɑː j i ʃ
نماینده	n a m ɑː j a n d e
نمایندگان	n a m ɑː j a n d e ɡ ɑː n
نمایه	n a m ɑː j e
نمودار	n e m u d ɑː ɾ
نمودن	n a m u d a n
نمونه	n a m u n a
نمکدان	n a m a k d ɑː n
ننه	n a n e
نه	n o h
نهج	n a h a d͡ʒ
نهر	n a h ɾ
نهفتن	n a h o f t a n
نو	n a v
نواختر	n a v a x t a ɾ
نواختن	n a v ɑː x t a n
نور	n u ɾ
نوروز	n a v ɾ s z
نوزده	n u z d a h
نوشتن	n a v i ʃ t a n
نوشیدن	n oː ʃ iː d a n
نوشیدنی	n u ʃ i d a n iː
نوم	n oː m
نومد	n o w m a d
نوک	n v a k
نوکر	n a v k a r
نویسه‌گردانی	n e v iː s e ɡ a ɾ d ɑː n iː
نوین	n a v i n
نژادها	n e ʒ ɑː d h ɑː
نژادپرست	n e ʒ ɑː d p a ɾ a s t
نژادی	n e ʒ ɑː d iː
نکاح	n e k ɑː h
نکونام	n e k uː n ɑː m
نگار	n e ɡ ɑː ɾ
نگهداری	n e ɡ a h d ɑː ɾ iː
نیاز	n i j ɑː z
نیازها	n iː j ɑː z h ɑː
نیایش	n i j ɑː j i ʃ
نیرو	n e ɾ s
نیرومند	n iː ɾ uː m a n d
نیروگاه	n i ɾ u ɡ ɑː h
نیز	n e z
نیزه	n e i z e
نیست	n e s t
نیفه	n e f a
نیوشا	n i j oː ʃ ɑː
نیک	n e k
هامون	h ɒː m uː n
هجران	h i d͡ʒ ɾ ɑː n
هخامنش	h a x ɑː m a n i ʃ
هدیه	h a d i j a
هرتز	h e ɾ t z
هرزگی	h a ɾ z a ɡ iː
هرمز	h o ɾ m o z
هرچه	h a ɾ t͡ʃ i
هرکس	h a r k a s
هزار	h a z ɑː ɾ
هزینه	h a z e n a
هشت	h a ʃ t
هشتن	h e ʃ t a n
هفته‌ها	h a f t e h ɑː
هفده	h a b d a h
هل	h e l
هلو	h o l uː
همبازی	h a m b ɑː z iː
همجنس‌گراهراس	h a m d͡ʒ i n s ɡ a ɾ ɑː h a ɾ ɑː s
همساده	h o m s ɑː d e
همسایه	h a m s ɑː j a
همسده	h a m s e d a
همنوع‌خواری	h a m n a v ʔ x ɑː ɾ iː
همه	h a m e
همچنان	h a m t ʃ e n ɑː n
همچنین	h a m t͡ʃ a n i n
همیشه	h a m e ʃ a
هم‌جنس‌گرا	h a m d͡ʒ i n s ɡ a ɾ ɑː
هندو	h e n d uː
هندوانه	h e n d e v ɑː n e
هندی	h e n d iː
هنر	h o n a ɾ
هنوز	h a n oː z
هنگ	h a n ɡ
هنی	h a n iː
هواپیما	h a v ɑː p a j m ɑː
هوتن	h uː t æ n
هوش	h oː ʃ
هوشیار	h oː ʃ j ɑː ɾ
هول	h a v l
هی	h e j
هیزم	h e z u m
هیس	s
واج	v ɑː d͡ʒ
وارث	v ɑː ɾ e s
وارد	v ɑː ɾ e d
واش	v ɑ ʃ
واقعا	v ɑː ɢ e ʔ a n
والا	v a e l l ɑː
والله	v a l l ɑː h
واژه‌نامه	v ɒː ʒ e n ɒː m e
واژه‌ها	v ɑː ʒ e h ɑː
واژگان	v ɑː ʒ e ɡ ɑː n
واکسن	v ɑ k s a n
وای	v ɑː j
وج	v a d͡ʒ
وجودی	v o d͡ʒ uː d iː
وحی	v a h j
ورز	v a ɾ z
وزغ	v a z a ɢ
وزن	v a z n
وزیدن	v a z iː d a n
وسیع	v a s e ʔ
وصل	v a s l
وضع	v a z ʔ
وضعیت	v a z ʔ i j j a t
وضوح	v o z uː h
وطن	v a t a n
وطن‌پرست	v a t a n p a ɾ a s t
وظیفه	v a z i f a
وعده	v a ʔ d a
وفات	v a f ɑː t
وقت	v a ɢ t
وقتی	v a ɢ t e
ول	v e l
ولایت	v e l ɑː j a t
ونوس	v e n uː s
وهم	v a h m
وکالت	v e k ɑː l a t
وکیل	v a k i l
ویدیو	v iː d iː j o
ویر	v i ɾ
ویرانه	v e ɾ ɑː n a
ویرایش	v i ɾ ɑː j i ʃ
ویس	v i s
ویستا	v i s t ɒ
ویه	uː j e
ویژگی‌ها	v iː ʒ e ɡ iː h ɑː
پا	p ɑː
پاداش	p ɑː d ɑː ʃ
پادشاه	p ɑː d i ʃ ɑː h
پارسه	p ɑː ɾ s e
پاره	p ɑː ɾ a
پاریس	p ɑː ɾ iː s
پاستا	p ɑː s t ɑː
پاسخ	p ɑː s u x
پاشنه	p ɑː ʃ n a
پاشیدن	p ɑː ʃ iː d a n
پالایش	p ɑː l ɑː j i ʃ
پالایشگاه	p ɑː l ɑː j i ʃ ɡ ɑː h
پانزده	p uː n z d a h
پاپ	p ɑː p
پاپوش	p ɒː p oː ʃ
پاک	p ɑː k
پاکستان	p ɑː k i s t ɑː n
پاکستانی	p ɑː k i s t ɑː n iː
پایتخت	p ɑː j t a x t
پایه	p ɑː j a
پایگاه	p ɑː j i ɡ ɑː h
پاییز	p ɑː iː z
پتک	p o t k
پختن	p o x t a n
پدرام	p a d ɾ ɑː m
پذیرفتن	p a z i ɾ u f t a n
پراندن	p a ɾ ɑː n d a n
پراکندگی	p a ɾ ɑː k a n d a ɡ iː
پرتو	p a ɾ t a v
پرتوقع	p o ɾ t a v a ɢ ɢ o ʔ
پرتگاه	p a ɾ t ɡ ɑː h
پردیس	p a ɾ d e s
پرس	p o ɾ s
پرستار	p a ɾ a s t ɑː ɾ
پرسش	p o ɾ s e ʃ
پرسیدن	p o ɾ s iː d a n
پرشور	p o ɾ ʃ uː ɾ
پرطرفدار	p o ɾ t a ɾ a f d ɑː ɾ
پرنده	p a ɾ a n d a
پرندوش	p a ɾ a n d oː ʃ
پرندگان	p a ɾ a n d a ɡ ɑː n
پرهیز	p a ɾ h e z
پرواز	p a ɾ v ɑː z
پروسه	p e ɾ o s e
پروژه	p e ɾ o ʒ e
پرچم	p a ɾ t͡ʃ a m
پرگار	p a ɾ ɡ ɑː ɾ
پری	p a ɾ iː
پریدن	p a ɾ i d a n
پریستان	p a ɾ i j i s t ɑː n
پریشان	p a ɾ e ʃ ɑː n
پزشک	p e z e ʃ k
پستان	p e s t ɑː n
پسر	p a s a ɾ
پسوند	p a s v a n d
پسی	p o s e
پش	p a ʃ
پشت	p o ʃ t e
پشتون	p a ʃ t uː n
پشمین	p a ʃ m iː n
پشه	p a ʃ e
پشیمان	p a ʃ iː m ɑː n
پل	p o l
پلاستیک	p e l ɒː s t iː k
پلان	p e l ɑː n
پلاک	p e l ɒː k
پلخته	p a l a x t a
پناهنده	p a n ɑː h a n d e
پناهندگان	p a n ɑː h a n d e ɡ ɑː n
پنبه	p a m b e
پنج	p a n d͡ʒ
پنجره	p a n d͡ʒ a ɾ a
پنجشیر	p a n d͡ʒ ʃ e ɾ
پنجه	p a n d͡ʒ a
پنهان	p e n h uː n
پنگان	p e n ɡ ɑː n
پنیر	p a n i ɾ
پهلوان	p a h l a v ɑː n
پودنه	p u d i n a
پوده	p uː d æ
پور	p u ɾ
پوزخند	p uː z x a n d
پوست	p oː s t
پوشاک	p oː ʃ ɑː k
پوشیدن	p oː ʃ iː d a n
پولدار	p u l d ɑː ɾ
پوهنتون	p oː h a n t uː n
پوپک	p oː p a k
پژوهش	p a ʒ u h i ʃ
پی	p e j
پیادگان	p iː j ɑː d e ɡ ɑː n
پیاله	p i j ɑː l a
پیامبر	p a j ɑː m b a ɾ
پیامک	p a j ɑː m a k
پیرتر	p iː ɾ t a ɾ
پیرترین	p iː ɾ t a ɾ iː n
پیسه	p a j s a
پیش	p e ʃ
پیشانی	p e ʃ ɑː n iː
پیشتاز	p e ʃ t ɑː z
پیشمرگه	p e ʃ m a ɾ ɡ e
پیشنهاد	p e ʃ n i h ɑː d
پیشه	p e ʃ a
پیشگیر	p e ʃ ɡ i ɾ
پیغامبر	p a j ɢ ɑː m b a ɾ
پیوسیدن	p a j oː s iː d a n
پیچیدن	p e t͡ʃ i d a
پیکر	p a j k a ɾ
چا	t ʃ ɑː
چاشت	t ʃ ɑː ʃ t
چاشنی	t ʃ ɑː ʃ n iː
چاقو	t͡ʃ ɑː ɢ uː
چامه	t͡ʃ ɑː m a
چامه‌سرایی	t͡ʃ ɑː m a s a ɾ ɑː j iː
چاه‌کور	t͡ʃ ɑː h k a v ɾ
چاپگر	t͡ʃ ɑː p ɡ a ɾ
چای	t͡ʃ ɑː j
چایدان	t͡ʃ ɑː j d ɑː n
چتر	t͡ʃ a t ɾ
چربی	t͡ʃ a ɾ b iː
چرخ	t͡ʃ a ɾ x
چرخه	t͡ʃ a ɾ x a
چرخیدن	t ʃ e ɾ x i d a n
چرمه	t͡ʃ a ɾ m a
چریک	t͡ʃ a ɾ i k
چشمان	t ʃ e ʃ m ɑː
چطور	t͡ʃ e t o v ɾ
چغندر	t͡ʃ o ɢ o n d a ɾ
چقدر	t͡ʃ e ɢ a d a ɾ
چل	t ʃ e l
چلنگر	t͡ʃ e l e n ɡ a ɾ
چله	t ʃ e l e
چلوکباب	t͡ʃ e l o v k a b ɑː b
چم	t͡ʃ a m
چمدان	t͡ʃ a m i d ɑː n
چمن	t͡ʃ a m a n
چمیدن	t͡ʃ a m i d a n
چنان	t ʃ o n ɑː n
چنانکه	t͡ʃ o n ɑː n k e
چنبره	t͡ʃ a m b a ɾ a
چند	t͡ʃ a n d
چندان	t͡ʃ a n d ɑː n
چندین	t͡ʃ a n d i n
چنین	t ʃ o n iː n
چه	t͡ʃ a
چهار	t͡ʃ a h ɑː ɾ
چهارده	t͡ʃ a h ɑː ɾ d a h
چهره	t͡ʃ e h ɾ a
چو	t ʃ o v
چوب	t͡ʃ oː b
چون	t͡ʃ oː n
چوپ	t͡ʃ oː p
چوپان	t͡ʃ u p ɑː n
چوکی	t ʃ a w k iː
چپ	t ʃ a p
چکش	t͡ʃ a k u ʃ
چکمه	t͡ʃ a k m a
چکیدن	t͡ʃ a k i d a n
چگونه	t͡ʃ e ɡ uː n e
چی	t͡ʃ e
چیست	t͡ʃ i s t
چیش	t ʃ i ʃ
ژاله	ʒ ɑː l a
ژامبون	ʒ ɑː m b o n
ژاندرم	ʒ ɒː n d æ r m
ژاپنی	ʒ ɑː p u n iː
ژاژ	ʒ ɑː ʒ
ژرف	ʒ a ɾ f
ژرفا	ʒ a ɾ f ɑː
ژرفی	ʒ a ɾ f iː
ژرف‌تر	ʒ a ɾ f t a ɾ
ژرف‌ترین	ʒ a ɾ f t a ɾ iː n
ژغار	ʒ a ɢ ɑː ɾ
ژم	ʒ æ m
ژنو	ʒ e n e v
ژولیدن	ʒ uː l iː d a n
ژوپیتر	ʒ u p i t e ɾ
ژکفر	ʒ a k f a ɾ
ژکفری	ʒ a k f a ɾ iː
کابل	k ɑː b u l
کابلی	k ɑː b u l iː
کاخ	k ɑː x
کار	k ɑː ɾ
کارزار	k ɑː ɾ z ɑː ɾ
کاروان	k ɑː ɾ v ɑː n
کارواژه‌ها	k ɒː r v ɒː ʒ e h ɒː
کارواژگان	k ɒː r v ɒː ʒ e ɡ ɒː n
کارورزی	k ɑː ɾ v a ɾ z iː
کاریز	k ɑː ɾ e z
کاسب	k ɑː s i b
کاسه	k ɑː s e
کاغد	k ɑː ɢ a d
کاغذ	k ɑː ɢ a z
کاغذها	k ɑː ɢ a z h ɑː
کافی	k ɑː f iː
کالب	k ɑː l e b
کالبد	k ɑː l b u d
کالیفرنیا	k ɑː l iː f o r n i j ɑː
کاهش	k ɑː h i ʃ
کاکوتی	k ɑː k uː t iː
کباب	k a b ɑː b
کبریت	k e b ɾ iː t
کبوتر	k a b oː t a ɾ
کبود	k a b oː d
کتاب	k e t ɑː b
کتب	k o t o b
کتی	k a t iː
کثیف	k a s i f
کجا	k o d͡ʒ ɑː
کر	k a ɾ
کرامت	k a ɾ ɑː m a t
کرایه	k i ɾ ɑː j a
کردن	k a d a n
کردی	k o ɾ d iː
کرس	k e ɾ s
کرشن	k ɾ i ʃ n
کرفس	k æ ɾ æ f s
کره	k a ɾ a
کریمه	k e ɾ iː m e
کس	k a s
کشتار	k o ʃ t ɑː ɾ
کشتگی	k o ʃ t a ɡ iː
کشتی‌گیر	k o ʃ t iː ɡ iː ɾ
کشکول	k a ʃ k uː l
کشیش	k a ʃ i ʃ
کفاش	k a f f ɑ ʃ
کفتر	k e f t æ ɾ
کفش	k a f ʃ
کفگیر	k a f ɡ i ɾ
کلاس	k e l ɑː s
کلاغ	k a l ɑː ɢ
کلفخشنگ	k a l a f a x ʃ a n ɡ
کلنگ	k o l o n ɡ
کله	k a l l a
کلپ	k l a p
کلید	k a l i d
کم	k a m
کمان	k a m ɑː n
کمانچه	k a m ɑː n t͡ʃ a
کمند	k a m a n d
کمو	k æ m uː
کمک	k o m a k
کم‌مایه	k a m m ɑː j a
کم‌کم	k a m k a m
کن	k e n
کنار	k a n ɑː ɾ
کنجکاو	k o n d͡ʒ k ɑː v
کندن	k a n d a n
کنده	k a n d a
کنسرت	k o n s e ɾ t
کنشگر	k o n e ʃ ɡ a ɾ
کنعان	k æ n ʔ ɒː n
کنفرانس	k o n f e ɾ ɑː n s
کنونی	k o n uː n iː
کنکور	k o ŋ k uː r
کنگره	k o n ɡ r e
که	k e
کهر	k a h a ɾ
کهکشان	k a h k a ʃ ɑː n
کهکشان‌ها	k a h k a ʃ ɑː n h ɑː
کو	k oː
کوتاه	k oː t ɑː h
کوتاه‌تر	k uː t ɑː h t a ɾ
کوتاه‌ترین	k uː t ɑː h t a ɾ iː n
کود	k oː d
کودکان	k uː d æ k ɒː n
کودکی	k oː d a k iː
کوره	k oː ɾ a
کوزه	k u z a
کوشک	k oː ʃ k
کوفته	k oː f t a
کون	k u n
کوهستان	k oː h i s t ɑː n
کوچه	k oː t͡ʃ a
کوچک‌تر	k uː t ʃ e k t a ɾ
کوچک‌ترین	k uː t ʃ e k t a ɾ iː n
کوکب	k a v k a b
کویت	k o v e j t
کیر	k e ɾ
کیمیا	k iː m i j ɑː
کین	k iː n
کینه	k iː n e
کیهانی	k a j h ɑː n iː
گا	ɡ ɑː
گائیدن	ɡ ɑː j iː d a n
گاب	ɡ ɑː b
گاراژ	ɡ ɑː ɾ ɑː ʒ
گاری	ɡ ɒː ɾ iː
گاز	ɡ ɑː z
گان	ɡ ɑː n
گاه	ɡ ɑː h
گاهی	ɡ ɑː h iː
گاه‌شماری	ɡ ɑː h ʃ u m ɑː ɾ iː
گاومیش	ɡ ɑː v m e ʃ
گجرات	ɡ o d͡ʒ a ɾ ɑː t
گدازه	ɡ o d ɑː z e
گذاشتن	ɡ o z ɑː ʃ t a n
گذراندن	ɡ o z a ɾ ɑː n d a n
گذشتن	ɡ o z a ʃ t a n
گذشته	ɡ o z a ʃ t e
گرا	ɡ a ɾ ɑː
گراز	ɡ o ɾ ɑː z
گران	ɡ a ɾ ɑː n
گربسن	ɡ e r b e s a n
گردن	ɡ a ɾ d a n
گردنبند	ɡ a ɾ d a n b a n d
گردون	ɡ a ɾ d u n
گرزمان	ɡ æ ɾ æ z m ɒː n
گرزه	ɡ o ɾ z e
گرفتن	ɡ e ɾ e f t a n
گرم	ɡ a ɾ m
گره	ɡ e r e h
گروه	ɡ o ɾ uː h
گرچه	ɡ a ɾ t͡ʃ a
گرگ	ɡ o ɾ ɡ
گریختن	ɡ o ɾ iː x t a n
گریستن	ɡ e ɾ iː s t a n
گریه	ɡ e ɾ j e
گز	ɡ æ z
گزاردن	ɡ o z ɑː ɾ d a n
گزارش	ɡ o z ɑː ɾ e ʃ
گزاف	ɡ a z ɑː f
گزاف‌تر	ɡ a z ɑː f t a ɾ
گزاف‌ترین	ɡ a z ɑː f t a ɾ iː n
گزیدن	ɡ a z i d a n
گزینش	ɡ o z iː n e ʃ
گستاخ	ɡ o s t ɑː x
گستردن	ɡ o s t a ɾ d a n
گسترده	ɡ o s t a ɾ d e
گسستن	ɡ o s a s t a n
گشاد	ɡ o ʃ ɑː d
گشادن	ɡ o ʃ ɑː d a n
گشادی	ɡ o ʃ ɑː d iː
گشتن	ɡ a ʃ t a n
گشنیز	ɡ e ʃ n iː z
گفتار	ɡ o f t ɑː ɾ
گفتن	ɡ o f t a n
گفتگو	ɡ o f t o ɡ uː j
گل	ɡ e l
گلابی	ɡ o l ɑː b iː
گلدان	ɡ o l d ɑː n
گلستان	ɡ o l e s t ɑː n
گلف	ɡ o l f
گلو	ɡ a l oː
گلپر	ɡ o l p a ɾ
گلچه	ɡ o l t͡ʃ e
گلی	ɡ o l iː
گم	ɡ o m
گماشتن	ɡ o m ɑː ʃ t a n
گناه	ɡ o n ɑː h
گنجشک	ɡ o n d͡ʒ e ʃ k
گنجور	ɡ a n d͡ʒ u ɾ
گنجینه	ɡ a n d͡ʒ i n a
گندم	ɡ a n d u m
گنده	ɡ a n d a
گنم	ɡ e n o m
گهواره	ɡ a h v ɑː ɾ a
گو	ɡ o v
گواشتن	ɡ o v ɑː ʃ t a n
گواه	ɡ o v ɑː h
گوجه	ɡ a v d͡ʒ a
گودر	ɡ oː d a ɾ
گور	ɡ oː ɾ
گورستان	ɡ oː ɾ i s t ɑː n
گوز	ɡ a v z
گوساله	ɡ uː s ɑː l e
گوسفند	ɡ oː s f a n d
گوشت	ɡ oː ʃ t
گوشه	ɡ oː ʃ a
گوشواره	ɡ oː ʃ v ɑː ɾ a
گون	ɡ oː n
گوناگون	ɡ u n ɑː ɡ u n
گونه	ɡ oː n a
گوهر	ɡ a v h a ɾ
گوگرد	ɡ oː ɡ i ɾ d
گوی	ɡ uː
گویش	ɡ oː j i ʃ
گچ	ɡ a t͡ʃ
گی	a ɡ iː
گیاخن	ɡ o j ɑː x a n
گیان	ɡ o j ɑː n
گیتا	ɡ iː t ɒː
گیتی	ɡ e t iː
گیس	ɡ e s
گین	ɡ i n
گیک	ɡ iː k
یائسگی	j ɑː ʔ i s a ɡ iː
یاب	j ɑː b
یاد	j ɑː d
یار	j ɑː ɾ
یاسا	j ɑː s ɑː
یاساء	j ɑː s ɑː ʔ
یاساق	j ɒː s ɒː q
یافتن	j ɑː f t a n
یاقوت	j ɑː ɢ u t
یاور	j ɑː v a ɾ
یتیم	j a t i m
یخ	j a x
یخچال	j a x t͡ʃ ɑː l
یراق	j a ɾ ɑː ɢ
یزد	j a z d
یزدان	j a z d ɑː n
یشم	j a ʃ m
یعنی	j a ʔ n iː
یلدا	j a l d ɑ
یم	j a m
یمن	j a m a n
ین	e n
یه	j e
یهود	j a h u d
یهودی	j a h u d iː
یواش	j a v ɑː ʃ
یونانی	j u n ɑː n iː
یونجه	j oː n d͡ʒ a
یپک	j e p a k
یک	j a k
یگانه	j a ɡ ɑː n a
یی	j iː
ییلاق	j a j l ɑː ɢ
