<|HBS|>abnormalnost	a b n o r m ǎː l n oː s t
<|HBS|>administracija	a d m i n i s t r ǎː t͡s i j a
<|HBS|>advokat	a d ʋ ǒ k aː t
<|HBS|>aerobik	a e r ǒ b i k
<|HBS|>akcija	ǎ k t͡s i j a
<|HBS|>aktivnost	a k t ǐː ʋ n oː s t
<|HBS|>alat	ǎ l aː t
<|HBS|>alternativan	â l t e r n a t iː ʋ a n
<|HBS|>anka	âː n k a
<|HBS|>anđeo	âː n d͡ʑ e o
<|HBS|>aplicirati	a p l i t͡s ǐː r a t i
<|HBS|>apostol	ǎ p o s t o l
<|HBS|>aranžman	a r ǎ n ʒ m aː n
<|HBS|>arogancija	a r o ɡ ǎ n t͡s i j a
<|HBS|>arogantan	a r o ɡ ǎ n t a n
<|HBS|>artiljerija	a r t i ʎ ě r i j a
<|HBS|>asirski	ǎ s iː r s k iː
<|HBS|>atletičarka	a t l ě t i t͡ʃ aː r k a
<|HBS|>atribut	a t r ǐ b uː t
<|HBS|>aukcija	a ǔ k t͡s i j a
<|HBS|>autocesta	a u t o t͡s ě s t a
<|HBS|>autoritet	a u t o r ǐ t eː t
<|HBS|>bacač	b ǎ t͡s aː t͡ʃ
<|HBS|>bajka	b âː j k a
<|HBS|>barijera	b a r i j ěː r a
<|HBS|>barjak	b ǎ r j aː k
<|HBS|>bend	b ê n d
<|HBS|>beskonačnost	b ê s k o n a t͡ʃ n oː s t
<|HBS|>beskoristan	b ê s k o r iː s t a n
<|HBS|>beton	b ě t oː n
<|HBS|>bevanda	b ě ʋ aː n d a
<|HBS|>bezbrižnost	b ě z b r i ʒ n oː s t
<|HBS|>bezgrešan	b ě z ɡ r e ʃ a n
<|HBS|>bezosjećajno	b ê z o s j e t͡ɕ aː j n o
<|HBS|>bezuspješan	b e z ǔ s p j e ʃ a n
<|HBS|>bešćutnost	b ě ʃ t͡ɕ u t n oː s t
<|HBS|>biciklizam	b i t͡s i k l ǐ z a m
<|HBS|>bilježnik	b ǐ ʎ e ʒ n iː k
<|HBS|>birački	b ǐ r aː t͡ʃ k iː
<|HBS|>bitno	b î t n o
<|HBS|>boginja	b ǒ ɡ i ɲ a
<|HBS|>bojkot	b ǒ j k o t
<|HBS|>boka	b ô k a
<|HBS|>boljitak	b o ʎ ǐː t a k
<|HBS|>bolnica	b ǒː l n i t͡s a
<|HBS|>bombardirati	b o m b a r d ǐː r a t i
<|HBS|>bor	b ôː r
<|HBS|>boris	b ôː r i s
<|HBS|>boston	b ô s t o n
<|HBS|>božur	b ǒ ʒ uː r
<|HBS|>brada	b r ǎː d a
<|HBS|>brdovit	b r d ǒ ʋ i t
<|HBS|>brodica	b r ǒ d i t͡s a
<|HBS|>bubnjar	b ǔ b ɲ aː r
<|HBS|>budala	b u d ǎ l a
<|HBS|>cijenjen	t͡s i j êː ɲ e n
<|HBS|>crnogorac	t͡s r n ǒ ɡ o r a t͡s
<|HBS|>dalekoistočni	d a l e k o ǐ s t o t͡ʃ n iː
<|HBS|>dalekovidno	d a l e k ǒ ʋ i d n o
<|HBS|>dalibor	d ǎ l i b o r
<|HBS|>daljina	d a ʎ ǐ n a
<|HBS|>dan	d âː n
<|HBS|>danac	d ǎː n a t͡s
<|HBS|>danski	d âː n s k iː
<|HBS|>decenija	d ě t͡s eː n i j a
<|HBS|>dekan	d ě k aː n
<|HBS|>delegacija	d e l e ɡ ǎː t͡s i j a
<|HBS|>depo	d ě p oː
<|HBS|>desetoro	d ê s e t o r o
<|HBS|>despot	d ě s p o t
<|HBS|>direktorica	d i r e k t ǒ r i t͡s a
<|HBS|>diskretno	d ǐ s k r e t n o
<|HBS|>divlje	d ǐ ʋ ʎ eː
<|HBS|>djelomično	d j ê l o m i t͡ʃ n o
<|HBS|>djeva	d j ěː ʋ a
<|HBS|>dlaka	d l â k a
<|HBS|>dodavanje	d o d ǎː ʋ aː ɲ e
<|HBS|>doista	d ô i s t a
<|HBS|>dojilja	d ǒ j iː ʎ a
<|HBS|>dokle	d ǒː k l eː
<|HBS|>dopustiti	d o p ǔ s t i t i
<|HBS|>dopuštati	d o p ǔː ʃ t a t i
<|HBS|>dosadan	d ô s aː d a n
<|HBS|>dovoljno	d ô ʋ oː ʎ n o
<|HBS|>dozvoliti	d o z ʋ ǒ l i t i
<|HBS|>dočekati	d ǒ t͡ʃ e k a t i
<|HBS|>drijen	d r i j êː n
<|HBS|>drugačiji	d r u ɡ ǎ t͡ʃ i j iː
<|HBS|>drukčije	d r ǔ k t͡ʃ i j eː
<|HBS|>drvo	d r̂ ʋ o
<|HBS|>dugotrajan	d û ɡ o t r aː j a n
<|HBS|>duhan	d ǔ x aː n
<|HBS|>duhovni	d ǔ x oː ʋ n iː
<|HBS|>dužnosnica	d ǔː ʒ n o s n i t͡s a
<|HBS|>dvadesetak	d ʋ a d e s ěː t a k
<|HBS|>dvojnik	d ʋ ôː j n iː k
<|HBS|>džak	d͡ʒ âː k
<|HBS|>džin	d͡ʒ î n
<|HBS|>efekt	ě f e k t
<|HBS|>ekipa	e k ǐː p a
<|HBS|>elektrana	e l e k t r ǎ n a
<|HBS|>električar	e l ě k t r i t͡ʃ aː r
<|HBS|>elemenat	e l ě m e n a t
<|HBS|>emotivan	ê m o t iː ʋ a n
<|HBS|>epitet	e p ǐ t eː t
<|HBS|>estonija	ě s t oː n i j a
<|HBS|>fatalno	f ǎ t aː l n o
<|HBS|>fašizam	f a ʃ ǐ z a m
<|HBS|>feniks	f ěː n i k s
<|HBS|>fildžan	f ǐ l d͡ʒ aː n
<|HBS|>filolog	f i l ǒ l o ɡ
<|HBS|>fizioterapeut	f i z i o t e r a p ě u t
<|HBS|>fišek	f ǐ ʃ e k
<|HBS|>fjaka	f j â k a
<|HBS|>florida	f l ǒ r i d a
<|HBS|>fontana	f ǒ n t aː n a
<|HBS|>formalnost	f o r m ǎː l n oː s t
<|HBS|>francuskinja	f r ǎ n t͡s u s k i ɲ a
<|HBS|>fudbaler	f u d b ǎ l eː r
<|HBS|>gadan	ɡ ǎ d a n
<|HBS|>garnitura	ɡ a r n i t ǔː r a
<|HBS|>geomorfologija	ɡ e o m o r f o l ǒ ɡ i j a
<|HBS|>geslo	ɡ ê s l o
<|HBS|>gimnastika	ɡ i m n ǎ s t i k a
<|HBS|>glasnogovornik	ɡ l a s n o ɡ o ʋ ǒ r n iː k
<|HBS|>glazbenica	ɡ l ǎ z b e n i t͡s a
<|HBS|>glupost	ɡ l ǔː p oː s t
<|HBS|>god	ɡ ôː d
<|HBS|>godinama	ɡ ô d i n a m a
<|HBS|>gorski	ɡ ǒ r s k iː
<|HBS|>gospodin	ɡ o s p ǒ d i n
<|HBS|>govoriti	ɡ o ʋ ǒ r i t i
<|HBS|>gozba	ɡ ǒ z b a
<|HBS|>gradonačelnica	ɡ r a d o n ǎː t͡ʃ e l n i t͡s a
<|HBS|>granata	ɡ r a n ǎː t a
<|HBS|>greben	ɡ r ê b eː n
<|HBS|>groblje	ɡ r ôː b ʎ e
<|HBS|>gubitak	ɡ u b ǐː t a k
<|HBS|>guja	ɡ ǔː j a
<|HBS|>gusjenica	ɡ û s j e n i t͡s a
<|HBS|>gušterača	ɡ u ʃ t ě r a t͡ʃ a
<|HBS|>han	x âː n
<|HBS|>heroj	x ě r oː j
<|HBS|>hipodrom	x î p o d r o m
<|HBS|>horoz	x ô r oː z
<|HBS|>hrabro	x r âː b r o
<|HBS|>hrenovka	x r ě n oː ʋ k a
<|HBS|>human	x û m aː n
<|HBS|>humor	x ǔ m o r
<|HBS|>ime	î m e
<|HBS|>inauguracija	i n a u ɡ u r ǎː t͡s i j a
<|HBS|>inače	î n aː t͡ʃ e
<|HBS|>inačica	i n ǎ t͡ʃ i t͡s a
<|HBS|>intelekt	i n t ě l e k t
<|HBS|>intuitivno	î n t u i t iː ʋ n o
<|HBS|>irska	îː r s k aː
<|HBS|>iscuriti	i s t͡s ǔː r i t i
<|HBS|>isključiti	i s k ʎ ǔː t͡ʃ i t i
<|HBS|>iskustvo	i s k ǔː s t ʋ o
<|HBS|>islam	ǐ s l aː m
<|HBS|>ismijati	i s m ǐ j a t i
<|HBS|>isplativ	i s p l ǎ t i ʋ
<|HBS|>ispunjiv	i s p ǔ ɲ i ʋ
<|HBS|>istodobno	i s t ǒ d o b n o
<|HBS|>istosmjerno	î s t o s m j eː r n o
<|HBS|>isušiti	i s ǔː ʃ i t i
<|HBS|>italija	ǐ t aː l i j a
<|HBS|>izabran	î z a b r aː n
<|HBS|>izbaciti	i z b ǎː t͡s i t i
<|HBS|>izboriti	i z b ǒ r i t i
<|HBS|>izjava	î z j a ʋ a
<|HBS|>izostaviti	i z ǒ s t a ʋ i t i
<|HBS|>izuzetno	î z u z eː t n o
<|HBS|>izvjestan	î z ʋ j e s t a n
<|HBS|>jajovod	j â j o ʋ oː d
<|HBS|>jako	j âː k o
<|HBS|>jamačno	j ǎ m a t͡ʃ n o
<|HBS|>japan	j ǎ p aː n
<|HBS|>japanac	j a p ǎː n a t͡s
<|HBS|>jasen	j â s eː n
<|HBS|>jebati	j ě b a t i
<|HBS|>jedan	j ě d a n
<|HBS|>jesen	j ê s eː n
<|HBS|>ječam	j ě t͡ʃ a m
<|HBS|>jutro	j û t r o
<|HBS|>jutrom	j û t r o m
<|HBS|>jutros	j û t r oː s
<|HBS|>kaba	k ǎː b a
<|HBS|>kabul	k ǎː b u l
<|HBS|>kajiš	k ǎ j i ʃ
<|HBS|>kanal	k ǎ n aː l
<|HBS|>karton	k ǎ r t oː n
<|HBS|>katedra	k ǎ t eː d r a
<|HBS|>katolik	k â t o l iː k
<|HBS|>kazališni	k ǎ z a l iː ʃ n iː
<|HBS|>kačket	k ǎ t͡ʃ k eː t
<|HBS|>kenijac	k e n ǐː j a t͡s
<|HBS|>kiklop	k ǐ k l o p
<|HBS|>klati	k l â t i
<|HBS|>klobučar	k l ǒ b u t͡ʃ aː r
<|HBS|>književno	k ɲ î ʒ eː ʋ n o
<|HBS|>knjižnica	k ɲ ǐː ʒ n i t͡s a
<|HBS|>kobasica	k o b ǎ s i t͡s a
<|HBS|>kobno	k ôː b n o
<|HBS|>komandant	k o m ǎ n d a n t
<|HBS|>kome	k ǒ m e
<|HBS|>kompa	k o m p ǎ
<|HBS|>koncepcija	k o n t͡s ě p t͡s i j a
<|HBS|>konoba	k ǒ n o b a
<|HBS|>konopac	k ǒ n o p a t͡s
<|HBS|>kontinuiran	k o n t i n ǔ iː r a n
<|HBS|>kontroverzno	k o n t r o ʋ ě r z n o
<|HBS|>kopar	k ô p a r
<|HBS|>koplje	k ô p ʎ e
<|HBS|>korejski	k ǒ r eː j s k iː
<|HBS|>korijen	k ô r j eː n
<|HBS|>kos	k ôː s
<|HBS|>kovati	k ǒ ʋ a t i
<|HBS|>kozmos	k ô z m o s
<|HBS|>košarkaš	k o ʃ ǎ r k aː ʃ
<|HBS|>kožni	k ô ʒ n iː
<|HBS|>kraljević	k r ǎː ʎ e ʋ i t͡ɕ
<|HBS|>krasopisno	k r â s o p iː s n o
<|HBS|>kratkometražni	k r a t k o m ě t r aː ʒ n iː
<|HBS|>kremlj	k r ê m ʎ
<|HBS|>krimen	k r îː m e n
<|HBS|>kriminal	k r i m ǐ n aː l
<|HBS|>kristal	k r ǐ s t aː l
<|HBS|>kritički	k r ǐ t i t͡ʃ k iː
<|HBS|>krivodol	k r i ʋ ǒ d o l
<|HBS|>križevci	k r ǐː ʒ eː ʋ t͡s i
<|HBS|>krkan	k ř k a n
<|HBS|>krmak	k řː m a k
<|HBS|>kroasan	k r o ǎ s aː n
<|HBS|>kroki	k r ǒ k iː
<|HBS|>kroničan	k r ǒ n i t͡ʃ a n
<|HBS|>kronologija	k r o n o l ǒ ɡ i j a
<|HBS|>krupa	k r ǔː p a
<|HBS|>kuhar	k û x aː r
<|HBS|>kukavica	k û k a ʋ i t͡s a
<|HBS|>kurban	k ǔ r b aː n
<|HBS|>kuvati	k û ʋ a t i
<|HBS|>kvalitetan	k ʋ â l i t eː t a n
<|HBS|>kvačilo	k ʋ â t͡ʃ i l o
<|HBS|>lagati	l ǎ ɡ a t i
<|HBS|>lakovjerno	l â k o ʋ j eː r n o
<|HBS|>latinski	l ǎ t iː n s k iː
<|HBS|>lažan	l â ʒ a n
<|HBS|>ledolomac	l e d o l ǒː m a t͡s
<|HBS|>leteći	l ě t eː t͡ɕ iː
<|HBS|>li	l i
<|HBS|>lijep	l i j êː p
<|HBS|>liječnik	l i j êː t͡ʃ n iː k
<|HBS|>ljudski	ʎ ǔ d s k iː
<|HBS|>ljudskost	ʎ û d s k oː s t
<|HBS|>lord	l ô r d
<|HBS|>los	l ô s
<|HBS|>lova	l ǒː ʋ a
<|HBS|>lovočuvar	l o ʋ o t͡ʃ ǔ ʋ aː r
<|HBS|>loš	l ô ʃ
<|HBS|>lubenica	l u b ě n i t͡s a
<|HBS|>ludo	l ûː d o
<|HBS|>lukavac	l û k a ʋ a t͡s
<|HBS|>luksuzno	l ǔ k s u z n o
<|HBS|>lutalica	l ǔː t a l i t͡s a
<|HBS|>luteranski	l u t ě r aː n s k iː
<|HBS|>magarac	m ǎ ɡ a r a t͡s
<|HBS|>magnat	m ǎ ɡ n aː t
<|HBS|>magnetizam	m a ɡ n e t ǐ z a m
<|HBS|>majoneza	m a j o n ěː z a
<|HBS|>makro	m â k r o
<|HBS|>malta	m âː l t a
<|HBS|>manjinski	m ǎ ɲ iː n s k iː
<|HBS|>marihuana	m a r i x u ǎ n a
<|HBS|>materica	m â t e r i t͡s a
<|HBS|>mauzolej	m a u z ǒ l e j
<|HBS|>med	m êː d
<|HBS|>mekteb	m ě k t e b
<|HBS|>merkur	m ě r k uː r
<|HBS|>mesto	m ê s t o
<|HBS|>meteor	m e t ě oː r
<|HBS|>metodologija	m e t o d o l ǒ ɡ i j a
<|HBS|>metropola	m e t r ǒ p o l a
<|HBS|>mijena	m i j ěː n a
<|HBS|>miti	m î t i
<|HBS|>miš	m î ʃ
<|HBS|>mjesečni	m j ê s e t͡ʃ n iː
<|HBS|>mještanin	m j ě ʃ t a n i n
<|HBS|>mlak	m l âː k
<|HBS|>mlijeko	m l i j ěː k o
<|HBS|>moda	m ǒː d a
<|HBS|>moj	m ôː j
<|HBS|>monizam	m o n ǐ z a m
<|HBS|>monotonija	m o n o t ǒ n i j a
<|HBS|>možda	m ǒ ʒ d a
<|HBS|>muharem	m u x ǎ r e m
<|HBS|>naboj	n ǎː b o j
<|HBS|>nadjenuti	n ǎ d j e n u t i
<|HBS|>naglavačke	n a ɡ l a ʋ ǎ t͡ʃ k eː
<|HBS|>nagovijestiti	n a ɡ o ʋ i j ěː s t i t i
<|HBS|>naklada	n âː k l a d a
<|HBS|>nama	n â m a
<|HBS|>nametati	n a m ě t a t i
<|HBS|>nametljiv	n a m ě t ʎ i ʋ
<|HBS|>naprema	n ǎ p r e m a
<|HBS|>narudžba	n ǎː r u d͡ʒ b a
<|HBS|>narukvica	n ǎ r u k ʋ i t͡s a
<|HBS|>naručje	n ǎː r uː t͡ʃ j e
<|HBS|>nasilnik	n ǎː s iː l n iː k
<|HBS|>naslov	n ǎː s l o ʋ
<|HBS|>nasred	n â s r e d
<|HBS|>naušnica	n ǎ u ʃ n i t͡s a
<|HBS|>navečer	n â ʋ e t͡ʃ eː r
<|HBS|>navika	n âː ʋ i k a
<|HBS|>navlastito	n ǎ ʋ l a s t i t o
<|HBS|>naziv	n ǎː z i ʋ
<|HBS|>načelo	n a t͡ʃ ěː l o
<|HBS|>načiniti	n a t͡ʃ ǐ n i t i
<|HBS|>nedoumica	n e d ǒ u m i t͡s a
<|HBS|>negde	n ê ɡ d e
<|HBS|>neiskreno	n ě i s k r e n o
<|HBS|>nekada	n ê k a d a
<|HBS|>nekim	n ê k iː m
<|HBS|>nekoga	n ê k o ɡ a
<|HBS|>nekomu	n ê k o m u
<|HBS|>nekoć	n ê k oː t͡ɕ
<|HBS|>nektar	n ê k t a r
<|HBS|>nelagodno	n ê l a ɡ o d n o
<|HBS|>nemo	n êː m o
<|HBS|>neodoljivo	n e o d ǒ ʎ i ʋ o
<|HBS|>neodređen	n e ǒ d r eː d͡ʑ e n
<|HBS|>neograničen	n e o ɡ r ǎ n i t͡ʃ e n
<|HBS|>neosvojiv	n e o s ʋ ǒ j i ʋ
<|HBS|>nepal	n ě p aː l
<|HBS|>nepažnja	n e p ǎ ʒ ɲ a
<|HBS|>nepostojan	n e p ǒː s t o j aː n
<|HBS|>nepoverenje	n e p o ʋ e r ěː ɲ e
<|HBS|>neprimjereno	n e p r ǐ m j e r e n o
<|HBS|>nervirati	n e r ʋ ǐː r a t i
<|HBS|>nesposoban	n ê s p o s o b a n
<|HBS|>neukusno	n ê u k u s n o
<|HBS|>nevjernik	n ě ʋ j eː r n iː k
<|HBS|>nezahvalan	n ê z a x ʋ aː l a n
<|HBS|>nezamjenjiv	n e z a m j ě ɲ i ʋ
<|HBS|>nezavisno	n e z ǎː ʋ i s n o
<|HBS|>nećete	n êː t͡ɕ eː t e
<|HBS|>nečim	n ê t͡ʃ i m
<|HBS|>nikad	n î k a d
<|HBS|>nikuda	n î k u d a
<|HBS|>nisam	n ǐː s a m
<|HBS|>nit	n îː t
<|HBS|>nišan	n ǐ ʃ a n
<|HBS|>njihov	ɲ î x o ʋ
<|HBS|>njim	ɲ îː m
<|HBS|>njima	ɲ î m a
<|HBS|>normalno	n ô r m aː l n o
<|HBS|>norvežanin	n o r ʋ ěː ʒ a n i n
<|HBS|>nosač	n ǒ s aː t͡ʃ
<|HBS|>novajlija	n o ʋ ǎ j l i j a
<|HBS|>noćenje	n ǒ t͡ɕ eː ɲ e
<|HBS|>nuklearni	n û k l e aː r n iː
<|HBS|>numerički	n u m ě r i t͡ʃ k iː
<|HBS|>obad	ô b aː d
<|HBS|>obdukcija	o b d ǔ k t͡s i j a
<|HBS|>obilježiti	o b ǐ ʎ e ʒ i t i
<|HBS|>obje	ô b j e
<|HBS|>oblak	ô b l aː k
<|HBS|>obnavljati	o b n ǎː ʋ ʎ a t i
<|HBS|>obostran	o b ǒ s t r a n
<|HBS|>obrana	ô b r a n a
<|HBS|>obzir	ô b z iː r
<|HBS|>ocat	ǒ t͡s a t
<|HBS|>odelo	o d ěː l o
<|HBS|>odgovoriti	o d ɡ o ʋ ǒː r i t i
<|HBS|>odmoriti	o d m ǒ r i t i
<|HBS|>odnos	ǒ d n o s
<|HBS|>odoljeti	o d ǒ ʎ e t i
<|HBS|>održavati	o d r ʒ ǎː ʋ a t i
<|HBS|>odstupiti	o d s t ǔː p i t i
<|HBS|>oduprijeti	o d ǔ p r j eː t i
<|HBS|>okean	o k ě aː n
<|HBS|>okretati	o k r ěː t a t i
<|HBS|>okrutno	ô k r uː t n o
<|HBS|>olabaviti	ǒ l a b a ʋ i t i
<|HBS|>oljuštiti	o ʎ ǔː ʃ t i t i
<|HBS|>ometati	o m ěː t a t i
<|HBS|>omladinac	o m l a d ǐː n a t͡s
<|HBS|>omot	ǒ m o t
<|HBS|>onemogućavati	o n e m o ɡ u t͡ɕ ǎː ʋ a t i
<|HBS|>ono	ǒ n o
<|HBS|>opasnost	o p ǎː s n oː s t
<|HBS|>opet	ô p eː t
<|HBS|>opravdan	ǒ p r aː ʋ d aː n
<|HBS|>opredeliti	o p r e d ěː l i t i
<|HBS|>oprostite	o p r ǒ s t i t e
<|HBS|>opsesivno	ô p s e s iː ʋ n o
<|HBS|>optika	ǒ p t i k a
<|HBS|>oronuo	o r ǒ n u o
<|HBS|>osamljen	ǒ s aː m ʎ e n
<|HBS|>osjećati	ǒ s j e t͡ɕ a t i
<|HBS|>osobit	ǒ s o b i t
<|HBS|>ostanak	ǒ s t a n a k
<|HBS|>ostvarivati	o s t ʋ a r ǐː ʋ a t i
<|HBS|>osuđivati	o s u d͡ʑ ǐː ʋ a t i
<|HBS|>osvajanje	o s ʋ ǎː j aː ɲ e
<|HBS|>osvajač	o s ʋ ǎ j aː t͡ʃ
<|HBS|>osvojiti	o s ʋ ǒ j i t i
<|HBS|>osvrt	ǒ s ʋ r t
<|HBS|>otkloniti	o t k l ǒ n i t i
<|HBS|>otkriti	ǒ t k r i t i
<|HBS|>otkrivati	o t k r ǐː ʋ a t i
<|HBS|>otplivati	ǒ t p l i ʋ a t i
<|HBS|>otvoriti	o t ʋ ǒ r i t i
<|HBS|>ovđe	ǒː ʋ d͡ʑ e
<|HBS|>očigledno	ô t͡ʃ i ɡ l eː d n o
<|HBS|>očistiti	ǒ t͡ʃ i s t i t i
<|HBS|>padobran	p â d o b r aː n
<|HBS|>paketić	p a k ě t i t͡ɕ
<|HBS|>pakistanski	p â k i s t aː n s k iː
<|HBS|>pametan	p â m e t a n
<|HBS|>papir	p ǎ p iː r
<|HBS|>paragraf	p a r ǎ ɡ r a f
<|HBS|>paralelno	p a r a l ě l n o
<|HBS|>pariz	p ǎ r iː z
<|HBS|>parče	p ǎː r t͡ʃ e
<|HBS|>pasoš	p âː s o ʃ
<|HBS|>patetično	p a t ě t i t͡ʃ n o
<|HBS|>pedijatar	p e d ǐ j aː t a r
<|HBS|>percepcija	p e r t͡s ě p t͡s i j a
<|HBS|>perfekt	p ě r f e k t
<|HBS|>perjanica	p ě r j a n i t͡s a
<|HBS|>peru	p e r u
<|HBS|>perverzan	p ě r ʋ e r z a n
<|HBS|>pečat	p ě t͡ʃ a t
<|HBS|>pijesak	p i j ěː s a k
<|HBS|>pik	p î k
<|HBS|>pipa	p î p a
<|HBS|>plakati	p l â k a t i
<|HBS|>plamenac	p l a m ěː n a t͡s
<|HBS|>platno	p l ǎː t n o
<|HBS|>plač	p l â t͡ʃ
<|HBS|>ples	p l êː s
<|HBS|>plesati	p l ěː s a t i
<|HBS|>plinovod	p l î n o ʋ oː d
<|HBS|>pluralizam	p l u r a l ǐ z a m
<|HBS|>podignuti	p ǒ d i ɡ n u t i
<|HBS|>poduzeće	p o d u z e t͡ɕ e
<|HBS|>poglavlje	p ǒ ɡ l aː ʋ ʎ e
<|HBS|>pogled	p ô ɡ l eː d
<|HBS|>pogoditi	p o ɡ ǒ d i t i
<|HBS|>pogreška	p ǒ ɡ r e ʃ k a
<|HBS|>poguban	p ô ɡ uː b a n
<|HBS|>pohod	p ǒ x o d
<|HBS|>pojam	p ǒː j a m
<|HBS|>pokazatelj	p o k ǎ z a t e ʎ
<|HBS|>pokidati	p ǒ k i d a t i
<|HBS|>pokloniti	p o k l ǒ n i t i
<|HBS|>pokvariti	p o k ʋ ǎː r i t i
<|HBS|>polazak	p ǒ l a z a k
<|HBS|>položaj	p ô l o ʒ aː j
<|HBS|>pomicati	p ǒ m i t͡s a t i
<|HBS|>pomišljati	p o m ǐː ʃ ʎ a t i
<|HBS|>ponajprije	p ǒ n aː j p r i j e
<|HBS|>popis	p ǒ p i s
<|HBS|>popisati	p o p ǐː s a t i
<|HBS|>porasti	p ǒ r aː s t i
<|HBS|>portal	p ǒ r t aː l
<|HBS|>posebno	p ǒː s e b n o
<|HBS|>posetilac	p o s ě t i l a t͡s
<|HBS|>posjeta	p ô s j e t a
<|HBS|>posjetiti	p ǒ s j e t i t i
<|HBS|>poslanstvo	p o s l ǎː n s t ʋ o
<|HBS|>poslušno	p ô s l uː ʃ n o
<|HBS|>postizati	p ǒ s t i z a t i
<|HBS|>postolje	p ǒː s t oː ʎ e
<|HBS|>potencijal	p o t e n t͡s ǐ j aː l
<|HBS|>potok	p ǒ t o k
<|HBS|>potvrditi	p o t ʋ řː d i t i
<|HBS|>povezati	p o ʋ ěː z a t i
<|HBS|>povlačiti	p o ʋ l ǎː t͡ʃ i t i
<|HBS|>povraćati	p ǒ ʋ r a t͡ɕ a t i
<|HBS|>pozadina	p ǒ z a d i n a
<|HBS|>pozdrav	p ô z d r aː ʋ
<|HBS|>pozvati	p ǒ z ʋ a t i
<|HBS|>početak	p o t͡ʃ ěː t a k
<|HBS|>pošast	p ô ʃ aː s t
<|HBS|>poštovanje	p o ʃ t o ʋ ǎː ɲ e
<|HBS|>pramen	p r â m eː n
<|HBS|>pravilo	p r â ʋ i l o
<|HBS|>pred	p r ê d
<|HBS|>predak	p r ê d a k
<|HBS|>predlog	p r ěː d l o ɡ
<|HBS|>predočiti	p r e d ǒ t͡ʃ i t i
<|HBS|>predvodnica	p r ě d ʋ o d n i t͡s a
<|HBS|>prekjuče	p r ê k j u t͡ʃ eː
<|HBS|>prekosutra	p r e k ǒ s u t r a
<|HBS|>prenositi	p r e n ǒ s i t i
<|HBS|>prepoznatljivost	p r e p o z n ǎ t ʎ i ʋ oː s t
<|HBS|>prepričavati	p r e p r i t͡ʃ ǎː ʋ a t i
<|HBS|>preseći	p r ě s e t͡ɕ i
<|HBS|>pretući	p r ě t uː t͡ɕ i
<|HBS|>prevaga	p r ê ʋ a ɡ a
<|HBS|>prevara	p r ê ʋ a r a
<|HBS|>prevladati	p r e ʋ l ǎː d a t i
<|HBS|>pridonijeti	p r i d ǒ n i j eː t i
<|HBS|>prijemnik	p r ǐ j eː m n iː k
<|HBS|>prijestolonasljednik	p r j e s t o l o n ǎː s ʎ e d n iː k
<|HBS|>prijevoz	p r j ěː ʋ o z
<|HBS|>primati	p r ǐː m a t i
<|HBS|>primjenjivati	p r i m j e ɲ ǐː ʋ a t i
<|HBS|>primjetno	p r î m j e t n o
<|HBS|>pripadnik	p r ǐ p a d n iː k
<|HBS|>pripovijedati	p r i p o ʋ j ěː d a t i
<|HBS|>priroda	p r ǐː r o d a
<|HBS|>pristojan	p r ǐː s t oː j a n
<|HBS|>pristupačno	p r î s t u p aː t͡ʃ n o
<|HBS|>privezivati	p r i ʋ e z ǐː ʋ a t i
<|HBS|>privreda	p r î ʋ r e d a
<|HBS|>privredni	p r î ʋ r e d n iː
<|HBS|>prkositi	p ř k o s i t i
<|HBS|>proba	p r ǒː b a
<|HBS|>probosti	p r ǒ b o s t i
<|HBS|>prodavačica	p r o d a ʋ ǎ t͡ʃ i t͡s a
<|HBS|>produkcija	p r o d ǔ k t͡s i j a
<|HBS|>produktivan	p r ô d u k t iː ʋ a n
<|HBS|>profit	p r ǒ f iː t
<|HBS|>proniknuti	p r ǒ n i k n u t i
<|HBS|>proročište	p r ǒ r o t͡ʃ iː ʃ t e
<|HBS|>prosto	p r ô s t o
<|HBS|>prosvjed	p r ǒ s ʋ j e d
<|HBS|>protektorat	p r o t e k t ǒ r aː t
<|HBS|>protivan	p r ô t iː ʋ a n
<|HBS|>proučiti	p r o ǔ t͡ʃ i t i
<|HBS|>prozor	p r ǒː z o r
<|HBS|>prožeti	p r ǒ ʒ eː t i
<|HBS|>psihoterapija	p s i x o t e r ǎ p i j a
<|HBS|>ptica	p t î t͡s a
<|HBS|>ptičurina	p t i t͡ʃ ǔ r i n a
<|HBS|>pucanj	p ûː t͡s a ɲ
<|HBS|>puk	p ûː k
<|HBS|>pšenica	p ʃ ě n i t͡s a
<|HBS|>radioaktivnost	r a d i o a k t ǐː ʋ n oː s t
<|HBS|>rajsferšlus	r ǎ j s f e r ʃ l u s
<|HBS|>raketa	r a k ě t a
<|HBS|>raspisati	r a s p ǐː s a t i
<|HBS|>rastaviti	r ǎ s t a ʋ i t i
<|HBS|>rastužiti	r a s t ǔː ʒ i t i
<|HBS|>ratifikacija	r a t i f i k ǎː t͡s i j a
<|HBS|>ravnopravnost	r a ʋ n o p r ǎː ʋ n oː s t
<|HBS|>ravnoteža	r a ʋ n o t ěː ʒ a
<|HBS|>razabrati	r a z ǎ b r a t i
<|HBS|>razlog	r ǎː z l o ɡ
<|HBS|>razmnožavati	r a z m n o ʒ ǎː ʋ a t i
<|HBS|>razredbeni	r ǎː z r e d b e n iː
<|HBS|>razumno	r â z uː m n o
<|HBS|>računovođa	r a t͡ʃ u n ǒ ʋ o d͡ʑ a
<|HBS|>reciklirati	r e t͡s i k l ǐː r a t i
<|HBS|>redak	r ěː d a k
<|HBS|>regulativa	r e ɡ u l a t ǐː ʋ a
<|HBS|>ren	r ê n
<|HBS|>reportaža	r e p o r t ǎː ʒ a
<|HBS|>reputacija	r e p u t ǎː t͡s i j a
<|HBS|>resor	r ě s oː r
<|HBS|>režiser	r e ʒ ǐ s eː r
<|HBS|>roditeljski	r ǒ d i t e ʎ s k iː
<|HBS|>ropstvo	r ǒ p s t ʋ o
<|HBS|>rođendan	r ô d͡ʑ e n d aː n
<|HBS|>rubinet	r u b ǐ n e t
<|HBS|>rukovoditi	r u k o ʋ ǒ d i t i
<|HBS|>sabor	s ǎː b o r
<|HBS|>saborski	s ǎː b o r s k iː
<|HBS|>sadra	s â d r a
<|HBS|>salata	s a l ǎː t a
<|HBS|>salona	s a l ôː n a
<|HBS|>sardinija	s ǎ r d iː n i j a
<|HBS|>sastavni	s ǎː s t a ʋ n iː
<|HBS|>satima	s ǎː t i m a
<|HBS|>sav	s â ʋ
<|HBS|>savet	s ǎː ʋ e t
<|HBS|>savez	s ǎː ʋ e z
<|HBS|>savijati	s a ʋ ǐː j a t i
<|HBS|>sedište	s ê d iː ʃ t e
<|HBS|>sedmi	s ê d m iː
<|HBS|>sedmorica	s e d m ǒ r i t͡s a
<|HBS|>seminar	s e m ǐ n aː r
<|HBS|>senzacija	s e n z ǎː t͡s i j a
<|HBS|>senzualan	s ê n z uː a l a n
<|HBS|>seoce	s e ǒ t͡s e
<|HBS|>septembar	s ě p t eː m b a r
<|HBS|>sigurnost	s i ɡ ǔː r n oː s t
<|HBS|>silno	s îː l n o
<|HBS|>simetrično	s i m ě t r i t͡ʃ n o
<|HBS|>singl	s ǐ n ɡ l
<|HBS|>sirijski	s îː r iː j s k iː
<|HBS|>sivac	s ǐː ʋ a t͡s
<|HBS|>sjaj	s j âː j
<|HBS|>sjajan	s j ǎː j a n
<|HBS|>sjednica	s j ê d n i t͡s a
<|HBS|>sjena	s j ê n a
<|HBS|>sjeveroistočno	s j e ʋ e r o ǐ s t o t͡ʃ n o
<|HBS|>sjeći	s j ê t͡ɕ i
<|HBS|>skolastika	s k o l ǎ s t i k a
<|HBS|>skresati	s k r ě s a t i
<|HBS|>skrob	s k r ô b
<|HBS|>skroz	s k r ôː z
<|HBS|>sladoled	s l â d o l eː d
<|HBS|>slast	s l âː s t
<|HBS|>slavonija	s l ǎ ʋ oː n i j a
<|HBS|>sledeći	s l ě d eː t͡ɕ iː
<|HBS|>slikar	s l î k aː r
<|HBS|>slon	s l ô n
<|HBS|>slovački	s l ǒ ʋ aː t͡ʃ k iː
<|HBS|>slovenija	s l ǒ ʋ eː n i j a
<|HBS|>smeće	s m ě t͡ɕ e
<|HBS|>smrditi	s m ř d i t i
<|HBS|>smuda	s m u d a
<|HBS|>sofija	s ǒ f i j a
<|HBS|>somun	s ǒ m uː n
<|HBS|>spavaonica	s p a ʋ a ǒː n i t͡s a
<|HBS|>spašavati	s p a ʃ ǎː ʋ a t i
<|HBS|>specifičan	s p e t͡s ǐ f i t͡ʃ a n
<|HBS|>specijalizacija	s p e t͡s i j a l i z ǎː t͡s i j a
<|HBS|>specijalno	s p ê t͡s i j aː l n o
<|HBS|>spiza	s p îː z a
<|HBS|>spolja	s p ô ʎ a
<|HBS|>spor	s p ô r
<|HBS|>sporazumijevati	s p o r a z u m j ěː ʋ a t i
<|HBS|>spoznati	s p ǒ z n a t i
<|HBS|>spustiti	s p ǔ s t i t i
<|HBS|>srednjoškolac	s r e d ɲ o ʃ k ǒː l a t͡s
<|HBS|>sretan	s r ê t a n
<|HBS|>sretati	s r ê t a t i
<|HBS|>srž	s r̂ː ʒ
<|HBS|>sticati	s t i t͡s a t i
<|HBS|>stiskati	s t ǐː s k a t i
<|HBS|>stizati	s t î z a t i
<|HBS|>stići	s t î t͡ɕ i
<|HBS|>stradati	s t r ǎː d a t i
<|HBS|>strah	s t r âː x
<|HBS|>stratopauza	s t r a t o p â u z a
<|HBS|>stroj	s t r ôː j
<|HBS|>stupa	s t û p a
<|HBS|>sudbina	s û d b i n a
<|HBS|>sumnjiv	s ǔ m ɲ i ʋ
<|HBS|>sumpor	s ûː m p o r
<|HBS|>sustavno	s ǔː s t aː ʋ n o
<|HBS|>sutkinja	s û t k i ɲ a
<|HBS|>suton	s ǔː t o n
<|HBS|>suv	s ûː ʋ
<|HBS|>suvenir	s u ʋ ě n iː r
<|HBS|>suviše	s û ʋ i ʃ eː
<|HBS|>sućut	s û t͡ɕ uː t
<|HBS|>sužen	s ûː ʒ e n
<|HBS|>suživot	s û ʒ i ʋ o t
<|HBS|>svakakav	s ʋ â k a k a ʋ
<|HBS|>svemirski	s ʋ ê m iː r s k iː
<|HBS|>svet	s ʋ êː t
<|HBS|>svidjeti	s ʋ î d j e t i
<|HBS|>svojstven	s ʋ ǒ j s t ʋ e n
<|HBS|>tadanji	t ǎ d a ɲ iː
<|HBS|>tajna	t âː j n a
<|HBS|>takozvani	t a k ǒ z ʋ aː n iː
<|HBS|>također	t a k ǒː d͡ʑ e r
<|HBS|>talac	t ǎː l a t͡s
<|HBS|>tačan	t â t͡ʃ a n
<|HBS|>tebi	t ê b i
<|HBS|>tegliti	t ê ɡ l i t i
<|HBS|>telegraf	t e l ě ɡ r a f
<|HBS|>telekomunikacija	t e l e k o m u n i k ǎː t͡s i j a
<|HBS|>teorija	t e ǒː r i j a
<|HBS|>terminologija	t e r m i n o l ǒ ɡ i j a
<|HBS|>testis	t ê s t i s
<|HBS|>tetiva	t ě t i ʋ a
<|HBS|>tirana	t i r ǎ n a
<|HBS|>tok	t ôː k
<|HBS|>tonuti	t ǒ n u t i
<|HBS|>točiti	t ǒ t͡ʃ i t i
<|HBS|>trajati	t r â j a t i
<|HBS|>tranzitni	t r ǎ n z iː t n iː
<|HBS|>trenutno	t r ê n uː t n o
<|HBS|>trezvenjak	t r e z ʋ ě ɲ aː k
<|HBS|>trezveno	t r ê z ʋ e n o
<|HBS|>tromjesečje	t r ǒ m j e s eː t͡ʃ j e
<|HBS|>trst	t r̂ s t
<|HBS|>trudan	t r ǔː d a n
<|HBS|>trunak	t r ǔː n a k
<|HBS|>tuka	t û k a
<|HBS|>tumačiti	t u m ǎː t͡ʃ i t i
<|HBS|>tur	t ûː r
<|HBS|>tužilac	t ǔ ʒ i l a t͡s
<|HBS|>tvornica	t ʋ ǒː r n i t͡s a
<|HBS|>ubaciti	u b ǎː t͡s i t i
<|HBS|>ubojica	ǔ b o j i t͡s a
<|HBS|>ubrizgavati	u b r i z ɡ ǎː ʋ a t i
<|HBS|>ugađati	u ɡ ǎː d͡ʑ a t i
<|HBS|>ugljen	û ɡ ʎ eː n
<|HBS|>ugrijati	ǔ ɡ r i j a t i
<|HBS|>ujediniti	u j e d ǐː n i t i
<|HBS|>uključivati	u k ʎ u t͡ʃ ǐː ʋ a t i
<|HBS|>ulaz	ǔ l a z
<|HBS|>umesto	ǔ m e s t o
<|HBS|>unaprijed	ǔ n a p r j eː d
<|HBS|>upiti	ǔ p i t i
<|HBS|>upotreba	û p o t r e b a
<|HBS|>uskrs	ǔ s k r s
<|HBS|>uspinjača	u s p ǐ ɲ a t͡ʃ a
<|HBS|>uspjeti	ǔ s p j e t i
<|HBS|>usto	ǔ s t oː
<|HBS|>uteg	ǔː t e ɡ
<|HBS|>uvidjeti	ǔ ʋ i d j e t i
<|HBS|>uvjeriti	ǔ ʋ j e r i t i
<|HBS|>uvrstiti	u ʋ řː s t i t i
<|HBS|>uzor	ǔː z o r
<|HBS|>uzorak	ǔː z o r a k
<|HBS|>uzvik	û z ʋ iː k
<|HBS|>učesnica	ǔ t͡ʃ e s n i t͡s a
<|HBS|>uštedjeti	u ʃ t ěː d j e t i
<|HBS|>ušće	ûː ʃ t͡ɕ e
<|HBS|>vandalizam	ʋ a n d a l ǐ z a m
<|HBS|>važiti	ʋ ǎː ʒ i t i
<|HBS|>vedro	ʋ e d r̩ o
<|HBS|>velški	ʋ ê l ʃ k iː
<|HBS|>verojatno	ʋ ê r o j aː t n o
<|HBS|>veterinarstvo	ʋ e t e r i n ǎː r s t ʋ o
<|HBS|>veće	ʋ ěː t͡ɕ e
<|HBS|>videokaseta	ʋ i d e o k a s ě t a
<|HBS|>vidjeti	ʋ î d j e t i
<|HBS|>viski	ʋ î s k i
<|HBS|>viza	ʋ ǐː z a
<|HBS|>vjenčanica	ʋ j e n t͡ʃ ǎ n i t͡s a
<|HBS|>vjerojatno	ʋ j ê r o j aː t n o
<|HBS|>vjerski	ʋ j ě r s k iː
<|HBS|>vlažnost	ʋ l â ʒ n oː s t
<|HBS|>vod	ʋ ôː d
<|HBS|>vodoravan	ʋ ô d o r aː ʋ a n
<|HBS|>vodoravno	ʋ ô d o r aː ʋ n o
<|HBS|>vodovod	ʋ ô d o ʋ oː d
<|HBS|>voz	ʋ ôː z
<|HBS|>voće	ʋ ǒ t͡ɕ e
<|HBS|>vratar	ʋ r ǎ t aː r
<|HBS|>vrenje	ʋ r ěː ɲ e
<|HBS|>vrijedan	ʋ r j ěː d a n
<|HBS|>vrijediti	ʋ r i j ěː d i t i
<|HBS|>vulkan	ʋ ǔ l k aː n
<|HBS|>zadirkivati	z a d i r k ǐː ʋ a t i
<|HBS|>zakasniti	z a k ǎ s n i t i
<|HBS|>zakazati	z a k ǎː z a t i
<|HBS|>zalog	z ǎː l o ɡ
<|HBS|>zameniti	z a m ěː n i t i
<|HBS|>zaokruživati	z a o k r u ʒ ǐː ʋ a t i
<|HBS|>zapad	z âː p a d
<|HBS|>zastor	z ǎː s t o r
<|HBS|>zavezati	z a ʋ ěː z a t i
<|HBS|>zavodnik	z ǎː ʋ o d n iː k
<|HBS|>zavodnički	z ǎː ʋ o d n i t͡ʃ k iː
<|HBS|>zavrijediti	z a ʋ r j ěː d i t i
<|HBS|>završiti	z a ʋ řː ʃ i t i
<|HBS|>zdravstveni	z d r ǎ ʋ s t ʋ e n iː
<|HBS|>zlostavljati	z l ǒ s t a ʋ ʎ a t i
<|HBS|>značiti	z n ǎː t͡ʃ i t i
<|HBS|>zob	z ôː b
<|HBS|>zrak	z r âː k
<|HBS|>zuba	z ǔː b aː
<|HBS|>zvanično	z ʋ ǎ n i t͡ʃ n o
<|HBS|>zvjezdan	z ʋ j ě z d a n
<|HBS|>ćeif	t͡ɕ ě i f
<|HBS|>čarolija	t͡ʃ a r ǒ l i j a
<|HBS|>čaršija	t͡ʃ ǎ r ʃ i j a
<|HBS|>časno	t͡ʃ â s n o
<|HBS|>čelični	t͡ʃ ě l i t͡ʃ n iː
<|HBS|>čep	t͡ʃ ê p
<|HBS|>čest	t͡ʃ êː s t
<|HBS|>čestit	t͡ʃ ě s t i t
<|HBS|>češnjak	t͡ʃ ě ʃ ɲ aː k
<|HBS|>čime	t͡ʃ ǐː m e
<|HBS|>čistka	t͡ʃ î s t k a
<|HBS|>čitanje	t͡ʃ ǐ t aː ɲ e
<|HBS|>čovječanstvo	t͡ʃ o ʋ j e t͡ʃ ǎ n s t ʋ o
<|HBS|>đubre	d͡ʑ û b r e
<|HBS|>šahin	ʃ ǎː x i n
<|HBS|>šala	ʃ ǎː l a
<|HBS|>šeher	ʃ ê x e r
<|HBS|>šiltkapa	ʃ î l t k a p a
<|HBS|>šina	ʃ î n a
<|HBS|>širiti	ʃ ǐː r i t i
<|HBS|>školarina	ʃ k o l ǎ r i n a
<|HBS|>škot	ʃ k ô t
<|HBS|>šljaka	ʃ ʎ â k a
<|HBS|>šljiva	ʃ ʎ î ʋ a
<|HBS|>šokantno	ʃ o k ǎ n t n o
<|HBS|>šou	ʃ ô u
<|HBS|>španjolac	ʃ p a ɲ ǒː l a t͡s
<|HBS|>štrajkati	ʃ t r â j k a t i
<|HBS|>štram	ʃ t r â m
<|HBS|>žalfija	ʒ ǎ l f i j a
<|HBS|>žbunje	ʒ b ûː ɲ e
<|HBS|>željko	ʒ êː ʎ k o
<|HBS|>ženevski	ʒ ě n e ʋ s k iː
<|HBS|>žestoko	ʒ e s t ǒ k o
<|HBS|>živahnost	ʒ î ʋ aː x n oː s t
<|POL|>abaton	a b a t ɔ n
<|POL|>abażur	a b a ʐ u r
<|POL|>abdykacja	a b d ɨ k a t͡s j a
<|POL|>abiturientach	a b i t u r j ɛ n t a x
<|POL|>abonentowi	a b ɔ n ɛ n t ɔ v i
<|POL|>abrazyjny	a b r a z ɨ j n ɨ
<|POL|>absolut	a p s ɔ l u t
<|POL|>absyd	a p s ɨ t
<|POL|>adiutański	a d j u t a ɲ s k i
<|POL|>administratoria	a d m i ɲ i s t r a t ɔ r j a
<|POL|>adwokacikowi	a d v ɔ k a t͡ɕ i k ɔ v i
<|POL|>adwokactwem	a d v ɔ k a t͡s t f ɛ m
<|POL|>aeronomiczny	a ɛ r ɔ n ɔ m i t͡ʂ n ɨ
<|POL|>aerozolowano	a ɛ r ɔ z ɔ l ɔ v a n ɔ
<|POL|>afarski	a f a r s k i
<|POL|>afatycznymi	a f a t ɨ t͡ʂ n ɨ m i
<|POL|>agrafko	a ɡ r a f k ɔ
<|POL|>agrest	a ɡ r ɛ s t
<|POL|>agronomiczny	a ɡ r ɔ n ɔ m i t͡ʂ n ɨ
<|POL|>alarmująco	a l a r m u j ɔ n t͡s ɔ
<|POL|>albańskich	a l b a ɲ s k i x
<|POL|>aleksytymia	a l ɛ k s ɨ t ɨ m j a
<|POL|>algierczyk	a l ɡ j ɛ r t͡ʂ ɨ k
<|POL|>aliterackie	a l i t ɛ r a t͡s k j ɛ
<|POL|>aluzyjnie	a l u z ɨ j ɲ ɛ
<|POL|>ambarkowanie	a m b a r k ɔ v a ɲ ɛ
<|POL|>amerykanista	a m ɛ r ɨ k a ɲ i s t a
<|POL|>amfiboliczny	a m f i b ɔ l i t͡ʂ n ɨ
<|POL|>amfiktionia	a m f i k t j ɔ ɲ a
<|POL|>amiant	a m j a n t
<|POL|>amonicyja	a m ɔ ɲ i t͡s ɨ j ɒ
<|POL|>anafora	a n a f ɔ r a
<|POL|>anatoksyna	a n a t ɔ k s ɨ n a
<|POL|>angina	a ŋ ɡ i n a
<|POL|>animowanie	a ɲ i m ɔ v a ɲ ɛ
<|POL|>apostatyczny	a p ɔ s t a t ɨ t͡ʂ n ɨ
<|POL|>apostolstwo	a p ɔ s t ɔ l s t f ɔ
<|POL|>apteką	a p t ɛ k ɔ w̃
<|POL|>arbitraż	a r b i t r a ʂ
<|POL|>archiwalne	a r x i v a l n ɛ
<|POL|>archiwizujące	a r x i v i z u j ɔ n t͡s ɛ
<|POL|>armada	a r m a d a
<|POL|>arteriosklerozie	a r t ɛ r j ɔ s k l ɛ r ɔ ʑ ɛ
<|POL|>artykulacje	a r t ɨ k u l a t͡s j ɛ
<|POL|>asenizator	a s ɛ ɲ i z a t ɔ r
<|POL|>asocjatywność	a s ɔ t͡s j a t ɨ v n ɔ ɕ t͡ɕ
<|POL|>asteniczny	a s t ɛ ɲ i t͡ʂ n ɨ
<|POL|>astrowieżyczkami	a s t r ɔ v j ɛ ʐ ɨ t͡ʂ k a m i
<|POL|>atakujecie	a t a k u j ɛ t͡ɕ ɛ
<|POL|>autobiograficzny	a w t ɔ b j ɔ ɡ r a f i t͡ʂ n ɨ
<|POL|>autokataliza	a w t ɔ k a t a l i z a
<|POL|>autokratka	a w t ɔ k r a t k a
<|POL|>autolizujesz	a w t ɔ l i z u j ɛ ʂ
<|POL|>autoryzowany	a w t ɔ r ɨ z ɔ v a n ɨ
<|POL|>autoryzowałaś	a w t ɔ r ɨ z ɔ v a w a ɕ
<|POL|>awanturniczy	a v a n t u r ɲ i t͡ʂ ɨ
<|POL|>babią	b a b j ɔ w̃
<|POL|>bagażowe	b a ɡ a ʐ ɔ v ɛ
<|POL|>bajtko	b ɒ j t k ɔ
<|POL|>balanga	b a l a ŋ ɡ a
<|POL|>bandoski	b a n d ɔ s k i
<|POL|>baniopień	b a ɲ ɔ p j ɛ ɲ
<|POL|>banknotowy	b a ŋ k n ɔ t ɔ v ɨ
<|POL|>bankrutowali	b a ŋ k r u t ɔ v a l i
<|POL|>bareizm	b a r ɛ i z m
<|POL|>barków	b a r k u f
<|POL|>basałyk	b a s a w ɨ k
<|POL|>basistek	b a ɕ i s t ɛ k
<|POL|>baw	b a f
<|POL|>bawola	b a v ɔ l a
<|POL|>bałwanić	b a w v a ɲ i t͡ɕ
<|POL|>bejca	b ɛ j t͡s a
<|POL|>bezcześciliby	b ɛ s t͡ʂ ɛ ɕ t͡ɕ i l i b ɨ
<|POL|>bezpieniężny	b ɛ s p j ɛ ɲ ɛ w̃ ʐ n ɨ
<|POL|>bezprefiksalny	b ɛ s p r ɛ f i k s a l n ɨ
<|POL|>bezpłatna	b ɛ s p w a t n a
<|POL|>bezwolnie	b ɛ z v ɔ l ɲ ɛ
<|POL|>bezwstydny	b ɛ s f s t ɨ d n ɨ
<|POL|>bezłożyskowcu	b ɛ z w ɔ ʐ ɨ s k ɔ f t͡s u
<|POL|>bełchatowianina	b ɛ w x a t ɔ v j a ɲ i n a
<|POL|>bidetowy	b i d ɛ t ɔ v ɨ
<|POL|>bidną	b i d n ɔ w̃
<|POL|>biegała	b j ɛ ɡ a w a
<|POL|>biegłaś	b j ɛ ɡ w a ɕ
<|POL|>bielskiego	b j ɛ l s k j ɛ ɡ ɔ
<|POL|>bielą	b j ɛ l ɔ w̃
<|POL|>biodro	b j ɔ d r ɔ
<|POL|>biogurt	b j ɔ ɡ u r t
<|POL|>biznesik	b i z n ɛ ɕ i k
<|POL|>biżuteryjny	b i ʐ u t ɛ r ɨ j n ɨ
<|POL|>bluz	b l u s
<|POL|>bluzeczki	b l u z ɛ t͡ʂ k i
<|POL|>bohaterski	b ɔ x a t ɛ r s k i
<|POL|>bombić	b ɔ m b i t͡ɕ
<|POL|>borowik	b ɔ r ɔ v i k
<|POL|>brekcja	b r ɛ k t͡s j a
<|POL|>bywaj	b ɨ v a j
<|POL|>błahostkom	b w a x ɔ s t k ɔ m
<|POL|>błądziłabyś	b w ɔ ɲ d͡ʑ i w a b ɨ ɕ
<|POL|>błądziłeś	b w ɔ ɲ d͡ʑ i w ɛ ɕ
<|POL|>cedzidło	t͡s ɛ d͡ʑ i d w ɔ
<|POL|>cennik	t͡s ɛ n ɲ i k
<|POL|>chmurką	x m u r k ɔ w̃
<|POL|>chodziłabym	x ɔ d͡ʑ i w a b ɨ m
<|POL|>chude	x u d ɛ
<|POL|>chutliwiec	x u t l i v j ɛ t͡s
<|POL|>ciachami	t͡ɕ a x a m i
<|POL|>ciarce	t͡ɕ a r t͡s ɛ
<|POL|>ciekawsko	t͡ɕ ɛ k a f s k ɔ
<|POL|>ciemięzca	t͡ɕ ɛ m j ɛ w̃ s t͡s a
<|POL|>cieni	t͡ɕ ɛ ɲ i
<|POL|>cierpliwej	t͡ɕ ɛ r p l i v ɛ j
<|POL|>cipcia	t͡ɕ i p t͡ɕ a
<|POL|>ciężarowych	t͡ɕ ɛ w̃ ʐ a r ɔ v ɨ x
<|POL|>cnotach	t͡s n ɔ t a x
<|POL|>college	k ɔ l ɛ t͡ʂ
<|POL|>cudzie	t͡s u d͡ʑ ɛ
<|POL|>cyk	t͡s ɨ k
<|POL|>cyzelować	t͡s ɨ z ɛ l ɔ v a t͡ɕ
<|POL|>czekanami	t͡ʂ ɛ k a n a m i
<|POL|>czwartej	t͡ʂ f a r t ɛ j
<|POL|>czytany	t͡ʂ ɨ t a n ɨ
<|POL|>czyścioszek	t͡ʂ ɨ ɕ t͡ɕ ɔ ʂ ɛ k
<|POL|>czyżyk	t͡ʂ ɨ ʐ ɨ k
<|POL|>często	t͡ʂ ɛ̃ s t ɔ
<|POL|>córą	t͡s u r ɔ w̃
<|POL|>danego	d a n ɛ ɡ ɔ
<|POL|>dawali	d a v a l i
<|POL|>deklamator	d ɛ k l a m a t ɔ r
<|POL|>demontowałaś	d ɛ m ɔ n t ɔ v a w a ɕ
<|POL|>dezorientować	d ɛ z ɔ r j ɛ n t ɔ v a t͡ɕ
<|POL|>diagnozuje	d j a ɡ n ɔ z u j ɛ
<|POL|>dialektycznie	d j a l ɛ k t ɨ t͡ʂ ɲ ɛ
<|POL|>doje	d ɔ j ɛ
<|POL|>doktor	d ɔ k t ɔ r
<|POL|>doktorski	d ɔ k t ɔ r s k i
<|POL|>donejtami	d ɔ n ɛ j t a m i
<|POL|>donejtom	d ɔ n ɛ j t ɔ m
<|POL|>donica	d ɔ ɲ i t͡s a
<|POL|>dostatek	d ɔ s t a t ɛ k
<|POL|>dostrzegasz	d ɔ s t ʂ ɛ ɡ a ʂ
<|POL|>dowiedziałem	d ɔ v j ɛ d͡ʑ a w ɛ m
<|POL|>drednot	d r ɛ d n ɔ t
<|POL|>drgalibyście	d r ɡ a l i b ɨ ɕ t͡ɕ ɛ
<|POL|>drągom	d r ɔ ŋ ɡ ɔ m
<|POL|>dubiel	d u b j ɛ l
<|POL|>duma	d u m a
<|POL|>dumni	d u m ɲ i
<|POL|>duńskie	d u ɲ s k j ɛ
<|POL|>dworca	d v ɔ r t͡s a
<|POL|>dwudziestosześcioletni	d v u d͡ʑ ɛ s t ɔ ʂ ɛ ɕ t͡ɕ ɔ l ɛ t ɲ i
<|POL|>dygać	d ɨ ɡ a t͡ɕ
<|POL|>dziesięcioletni	d͡ʑ ɛ ɕ ɛ ɲ t͡ɕ ɔ l ɛ t ɲ i
<|POL|>dzieła	d͡ʑ ɛ w a
<|POL|>dęłoby	d ɛ w ɔ b ɨ
<|POL|>dłubanka	d w u b a ŋ k a
<|POL|>echo	ɛ x ɔ
<|POL|>edytorski	ɛ d ɨ t ɔ r s k i
<|POL|>egzekucyjnego	ɛ ɡ z ɛ k u t͡s ɨ j n ɛ ɡ ɔ
<|POL|>egzotyczny	ɛ ɡ z ɔ t ɨ t͡ʂ n ɨ
<|POL|>eksportujecie	ɛ k s p ɔ r t u j ɛ t͡ɕ ɛ
<|POL|>elektronarzędzie	ɛ l ɛ k t r ɔ n a ʐ ɛ ɲ d͡ʑ ɛ
<|POL|>emotek	ɛ m ɔ t ɛ k
<|POL|>epidemiami	ɛ p i d ɛ m j a m i
<|POL|>epistemologia	ɛ p i s t ɛ m ɔ l ɔ ɡ j a
<|POL|>europarlamentarzystka	ɛ w r ɔ p a r l a m ɛ n t a ʐ ɨ s t k a
<|POL|>eweńskiemu	ɛ v ɛ ɲ s k j ɛ m u
<|POL|>ewolucja	ɛ v ɔ l u t͡s j a
<|POL|>fanaberie	f a n a b ɛ r j ɛ
<|POL|>faworyta	f a v ɔ r ɨ t a
<|POL|>fałszach	f a w ʂ a x
<|POL|>fałszem	f a w ʂ ɛ m
<|POL|>filiżaneczek	f i l i ʐ a n ɛ t͡ʂ ɛ k
<|POL|>filozofio	f i l ɔ z ɔ f j ɔ
<|POL|>firmą	f i r m ɔ w̃
<|POL|>flagowiec	f l a ɡ ɔ v j ɛ t͡s
<|POL|>fortunny	f ɔ r t u n n ɨ
<|POL|>fretkę	f r ɛ t k ɛ
<|POL|>frytkom	f r ɨ t k ɔ m
<|POL|>fryzyjska	f r ɨ z ɨ j s k a
<|POL|>frędzlu	f r ɛ n d͡z l u
<|POL|>galopowałeś	ɡ a l ɔ p ɔ v a w ɛ ɕ
<|POL|>garbowałam	ɡ a r b ɔ v a w a m
<|POL|>garczek	ɡ a r t͡ʂ ɛ k
<|POL|>gałęziak	ɡ a w ɛ ɲ ʑ a k
<|POL|>genewskim	ɡ ɛ n ɛ f s k i m
<|POL|>genie	ɡ ɛ ɲ ɛ
<|POL|>gierka	ɡ j ɛ r k a
<|POL|>gigabajt	ɡ i ɡ a b a j t
<|POL|>gimnazjów	ɡ i m n a z j u f
<|POL|>glewia	ɡ l ɛ v j a
<|POL|>gnać	ɡ n a t͡ɕ
<|POL|>gnijecie	ɡ ɲ i j ɛ t͡ɕ ɛ
<|POL|>gorzowianinem	ɡ ɔ ʐ ɔ v j a ɲ i n ɛ m
<|POL|>gospodarstwem	ɡ ɔ s p ɔ d a r s t f ɛ m
<|POL|>grahamkom	ɡ r a x a m k ɔ m
<|POL|>grawerujcie	ɡ r a v ɛ r u j t͡ɕ ɛ
<|POL|>gromny	ɡ r ɔ m n ɨ
<|POL|>grotom	ɡ r ɔ t ɔ m
<|POL|>grubowarg	ɡ r u b ɔ v a r k
<|POL|>grusze	ɡ r u ʂ ɛ
<|POL|>gruszek	ɡ r u ʂ ɛ k
<|POL|>grzejniczek	ɡ ʐ ɛ j ɲ i t͡ʂ ɛ k
<|POL|>grzeszek	ɡ ʐ ɛ ʂ ɛ k
<|POL|>gwiezdnymi	ɡ v j ɛ z d n ɨ m i
<|POL|>gwiezdną	ɡ v j ɛ z d n ɔ w̃
<|POL|>gębacz	ɡ ɛ m b a t͡ʂ
<|POL|>głuchego	ɡ w u x ɛ ɡ ɔ
<|POL|>haktywistka	x a k t ɨ v i s t k a
<|POL|>hawajskiej	x a v a j s k j ɛ j
<|POL|>hindustański	x i n d u s t a ɲ s k i
<|POL|>hipotetycznie	x i p ɔ t ɛ t ɨ t͡ʂ ɲ ɛ
<|POL|>hojniejszy	x ɔ j ɲ ɛ j ʂ ɨ
<|POL|>house	x a w s
<|POL|>identyfikowałyśmy	i d ɛ n t ɨ f i k ɔ v a w ɨ ɕ m ɨ
<|POL|>imię	i m j ɛ̃
<|POL|>irytująco	i r ɨ t u j ɔ n t͡s ɔ
<|POL|>islamska	i s l a m s k a
<|POL|>iwanko	i v a ŋ k ɔ
<|POL|>jadła	j a d w a
<|POL|>jamajskiej	j a m a j s k j ɛ j
<|POL|>janielski	j a ɲ ɛ l s k i
<|POL|>japończyk	j a p ɔ ɲ t͡ʂ ɨ k
<|POL|>japońsku	j a p ɔ ɲ s k u
<|POL|>jawnemu	j a v n ɛ m u
<|POL|>jaworznickim	j a v ɔ ʐ ɲ i t͡s k i m
<|POL|>jednokładność	j ɛ d n ɔ k w a d n ɔ ɕ t͡ɕ
<|POL|>jurzą	j u ʐ ɔ w̃
<|POL|>jętce	j ɛ n t t͡s ɛ
<|POL|>kaczkach	k a t͡ʂ k a x
<|POL|>kandela	k a n d ɛ l a
<|POL|>kapelusik	k a p ɛ l u ɕ i k
<|POL|>karmia	k a r m j a
<|POL|>kartridż	k a r t r i t͡ʂ
<|POL|>kawalarz	k a v a l a ʂ
<|POL|>każą	k a ʐ ɔ w̃
<|POL|>kidali	k i d a l i
<|POL|>kielecki	k j ɛ l ɛ t͡s k i
<|POL|>kladowi	k l a d ɔ v i
<|POL|>klawesyn	k l a v ɛ s ɨ n
<|POL|>knajpce	k n a j p t͡s ɛ
<|POL|>knute	k n u t ɛ
<|POL|>knuć	k n u t͡ɕ
<|POL|>kobieciarstwie	k ɔ b j ɛ t͡ɕ a r s t f j ɛ
<|POL|>kobzę	k ɔ b z ɛ
<|POL|>kochało	k ɔ x a w ɔ
<|POL|>kocurów	k ɔ t͡s u r u f
<|POL|>koiło	k ɔ i w ɔ
<|POL|>kolejowy	k ɔ l ɛ j ɔ v ɨ
<|POL|>kolekcjonowałabyś	k ɔ l ɛ k t͡s j ɔ n ɔ v a w a b ɨ ɕ
<|POL|>koleżeński	k ɔ l ɛ ʐ ɛ ɲ s k i
<|POL|>kolisty	k ɔ l i s t ɨ
<|POL|>komedią	k ɔ m ɛ d j ɔ w̃
<|POL|>kompletnie	k ɔ m p l ɛ t ɲ ɛ
<|POL|>komplikacja	k ɔ m p l i k a t͡s j a
<|POL|>konasz	k ɔ n a ʂ
<|POL|>konsumpcja	k ɔ n s u m p t͡s j a
<|POL|>kontemplacyjnie	k ɔ n t ɛ m p l a t͡s ɨ j ɲ ɛ
<|POL|>kontrolujmy	k ɔ n t r ɔ l u j m ɨ
<|POL|>konwalijki	k ɔ n v a l i j k i
<|POL|>kooptować	k ɔ ɔ p t ɔ v a t͡ɕ
<|POL|>koperta	k ɔ p ɛ r t a
<|POL|>korespondencyjny	k ɔ r ɛ s p ɔ n d ɛ n t͡s ɨ j n ɨ
<|POL|>kormorany	k ɔ r m ɔ r a n ɨ
<|POL|>koszula	k ɔ ʂ u l a
<|POL|>kotwić	k ɔ t f i t͡ɕ
<|POL|>kołach	k ɔ w a x
<|POL|>krab	k r a p
<|POL|>krasego	k r a s ɛ ɡ ɔ
<|POL|>krasemu	k r a s ɛ m u
<|POL|>kresą	k r ɛ s ɔ w̃
<|POL|>krową	k r ɔ v ɔ w̃
<|POL|>kręgielnia	k r ɛ ŋ ɡ j ɛ l ɲ a
<|POL|>krętek	k r ɛ n t ɛ k
<|POL|>kseruj	k s ɛ r u j
<|POL|>który	k t o r ɨ
<|POL|>kuców	k u t͡s u f
<|POL|>kulminacja	k u l m i n a t͡s j a
<|POL|>kupą	k u p ɔ w̃
<|POL|>kurwom	k u r v ɔ m
<|POL|>kępą	k ɛ m p ɔ w̃
<|POL|>kładłyby	k w a d w ɨ b ɨ
<|POL|>kłucie	k w u t͡ɕ ɛ
<|POL|>kłócicie	k w u t͡ɕ i t͡ɕ ɛ
<|POL|>lankijscy	l a ŋ k i j s t͡s ɨ
<|POL|>lapońskim	l a p ɔ ɲ s k i m
<|POL|>laudacja	l a w d a t͡s j a
<|POL|>leciałabym	l ɛ t͡ɕ a w a b ɨ m
<|POL|>lenek	l ɛ n ɛ k
<|POL|>lgnąc	l ɡ n ɔ n t͡s
<|POL|>liberia	l i b ɛ r j a
<|POL|>ligom	l i ɡ ɔ m
<|POL|>lnica	l ɲ i t͡s a
<|POL|>lubimy	l u b i m ɨ
<|POL|>lżejszego	l ʐ ɛ j ʂ ɛ ɡ ɔ
<|POL|>manekin	m a n ɛ k i n
<|POL|>marokański	m a r ɔ k a ɲ s k i
<|POL|>martwak	m a r t f a k
<|POL|>mary	m a r ɨ
<|POL|>maskowaniami	m a s k ɔ v a ɲ a m i
<|POL|>matę	m a t ɛ
<|POL|>mdlący	m d l ɔ n t͡s ɨ
<|POL|>memłać	m ɛ m w a t͡ɕ
<|POL|>metresa	m ɛ t r ɛ s a
<|POL|>mieszkaniem	m j ɛ ʂ k a ɲ ɛ m
<|POL|>miglanc	m i ɡ l a n t͡s
<|POL|>mile	m i l ɛ
<|POL|>milusie	m i l u ɕ ɛ
<|POL|>minięcie	m i ɲ ɛ ɲ t͡ɕ ɛ
<|POL|>minoga	m i n ɔ ɡ a
<|POL|>mir	m i r
<|POL|>mizeriom	m i z ɛ r j ɔ m
<|POL|>monopolisty	m ɔ n ɔ p ɔ l i s t ɨ
<|POL|>moralniak	m ɔ r a l ɲ a k
<|POL|>moralnie	m ɔ r a l ɲ ɛ
<|POL|>mordowałby	m ɔ r d ɔ v a w b ɨ
<|POL|>mordowałem	m ɔ r d ɔ v a w ɛ m
<|POL|>mrówce	m r u f t͡s ɛ
<|POL|>mrąc	m r ɔ n t͡s
<|POL|>municypalny	m u ɲ i t͡s ɨ p a l n ɨ
<|POL|>muszkatołowcem	m u ʂ k a t ɔ w ɔ f t͡s ɛ m
<|POL|>muszkatołowcom	m u ʂ k a t ɔ w ɔ f t͡s ɔ m
<|POL|>muszkatołowiec	m u ʂ k a t ɔ w ɔ v j ɛ t͡s
<|POL|>muzułmańskiej	m u z u w m a ɲ s k j ɛ j
<|POL|>muzyków	m u z ɨ k u f
<|POL|>mycka	m ɨ t͡s k a
<|POL|>myszą	m ɨ ʂ ɔ w̃
<|POL|>myślałoby	m ɨ ɕ l a w ɔ b ɨ
<|POL|>mędrszego	m ɛ n t r ʂ ɛ ɡ ɔ
<|POL|>mękę	m ɛ ŋ k ɛ
<|POL|>młoteczek	m w ɔ t ɛ t͡ʂ ɛ k
<|POL|>nadciąć	n a t t͡ɕ ɔ ɲ t͡ɕ
<|POL|>nadsiębierny	n a t ɕ ɛ m b j ɛ r n ɨ
<|POL|>nadużyć	n a d u ʐ ɨ t͡ɕ
<|POL|>nagnieść	n a ɡ ɲ e ɕ t͡ɕ
<|POL|>naiwniutki	n a i v ɲ u t k i
<|POL|>najciężsi	n a j t͡ɕ ɛ w̃ ʂ ɕ i
<|POL|>najcięższa	n a j t͡ɕ ɛ w̃ ʂ ʂ a
<|POL|>najebka	n a j ɛ p k a
<|POL|>najmądrzej	n a j m ɔ n d ʐ ɛ j
<|POL|>najowocniejszej	n a j ɔ v ɔ t͡s ɲ ɛ j ʂ ɛ j
<|POL|>najrozmowniej	n a j r ɔ z m ɔ v ɲ ɛ j
<|POL|>najszlachetniejszy	n a j ʂ l a x ɛ t ɲ ɛ j ʂ ɨ
<|POL|>najtwardszy	n a j t f a r t ʂ ɨ
<|POL|>nalewacie	n a l ɛ v a t͡ɕ ɛ
<|POL|>należą	n a l ɛ ʐ ɔ w̃
<|POL|>namawiaj	n a m a v j a j
<|POL|>nanizać	n a ɲ i z a t͡ɕ
<|POL|>napoję	n a p ɔ j ɛ
<|POL|>naprawialiśmy	n a p r a v j a l i ɕ m ɨ
<|POL|>narciarskie	n a r t͡ɕ a r s k j ɛ
<|POL|>narowie	n a r ɔ v j ɛ
<|POL|>nawyknąć	n a v ɨ k n ɔ ɲ t͡ɕ
<|POL|>nazadnik	n a z a d ɲ i k
<|POL|>nazywałybyśmy	n a z ɨ v a w ɨ b ɨ ɕ m ɨ
<|POL|>naładowywać	n a w a d ɔ v ɨ v a t͡ɕ
<|POL|>naścieła	n a ɕ t͡ɕ ɛ w a
<|POL|>nianią	ɲ a ɲ ɔ w̃
<|POL|>nicią	ɲ i t͡ɕ ɔ w̃
<|POL|>niebieskie	ɲ ɛ b j ɛ s k j ɛ
<|POL|>niegrzecznym	ɲ ɛ ɡ ʐ ɛ t͡ʂ n ɨ m
<|POL|>niepodległy	ɲ ɛ p ɔ d l ɛ ɡ w ɨ
<|POL|>nieracjonalność	ɲ ɛ r a t͡s j ɔ n a l n ɔ ɕ t͡ɕ
<|POL|>nierzetelny	ɲ ɛ ʐ ɛ t ɛ l n ɨ
<|POL|>nieuchronnie	ɲ ɛ u x r ɔ n ɲ ɛ
<|POL|>nieuctwo	ɲ ɛ w u t͡s t f ɔ
<|POL|>nieudacznica	ɲ ɛ u d a t͡ʂ ɲ i t͡s a
<|POL|>niewolnictwu	ɲ ɛ v ɔ l ɲ i t͡s t f u
<|POL|>nieznaczni	ɲ ɛ z n a t͡ʂ ɲ i
<|POL|>niw	ɲ i f
<|POL|>nizał	ɲ i z a w
<|POL|>norami	n ɔ r a m i
<|POL|>notowalibyście	n ɔ t ɔ v a l i b ɨ ɕ t͡ɕ ɛ
<|POL|>nożowi	n ɔ ʐ ɔ v i
<|POL|>nucą	n u t͡s ɔ w̃
<|POL|>numizmatyka	n u m i z m a t ɨ k a
<|POL|>nóżce	n u ʂ t͡s ɛ
<|POL|>obcas	ɔ p t͡s a s
<|POL|>obelga	ɔ b ɛ l ɡ a
<|POL|>oberwanie	ɔ b ɛ r v a ɲ ɛ
<|POL|>obiadami	ɔ b j a d a m i
<|POL|>obije	ɔ b i j ɛ
<|POL|>obmacać	ɔ b m a t͡s a t͡ɕ
<|POL|>obozów	ɔ b ɔ z u f
<|POL|>obskurny	ɔ p s k u r n ɨ
<|POL|>obsyłać	ɔ p s ɨ ɫ a t͡ɕ
<|POL|>obwąchiwać	ɔ b v ɔ w̃ x i v a t͡ɕ
<|POL|>ocalone	ɔ t͡s a l ɔ n ɛ
<|POL|>odetrzeć	ɔ d ɛ t r̝ ɛ t͡ɕ
<|POL|>odjechanie	ɔ d j ɛ x a ɲ ɛ
<|POL|>odkryty	ɔ t k r ɨ t ɨ
<|POL|>odkładach	ɔ t k w a d a x
<|POL|>odradzało	ɔ d r a d͡z a w ɔ
<|POL|>odsiać	ɔ t ɕ a t͡ɕ
<|POL|>odsyłacz	ɔ t s ɨ w a t͡ʂ
<|POL|>odśnieżałam	ɔ t ɕ ɲ ɛ ʐ a w a m
<|POL|>odśpiewanie	ɔ t ɕ p j ɛ v a ɲ ɛ
<|POL|>oficjalnie	ɔ f i t͡s j a l ɲ ɛ
<|POL|>oglądałyście	ɔ ɡ l ɔ n d a w ɨ ɕ t͡ɕ ɛ
<|POL|>ogniskowy	ɔ ɡ ɲ i s k ɔ v ɨ
<|POL|>ojebać	ɔ j ɛ b a t͡ɕ
<|POL|>okapi	ɔ k a p i
<|POL|>okazjonalny	ɔ k a z j ɔ n a l n ɨ
<|POL|>okradajcie	ɔ k r a d a j t͡ɕ ɛ
<|POL|>okroi	ɔ k r ɔ i
<|POL|>oktawa	ɔ k t a v a
<|POL|>okładzik	ɔ k w a d͡ʑ i k
<|POL|>oleiście	ɔ l ɛ i ɕ t͡ɕ ɛ
<|POL|>opatentowałoby	ɔ p a t ɛ n t ɔ v a w ɔ b ɨ
<|POL|>opera	ɔ p ɛ r a
<|POL|>opiekę	ɔ p j ɛ k ɛ
<|POL|>opowiedacz	ɔ p ɔ v j ɛ d a t͡ʂ
<|POL|>oprowadzało	ɔ p r ɔ v a d͡z a w ɔ
<|POL|>opłacać	ɔ p w a t͡s a t͡ɕ
<|POL|>orda	ɔ r d a
<|POL|>organizuje	ɔ r ɡ a ɲ i z u j ɛ
<|POL|>osa	ɔ s a
<|POL|>oskoły	ɔ s k ɔ w ɨ
<|POL|>ostrzegały	ɔ s t ʂ ɛ ɡ a w ɨ
<|POL|>oszałamiać	ɔ ʂ a w a m j a t͡ɕ
<|POL|>osączenie	ɔ s ɔ n t͡ʂ ɛ ɲ ɛ
<|POL|>osłuchać	ɔ s w u x a t͡ɕ
<|POL|>ot	ɔ t
<|POL|>otaczający	ɔ t a t͡ʂ a j ɔ n t͡s ɨ
<|POL|>otwartą	ɔ t f a r t ɔ w̃
<|POL|>ozorom	ɔ z ɔ r ɔ m
<|POL|>oślego	ɔ ɕ l ɛ ɡ ɔ
<|POL|>oświetlałybyście	ɔ ɕ f j ɛ t l a w ɨ b ɨ ɕ t͡ɕ ɛ
<|POL|>pacniecie	p a t͡s ɲ ɛ t͡ɕ ɛ
<|POL|>pad	p a t
<|POL|>padem	p a d ɛ m
<|POL|>padło	p a d w ɔ
<|POL|>parapsychologia	p a r a p s ɨ x ɔ l ɔ ɡ j a
<|POL|>pareidolia	p a r ɛ i d ɔ l j a
<|POL|>park	p a r k
<|POL|>pasmu	p a s m u
<|POL|>pastami	p a s t a m i
<|POL|>pastuch	p a s t u x
<|POL|>paszczur	p a ʂ t͡ʂ u r
<|POL|>pasłam	p a s w a m
<|POL|>pchlimi	p x l i m i
<|POL|>peonia	p ɛ ɔ ɲ j a
<|POL|>perskim	p ɛ r s k i m
<|POL|>persz	p ɛ r ʂ
<|POL|>pewniak	p ɛ v ɲ a k
<|POL|>pełzacz	p ɛ w z a t͡ʂ
<|POL|>pełła	p ɛ w w a
<|POL|>pełłam	p ɛ w w a m
<|POL|>piknąć	p i k n ɔ ɲ t͡ɕ
<|POL|>pilnowały	p i l n ɔ v a w ɨ
<|POL|>pirotechnika	p i r ɔ t ɛ x ɲ i k a
<|POL|>pisankę	p i s a ŋ k ɛ
<|POL|>pisało	p i s a w ɔ
<|POL|>pitę	p i t ɛ
<|POL|>pięcioksiąg	p j ɛ ɲ t͡ɕ ɔ k ɕ ɔ ŋ k
<|POL|>piętnastego	p j ɛ n t n a s t ɛ ɡ ɔ
<|POL|>piłodziób	p i w ɔ d͡ʑ u p
<|POL|>plandeka	p l a n d ɛ k a
<|POL|>pobrany	p ɔ b r a n ɨ
<|POL|>pochylać	p ɔ x ɨ l a t͡ɕ
<|POL|>pociot	p ɔ t͡ɕ ɔ t
<|POL|>podejrzewałybyście	p ɔ d ɛ j ʐ ɛ v a w ɨ b ɨ ɕ t͡ɕ ɛ
<|POL|>podgrzewać	p ɔ d ɡ ʐ ɛ v a t͡ɕ
<|POL|>podli	p ɔ d l i
<|POL|>podtlenek	p ɔ t t l ɛ n ɛ k
<|POL|>podówczas	p ɔ d u f t͡ʂ a s
<|POL|>pogardzałaby	p ɔ ɡ a r d͡z a w a b ɨ
<|POL|>pokrzepianie	p ɔ k ʂ ɛ p j a ɲ ɛ
<|POL|>polek	p ɔ l ɛ k
<|POL|>politowanie	p ɔ l i t ɔ v a ɲ ɛ
<|POL|>pomagamy	p ɔ m a ɡ a m ɨ
<|POL|>pomocniczko	p ɔ m ɔ t͡s ɲ i t͡ʂ k ɔ
<|POL|>poprzedni	p ɔ p ʂ ɛ d ɲ i
<|POL|>pornografie	p ɔ r n ɔ ɡ r a f j ɛ
<|POL|>porze	p ɔ ʐ ɛ
<|POL|>posikać	p ɔ ɕ i k a t͡ɕ
<|POL|>postach	p ɔ s t a x
<|POL|>posłużyć	p ɔ s w u ʐ ɨ t͡ɕ
<|POL|>powiedz	p ɔ v j ɛ t͡s
<|POL|>powiewać	p ɔ v j ɛ v a t͡ɕ
<|POL|>powtarzający	p ɔ f t a ʐ a j ɔ n t͡s ɨ
<|POL|>pozbywać	p ɔ z b ɨ v a t͡ɕ
<|POL|>pozorny	p ɔ z ɔ r n ɨ
<|POL|>pozostali	p ɔ z ɔ s t a l i
<|POL|>pozwalam	p ɔ z v a l a m
<|POL|>pozwolić	p ɔ z v ɔ l i t͡ɕ
<|POL|>połykają	p ɔ w ɨ k a j ɔ w̃
<|POL|>poślubiać	p ɔ ɕ l u b j a t͡ɕ
<|POL|>pożyczkobiorca	p ɔ ʐ ɨ t͡ʂ k ɔ b j ɔ r t͡s a
<|POL|>pradolina	p r a d ɔ l i n a
<|POL|>pragębowiec	p r a ɡ ɛ m b ɔ v j ɛ t͡s
<|POL|>prawdziwek	p r a v d͡ʑ i v ɛ k
<|POL|>prezenty	p r ɛ z ɛ n t ɨ
<|POL|>produkowała	p r ɔ d u k ɔ v a w a
<|POL|>produkowałyśmy	p r ɔ d u k ɔ v a w ɨ ɕ m ɨ
<|POL|>programowała	p r ɔ ɡ r a m ɔ v a w a
<|POL|>pryskać	p r ɨ s k a t͡ɕ
<|POL|>pryszczyki	p r ɨ ʂ t͡ʂ ɨ k i
<|POL|>przebijanie	p ʂ ɛ b i j a ɲ ɛ
<|POL|>przeciwnie	p ʂ ɛ t͡ɕ i v ɲ ɛ
<|POL|>przekroję	p ʂ ɛ k r ɔ j ɛ
<|POL|>przekąska	p ʂ ɛ k ɔ w̃ s k a
<|POL|>przekładowość	p ʂ ɛ k w a d ɔ v ɔ ɕ t͡ɕ
<|POL|>przeleźć	p ʂ ɛ l ɛ ɕ t͡ɕ
<|POL|>przestępczyni	p ʂ ɛ s t ɛ m p t͡ʂ ɨ ɲ i
<|POL|>przeważać	p ʂ ɛ v a ʐ a t͡ɕ
<|POL|>przybierać	p ʂ ɨ b j ɛ r a t͡ɕ
<|POL|>przydługi	p ʂ ɨ d w u ɡ i
<|POL|>przyjacielski	p ʂ ɨ j a t͡ɕ ɛ l s k i
<|POL|>przyjąć	p ʂ ɨ j ɔ ɲ t͡ɕ
<|POL|>przymierzyć	p ʂ ɨ m j ɛ ʐ ɨ t͡ɕ
<|POL|>przypominali	p ʂ ɨ p ɔ m i n a l i
<|POL|>przyskrzyniać	p ʂ ɨ s k ʂ ɨ ɲ a t͡ɕ
<|POL|>przystrzyc	p ʂ ɨ s t ʂ ɨ t͡s
<|POL|>próbowało	p r u b ɔ v a w ɔ
<|POL|>psiskiem	p ɕ i s k j ɛ m
<|POL|>psuje	p s u j ɛ
<|POL|>psychol	p s ɨ x ɔ l
<|POL|>publicystycznie	p u b l i t͡s ɨ s t ɨ t͡ʂ ɲ ɛ
<|POL|>pulsacyjny	p u l s a t͡s ɨ j n ɨ
<|POL|>pustułko	p u s t u w k ɔ
<|POL|>puszkować	p u ʂ k ɔ v a t͡ɕ
<|POL|>północnik	p u w n ɔ t͡s ɲ i k
<|POL|>pękaliście	p ɛ ŋ k a l i ɕ t͡ɕ ɛ
<|POL|>raczy	r a t͡ʂ ɨ
<|POL|>radosne	r a d ɔ s n ɛ
<|POL|>raki	r a k i
<|POL|>rakla	r a k l a
<|POL|>rdestówka	r d ɛ s t u f k a
<|POL|>receptura	r ɛ t͡s ɛ p t u r a
<|POL|>rekompensata	r ɛ k ɔ m p ɛ n s a t a
<|POL|>reling	r ɛ l i ŋ k
<|POL|>renegocjacja	r ɛ n ɛ ɡ ɔ t͡s j a t͡s j a
<|POL|>rezerwowałybyśmy	r ɛ z ɛ r v ɔ v a w ɨ b ɨ ɕ m ɨ
<|POL|>rezerwując	r ɛ z ɛ r v u j ɔ n t͡s
<|POL|>rezjański	r ɛ z j a ɲ s k i
<|POL|>rozciągłość	r ɔ s t͡ɕ ɔ ŋ ɡ w ɔ ɕ t͡ɕ
<|POL|>rozkurcz	r ɔ s k u r t͡ʂ
<|POL|>rozpaczałyście	r ɔ s p a t͡ʂ a w ɨ ɕ t͡ɕ ɛ
<|POL|>rozpakowywać	r ɔ s p a k ɔ v ɨ v a t͡ɕ
<|POL|>rozpoczęłoby	r ɔ s p ɔ t͡ʂ ɛ w ɔ b ɨ
<|POL|>rozpuszczenie	r ɔ s p u ʂ t͡ʂ ɛ ɲ ɛ
<|POL|>rozrobienie	r ɔ z r ɔ b j ɛ ɲ ɛ
<|POL|>rozważało	r ɔ z v a ʐ a w ɔ
<|POL|>rwandyjski	r v a n d ɨ j s k i
<|POL|>rwandyjskie	r v a n d ɨ j s k j ɛ
<|POL|>rysowałem	r ɨ s ɔ v a w ɛ m
<|POL|>rytach	r ɨ t a x
<|POL|>ryłach	r ɨ w a x
<|POL|>rzeki	ʐ ɛ k i
<|POL|>rzeźbiarkę	ʐ ɛ ʑ b j a r k ɛ
<|POL|>rzutnik	ʐ u t ɲ i k
<|POL|>równania	r u v n a ɲ a
<|POL|>rączka	r ɔ n t͡ʂ k a
<|POL|>rżą	r ʐ ɔ w̃
<|POL|>sadzić	s a d͡ʑ i t͡ɕ
<|POL|>sadziła	s a d͡ʑ i w a
<|POL|>samico	s a m i t͡s ɔ
<|POL|>sampel	s a m p ɛ l
<|POL|>samym	s a m ɨ m
<|POL|>seminaryjny	s ɛ m i n a r ɨ j n ɨ
<|POL|>siaja	ɕ a j a
<|POL|>siarkę	ɕ a r k ɛ
<|POL|>siejba	ɕ ɛ j b a
<|POL|>siądzie	ɕ ɔ ɲ d͡ʑ ɛ
<|POL|>sięgnąć	ɕ ɛ ŋ ɡ n ɔ ɲ t͡ɕ
<|POL|>skaut	s k a w t
<|POL|>skazana	s k a z a n a
<|POL|>skończą	s k ɔ ɲ t͡ʂ ɔ w̃
<|POL|>skrajnie	s k r a j ɲ ɛ
<|POL|>skręcenie	s k r ɛ n t͡s ɛ ɲ ɛ
<|POL|>składałyśmy	s k w a d a w ɨ ɕ m ɨ
<|POL|>smarknąć	s m a r k n ɔ ɲ t͡ɕ
<|POL|>smarując	s m a r u j ɔ n t͡s
<|POL|>snajper	s n a j p ɛ r
<|POL|>sobolim	s ɔ b ɔ l i m
<|POL|>spadał	s p a d a w
<|POL|>sparszeć	s p a r ʂ ɛ t͡ɕ
<|POL|>spasanie	s p a s a ɲ ɛ
<|POL|>spawam	s p a v a m
<|POL|>spaście	s p a ɕ t͡ɕ ɛ
<|POL|>spinacz	s p i n a t͡ʂ
<|POL|>spiłować	s p i w ɔ v a t͡ɕ
<|POL|>spontanicznie	s p ɔ n t a ɲ i t͡ʂ ɲ ɛ
<|POL|>sprawię	s p r a v j ɛ
<|POL|>sprawniejszy	s p r a v ɲ ɛ j ʂ ɨ
<|POL|>sprzysiężenie	s p ʂ ɨ ɕ ɛ w̃ ʐ ɛ ɲ ɛ
<|POL|>spłowieć	s p w ɔ v j ɛ t͡ɕ
<|POL|>stacje	s t a t͡s j ɛ
<|POL|>staja	s t a j a
<|POL|>stanowczo	s t a n ɔ f t͡ʂ ɔ
<|POL|>starcze	s t a r t͡ʂ ɛ
<|POL|>stawać	s t a v a t͡ɕ
<|POL|>sterane	s t ɛ r a n ɛ
<|POL|>stopami	s t ɔ p a m i
<|POL|>strachliwie	s t r a x l i v j ɛ
<|POL|>straszniejszy	s t r a ʂ ɲ ɛ j ʂ ɨ
<|POL|>straw	s t r a f
<|POL|>strefa	s t r ɛ f a
<|POL|>stroić	s t r ɔ i t͡ɕ
<|POL|>strumyczek	s t r u m ɨ t͡ʂ ɛ k
<|POL|>studiowałyście	s t u d j ɔ v a w ɨ ɕ t͡ɕ ɛ
<|POL|>stężeń	s t ɛ w̃ ʐ ɛ ɲ
<|POL|>sudański	s u d a ɲ s k i
<|POL|>surogat	s u r ɔ ɡ a t
<|POL|>surówkami	s u r u f k a m i
<|POL|>suszą	s u ʂ ɔ w̃
<|POL|>swawole	s f a v ɔ l ɛ
<|POL|>syllabus	s ɨ l l a b u s
<|POL|>sympozjum	s ɨ m p ɔ z j u m
<|POL|>synkopa	s ɨ ŋ k ɔ p a
<|POL|>szachistkach	ʂ a x i s t k a x
<|POL|>szarawym	ʂ a r a v ɨ m
<|POL|>szczujnia	ʂ t͡ʂ u j ɲ a
<|POL|>szczęśliwe	ʂ t͡ʂ ɛ ɲ ɕ l i v ɛ
<|POL|>szklanka	ʂ k l a ŋ k a
<|POL|>szmelc	ʂ m ɛ l t͡s
<|POL|>szpaczek	ʂ p a t͡ʂ ɛ k
<|POL|>szukani	ʂ u k a ɲ i
<|POL|>szumówka	ʂ u m u f k a
<|POL|>szwajcarska	ʂ f a j t͡s a r s k a
<|POL|>szwy	ʂ f ɨ
<|POL|>szyfrujący	ʂ ɨ f r u j ɔ n t͡s ɨ
<|POL|>sępów	s ɛ m p u f
<|POL|>tajfun	t a j f u n
<|POL|>tajność	t a j n ɔ ɕ t͡ɕ
<|POL|>taniej	t a ɲ ɛ j
<|POL|>taninowy	t a ɲ i n ɔ v ɨ
<|POL|>taternik	t a t ɛ r ɲ i k
<|POL|>tatuowałyście	t a t u ɔ v a w ɨ ɕ t͡ɕ ɛ
<|POL|>telewizornia	t ɛ l ɛ v i z ɔ r ɲ a
<|POL|>teraźniejszemu	t ɛ r a ʑ ɲ ɛ j ʂ ɛ m u
<|POL|>todze	t ɔ d͡z ɛ
<|POL|>toku	t ɔ k u
<|POL|>tomikach	t ɔ m i k a x
<|POL|>toporom	t ɔ p ɔ r ɔ m
<|POL|>torturować	t ɔ r t u r ɔ v a t͡ɕ
<|POL|>towarzyska	t ɔ v a ʐ ɨ s k a
<|POL|>tramp	t r a m p
<|POL|>troskliwa	t r ɔ s k l i v a
<|POL|>trzmieli	t ʂ m j ɛ l i
<|POL|>trzmielimi	t ʂ m j ɛ l i m i
<|POL|>trzydziesta	t ʂ ɨ d͡ʑ ɛ s t a
<|POL|>tunezyjskiej	t u n ɛ z ɨ j s k j ɛ j
<|POL|>twierdzę	t f j ɛ r d͡z ɛ
<|POL|>tygrysiego	t ɨ ɡ r ɨ ɕ ɛ ɡ ɔ
<|POL|>tyra	t ɨ r a
<|POL|>tyłeczek	t ɨ w ɛ t͡ʂ ɛ k
<|POL|>uczęszczać	u t͡ʂ ɛ w̃ ʂ t͡ʂ a t͡ɕ
<|POL|>ufając	u f a j ɔ n t͡s
<|POL|>ufający	u f a j ɔ n t͡s ɨ
<|POL|>ufundować	u f u n d ɔ v a t͡ɕ
<|POL|>ujmo	u j m ɔ
<|POL|>ujmą	u j m ɔ w̃
<|POL|>ująć	u j ɔ ɲ t͡ɕ
<|POL|>ukrainizacja	u k r a i ɲ i z a t͡s j a
<|POL|>umili	u m i l i
<|POL|>umilknąć	u m i l k n ɔ ɲ t͡ɕ
<|POL|>umkniecie	u m k ɲ ɛ t͡ɕ ɛ
<|POL|>umoralnić	u m ɔ r a l ɲ i t͡ɕ
<|POL|>umyć	u m ɨ t͡ɕ
<|POL|>unieśmiertelnić	u ɲ ɛ ɕ m j ɛ r t ɛ l ɲ i t͡ɕ
<|POL|>uosobić	u ɔ s ɔ b i t͡ɕ
<|POL|>upartym	u p a r t ɨ m
<|POL|>upłynniać	u p w ɨ n ɲ a t͡ɕ
<|POL|>urocze	u r ɔ t͡ʂ ɛ
<|POL|>uroczystość	u r ɔ t͡ʂ ɨ s t ɔ ɕ t͡ɕ
<|POL|>urzucić	u ʐ u t͡ɕ i t͡ɕ
<|POL|>ustabilizować	u s t a b i l i z ɔ v a t͡ɕ
<|POL|>usteczka	u s t ɛ t͡ʂ k a
<|POL|>utraci	u t r a t͡ɕ i
<|POL|>uwypuklać	u v ɨ p u k l a t͡ɕ
<|POL|>wanilii	v a ɲ i l j i
<|POL|>warko	v a r k ɔ
<|POL|>warszawiakach	v a r ʂ a v j a k a x
<|POL|>wbudować	v b u d ɔ v a t͡ɕ
<|POL|>wdarcie	v d a r t͡ɕ ɛ
<|POL|>wegetariańskiego	v ɛ ɡ ɛ t a r j a ɲ s k j ɛ ɡ ɔ
<|POL|>wejdziemy	v ɛ j d͡ʑ ɛ m ɨ
<|POL|>wersalikowi	v ɛ r s a l i k ɔ v i
<|POL|>wiertłom	v j ɛ r t w ɔ m
<|POL|>wiewiórach	v j ɛ v j u r a x
<|POL|>wileńskiemu	v i l ɛ ɲ s k j ɛ m u
<|POL|>winniczek	v i n ɲ i t͡ʂ ɛ k
<|POL|>wirkach	v i r k a x
<|POL|>witałyście	v i t a w ɨ ɕ t͡ɕ ɛ
<|POL|>wodoleczniczy	v ɔ d ɔ l ɛ t͡ʂ ɲ i t͡ʂ ɨ
<|POL|>worywać	v ɔ r ɨ v a t͡ɕ
<|POL|>wspinać	f s p i n a t͡ɕ
<|POL|>wszczepić	f ʂ t͡ʂ ɛ p i t͡ɕ
<|POL|>wtrząchnąć	f t ʂ ɔ w̃ x n ɔ ɲ t͡ɕ
<|POL|>wulgarnie	v u l ɡ a r ɲ ɛ
<|POL|>wuwuzela	v u v u z ɛ l a
<|POL|>wychwalać	v ɨ x f a l a t͡ɕ
<|POL|>wyciągnięcie	v ɨ t͡ɕ ɔ ŋ ɡ ɲ ɛ ɲ t͡ɕ ɛ
<|POL|>wyczucie	v ɨ t͡ʂ u t͡ɕ ɛ
<|POL|>wyizolować	v ɨ i z ɔ l ɔ v a t͡ɕ
<|POL|>wyjaśnialibyście	v ɨ j a ɕ ɲ a l i b ɨ ɕ t͡ɕ ɛ
<|POL|>wyjmowałam	v ɨ j m ɔ v a w a m
<|POL|>wyjmujmy	v ɨ j m u j m ɨ
<|POL|>wykarczować	v ɨ k a r t͡ʂ ɔ v a t͡ɕ
<|POL|>wylaszczyć	v ɨ l a ʂ t͡ʂ ɨ t͡ɕ
<|POL|>wyleczenie	v ɨ l ɛ t͡ʂ ɛ ɲ ɛ
<|POL|>wymalowanie	v ɨ m a l ɔ v a ɲ ɛ
<|POL|>wymówienie	v ɨ m o v j ɛ ɲ e
<|POL|>wypolerowanie	v ɨ p ɔ l ɛ r ɔ v a ɲ ɛ
<|POL|>wypryskanie	v ɨ p r ɨ s k a ɲ ɛ
<|POL|>wypróżnienie	v ɨ p r u ʐ ɲ ɛ ɲ ɛ
<|POL|>wypłacalny	v ɨ p w a t͡s a l n ɨ
<|POL|>wyrazy	v ɨ r a z ɨ
<|POL|>wyrolować	v ɨ r ɔ l ɔ v a t͡ɕ
<|POL|>wysokim	v ɨ s ɔ k i m
<|POL|>wysyłali	v ɨ s ɨ w a l i
<|POL|>wytypować	v ɨ t ɨ p ɔ v a t͡ɕ
<|POL|>wytłumaczyć	v ɨ t w u m a t͡ʂ ɨ t͡ɕ
<|POL|>wąsa	v ɔ w̃ s a
<|POL|>wędrowałyby	v ɛ n d r ɔ v a w ɨ b ɨ
<|POL|>władać	v w a d a t͡ɕ
<|POL|>włoskim	v w ɔ s k i m
<|POL|>włączałyście	v w ɔ n t͡ʂ a w ɨ ɕ t͡ɕ ɛ
<|POL|>zaciąży	z a t͡ɕ ɔ w̃ ʐ ɨ
<|POL|>zaczęli	z a t͡ʂ ɛ l i
<|POL|>zagnie	z a ɡ ɲ ɛ
<|POL|>zajazd	z a j a s t
<|POL|>zajęcze	z a j ɛ n t͡ʂ ɛ
<|POL|>zależne	z a l ɛ ʐ n ɛ
<|POL|>zamaczać	z a m a t͡ʂ a t͡ɕ
<|POL|>zamienny	z a m j ɛ n n ɨ
<|POL|>zamęt	z a m ɛ n t
<|POL|>zapadam	z a p a d a m
<|POL|>zaparty	z a p a r t ɨ
<|POL|>zapraszałbyś	z a p r a ʂ a w b ɨ ɕ
<|POL|>zaprzeczyć	z a p ʂ ɛ t͡ʂ ɨ t͡ɕ
<|POL|>zaprzęg	z a p ʂ ɛ ŋ k
<|POL|>zaradzić	z a r a d͡ʑ i t͡ɕ
<|POL|>zarżnąć	z a r ʐ n ɔ ɲ t͡ɕ
<|POL|>zasługiwanie	z a s w u ɡ i v a ɲ ɛ
<|POL|>zatok	z a t ɔ k
<|POL|>zatrać	z a t r a t͡ɕ
<|POL|>zatrzask	z a t ʂ a s k
<|POL|>zaufajcie	z a w f a j t͡ɕ ɛ
<|POL|>zaufali	z a w f a l i
<|POL|>zaufaliby	z a w f a l i b ɨ
<|POL|>zaufałbym	z a w f a w b ɨ m
<|POL|>zautoryzowałyby	z a w t ɔ r ɨ z ɔ v a w ɨ b ɨ
<|POL|>zawszę	z a f ʂ ɛ
<|POL|>zazielenianie	z a ʑ ɛ l ɛ ɲ a ɲ ɛ
<|POL|>zaśpiewanie	z a ɕ p j ɛ v a ɲ ɛ
<|POL|>zażegnywać	z a ʐ ɛ ɡ n ɨ v a t͡ɕ
<|POL|>zbaczać	z b a t͡ʂ a t͡ɕ
<|POL|>zbożu	z b ɔ ʐ u
<|POL|>zdubbingowały	z d a b i ŋ ɡ ɔ v a w ɨ
<|POL|>zgój	z ɡ u j
<|POL|>ziewałaby	ʑ ɛ v a w a b ɨ
<|POL|>zlepienie	z l ɛ p j ɛ ɲ ɛ
<|POL|>zmechacić	z m ɛ x a t͡ɕ i t͡ɕ
<|POL|>zmiatać	z m j a t a t͡ɕ
<|POL|>zmywarki	z m ɨ v a r k i
<|POL|>znajdowałybyście	z n a j d ɔ v a w ɨ b ɨ ɕ t͡ɕ ɛ
<|POL|>znakomitość	z n a k ɔ m i t ɔ ɕ t͡ɕ
<|POL|>zono	z ɔ n ɔ
<|POL|>zsyłać	s s ɨ w a t͡ɕ
<|POL|>zszywka	s ʂ ɨ f k a
<|POL|>zwani	z v a ɲ i
<|POL|>zwiedzałabym	z v j ɛ d͡z a w a b ɨ m
<|POL|>zwinnie	z v i n ɲ ɛ
<|POL|>złożeniom	z w ɔ ʐ ɛ ɲ ɔ m
<|POL|>złożonemu	z w ɔ ʐ ɔ n ɛ m u
<|POL|>łacha	w a x a
<|POL|>łachę	w a x ɛ
<|POL|>łagier	w a ɡ j ɛ r
<|POL|>łapią	w a p j ɔ w̃
<|POL|>łasce	w a s t͡s ɛ
<|POL|>łezka	w ɛ s k a
<|POL|>łonie	w ɔ ɲ ɛ
<|POL|>łono	w ɔ n ɔ
<|POL|>łotewsku	w ɔ t ɛ f s k u
<|POL|>łowie	w ɔ v j ɛ
<|POL|>łupiną	w u p i n ɔ w̃
<|POL|>łódź	w u t͡ɕ
<|POL|>ń	ɲ
<|POL|>Światłowicz	ɕ f j a t w ɔ v i t͡ʂ
<|POL|>ścierające	ɕ t͡ɕ ɛ r a j ɔ n t͡s ɛ
<|POL|>ścieraliby	ɕ t͡ɕ ɛ r a l i b ɨ
<|POL|>śnieguła	ɕ ɲ ɛ ɡ u w a
<|POL|>środku	ɕ r ɔ t k u
<|POL|>świerzbiec	ɕ f j ɛ ʐ b j ɛ t͡s
<|POL|>świntuch	ɕ f i n t u x
<|POL|>Żagań	ʐ a ɡ a ɲ
<|POL|>żabki	ʐ a p k i
<|POL|>żalu	ʐ a l u
<|POL|>żarnami	ʐ a r n a m i
<|POL|>żyjecie	ʐ ɨ j ɛ t͡ɕ ɛ
<|POL|>żyję	ʐ ɨ j ɛ
<|POL|>żyletko	ʐ ɨ l ɛ t k ɔ
<|POL|>żyrant	ʐ ɨ r a n t
<|POL|>żytu	ʐ ɨ t u
<|POL|>żyłeś	ʐ ɨ w ɛ ɕ
<|POL|>żądaniami	ʐ ɔ n d a ɲ a m i
<|POL|>żęłam	ʐ ɛ w a m
<|SLV|>afganistan	a ʋ ɡ áː n i s t a n
<|SLV|>akvarij	a k ʋ àː r i j
<|SLV|>aleksander	a l ɛ k s àː n d ə r
<|SLV|>alkohol	a l k ɔ x óː l
<|SLV|>aluminij	a l u m ìː n i j
<|SLV|>ameriški	a m ɛ́ː r i ʃ k i
<|SLV|>ampak	á m p a k
<|SLV|>anatomija	a n a t ɔ m íː j a
<|SLV|>andrej	a n d r ɛ̀ː j
<|SLV|>angel	àː n ɡ ɛ l
<|SLV|>angleščina	a n ɡ l éː ʃ t͡ʃ i n a
<|SLV|>anglež	a n ɡ l éː ʃ
<|SLV|>anglija	áː n ɡ l i j a
<|SLV|>apartma	a p a r t m áː
<|SLV|>april	a p r íː l
<|SLV|>armada	a r m áː d a
<|SLV|>avgust	a ʋ ɡ úː s t
<|SLV|>avto	áː ʋ t ɔ
<|SLV|>avtobus	áː ʋ t ɔ b u s
<|SLV|>bambus	b áː m b u s
<|SLV|>banka	b áː n k a
<|SLV|>barva	b áː r ʋ a
<|SLV|>bas	b áː s
<|SLV|>bati	b àː t i
<|SLV|>beg	b éː k
<|SLV|>bel	b èː ʋ
<|SLV|>beograd	b éː ɔ ɡ r a t
<|SLV|>beseda	b ɛ s éː d a
<|SLV|>beton	b ɛ t óː n
<|SLV|>bik	b í k
<|SLV|>bistvo	b íː s t ʋ ɔ
<|SLV|>biti	b ìː t i
<|SLV|>blago	b l a ɡ óː
<|SLV|>blato	b l àː t ɔ
<|SLV|>blizu	b l ìː z u
<|SLV|>bližje	b l íː ʒ j ɛ
<|SLV|>boben	b óː b ə n
<|SLV|>bodi	b òː d i
<|SLV|>bodo	b óː d ɔ
<|SLV|>bog	b óː k
<|SLV|>bogastvo	b ɔ ɡ áː s t ʋ ɔ
<|SLV|>boja	b óː j a
<|SLV|>bojo	b óː j ɔ
<|SLV|>bolezen	b ɔ l éː z ə n
<|SLV|>bolečina	b ɔ l ɛ t͡ʃ ìː n a
<|SLV|>bolgarka	b ɔ l ɡ áː r k a
<|SLV|>bolj	b ɔ́ l
<|SLV|>bolje	b óː l j ɛ
<|SLV|>boljše	b óː l ʃ ɛ
<|SLV|>boljši	b óː l ʃ i
<|SLV|>bolnica	b óː l n i t͡s a
<|SLV|>bolnik	b ɔ ʋ n ìː k
<|SLV|>bom	b óː m
<|SLV|>borza	b óː r z a
<|SLV|>bosta	b óː s t a
<|SLV|>boste	b óː s t ɛ
<|SLV|>boš	b óː ʃ
<|SLV|>bralnik	b r áː l n i k
<|SLV|>branik	b r a n ìː k
<|SLV|>brati	b r àː t i
<|SLV|>brazda	b r àː z d a
<|SLV|>brez	b r ɛ s
<|SLV|>brlog	b ə r l ɔ́ k
<|SLV|>brskati	b ə r s k a t i
<|SLV|>bruto	b r úː t ɔ
<|SLV|>carstvo	t͡s áː r s t ʋ ɔ
<|SLV|>cel	t͡s éː ʋ
<|SLV|>celo	t͡s ɛ l óː
<|SLV|>cena	t͡s èː n a
<|SLV|>cerkev	t͡s èː r k ə ʋ
<|SLV|>cev	t͡s éː ʋ
<|SLV|>cilj	t͡s íː l
<|SLV|>da	d á
<|SLV|>dajati	d a j àː t i
<|SLV|>dalj	d á l
<|SLV|>daljši	d áː l ʃ i
<|SLV|>dar	d áː r
<|SLV|>darilo	d a r ìː l ɔ
<|SLV|>davek	d àː ʋ ə k
<|SLV|>december	d ɛ t͡s ɛ̀ː m b ə r
<|SLV|>dejanje	d ɛ j áː n j ɛ
<|SLV|>dekle	d ɛ k l ɛ́
<|SLV|>delati	d èː l a t i
<|SLV|>delavec	d èː l a ʋ ə t͡s
<|SLV|>demokracija	d ɛ m ɔ k r a t͡s íː j a
<|SLV|>denar	d ɛ n àː r
<|SLV|>deset	d ɛ s éː t
<|SLV|>desetletje	d ɛ s ɛ t l éː t j ɛ
<|SLV|>devet	d ɛ ʋ éː t
<|SLV|>devica	d ɛ ʋ ìː t͡s a
<|SLV|>dežela	d ɛ ʒ ɛ̀ː l a
<|SLV|>dijak	d i j àː k
<|SLV|>dirka	d íː r k a
<|SLV|>dno	d n ɔ́
<|SLV|>do	d ɔ
<|SLV|>doba	d ɔ̀ː b a
<|SLV|>dober	d òː b ə r
<|SLV|>dobro	d ɔ̀ː b r ɔ
<|SLV|>dobrodošel	d ɔ b r ɔ d ɔ̀ː ʃ ə ʋ
<|SLV|>dogodek	d ɔ ɡ óː d ə k
<|SLV|>dogovor	d ɔ ɡ ɔ́ː ʋ ɔ r
<|SLV|>dolg	d ɔ́ː ʋ k
<|SLV|>dolžina	d ɔ ʋ ʒ ìː n a
<|SLV|>dom	d óː m
<|SLV|>doma	d ɔ m áː
<|SLV|>dovolj	d ɔ ʋ ɔ́ l
<|SLV|>dovoljenje	d ɔ ʋ ɔ l j ɛ̀ː n j ɛ
<|SLV|>doživeti	d ɔ ʒ i ʋ èː t i
<|SLV|>dražji	d r áː ʒ j i
<|SLV|>drevo	d r ɛ ʋ óː
<|SLV|>drog	d r óː k
<|SLV|>drug	d r úː k
<|SLV|>družina	d r u ʒ ìː n a
<|SLV|>država	d ə r ʒ áː ʋ a
<|SLV|>duh	d úː x
<|SLV|>dunaj	d ùː n a j
<|SLV|>duša	d ùː ʃ a
<|SLV|>dve	d ʋ éː
<|SLV|>dvigniti	d ʋ ìː ɡ n i t i
<|SLV|>ekologija	ɛ k ɔ l ɔ ɡ íː j a
<|SLV|>ekonomist	ɛ k ɔ n ɔ m íː s t
<|SLV|>ena	ɛ̀ː n a
<|SLV|>enajst	ɛ n àː j s t
<|SLV|>energija	ɛ n ɛ r ɡ íː j a
<|SLV|>enota	ɛ n ɔ̀ː t a
<|SLV|>fant	f á n t
<|SLV|>februar	f éː b r u a r
<|SLV|>file	f i l éː
<|SLV|>filozof	f i l ɔ z óː f
<|SLV|>finski	f íː n s k i
<|SLV|>fižol	f i ʒ ɔ́ ʋ
<|SLV|>fotograf	f ɔ t ɔ ɡ r áː f
<|SLV|>fotografija	f ɔ t ɔ ɡ r a f íː j a
<|SLV|>francija	f r àː n t͡s i j a
<|SLV|>francoski	f r a n t͡s óː s k i
<|SLV|>francosko	f r a n t͡s óː s k ɔ
<|SLV|>general	ɡ ɛ n ɛ r áː l
<|SLV|>geslo	ɡ ɛ̀ː s l ɔ
<|SLV|>gibanje	ɡ ìː b a n j ɛ
<|SLV|>glas	ɡ l áː s
<|SLV|>glasba	ɡ l áː z b a
<|SLV|>glasbenik	ɡ l áː z b ɛ n i k
<|SLV|>gledališče	ɡ l ɛ d a l ìː ʃ t͡ʃ ɛ
<|SLV|>gledati	ɡ l èː d a t i
<|SLV|>globok	ɡ l ɔ b ɔ́ k
<|SLV|>god	ɡ óː t
<|SLV|>godba	ɡ óː d b a
<|SLV|>gor	ɡ ɔ̀ː r
<|SLV|>gorica	ɡ ɔ r ìː t͡s a
<|SLV|>gospod	ɡ ɔ s p óː t
<|SLV|>gospodična	ɡ ɔ s p ɔ d íː t͡ʃ n a
<|SLV|>gosti	ɡ òː s t i
<|SLV|>govor	ɡ ɔ́ː ʋ ɔ r
<|SLV|>grad	ɡ r áː t
<|SLV|>gradec	ɡ r áː d ə t͡s
<|SLV|>grob	ɡ r ɔ́ p
<|SLV|>grof	ɡ r ɔ́ f
<|SLV|>grom	ɡ r ɔ́ m
<|SLV|>grozdje	ɡ r òː z d j ɛ
<|SLV|>grozljiv	ɡ r ɔ z l j ìː ʋ
<|SLV|>gumb	ɡ úː m p
<|SLV|>hip	x íː p
<|SLV|>hiša	x ìː ʃ a
<|SLV|>hladilnik	x l a d íː l n i k
<|SLV|>hlače	x l àː t͡ʃ ɛ
<|SLV|>hrana	x r àː n a
<|SLV|>hrast	x r àː s t
<|SLV|>hvala	x ʋ àː l a
<|SLV|>hči	x t͡ʃ íː
<|SLV|>igra	íː ɡ r a
<|SLV|>igralec	i ɡ r áː l ə t͡s
<|SLV|>igrati	i ɡ r àː t i
<|SLV|>ime	i m éː
<|SLV|>imeti	i m èː t i
<|SLV|>indija	ìː n d i j a
<|SLV|>inštitut	i n ʃ t i t úː t
<|SLV|>irska	íː r s k a
<|SLV|>isti	íː s t i
<|SLV|>italija	i t àː l i j a
<|SLV|>italijanski	i t a l i j áː n s k i
<|SLV|>ivan	íː ʋ a n
<|SLV|>iz	i s
<|SLV|>izbira	i z b íː r a
<|SLV|>izpeljati	i s p ɛ l j àː t i
<|SLV|>izraz	i z r á s
<|SLV|>jajce	j àː j t͡s ɛ
<|SLV|>januar	j áː n u a r
<|SLV|>javor	j àː ʋ ɔ r
<|SLV|>jaz	j á s
<|SLV|>jelka	j èː l k a
<|SLV|>jezik	j ɛ̀ː z i k
<|SLV|>jezus	j éː z u s
<|SLV|>jože	j óː ʒ ɛ
<|SLV|>junij	j ùː n i j
<|SLV|>jurij	j ùː r i j
<|SLV|>jutri	j úː t r i
<|SLV|>jutro	j ùː t r ɔ
<|SLV|>kadar	k á d a r
<|SLV|>kakor	k á k ɔ r
<|SLV|>kakovost	k a k ɔ̀ː ʋ ɔ s t
<|SLV|>kamen	k àː m ə n
<|SLV|>kapetan	k a p éː t a n
<|SLV|>karel	k àː r ə l
<|SLV|>karta	k áː r t a
<|SLV|>kategorija	k a t ɛ ɡ ɔ r íː j a
<|SLV|>kavčič	k áː ʋ t͡ʃ i t͡ʃ
<|SLV|>kazen	k áː z ə n
<|SLV|>kaznovati	k a z n ɔ ʋ àː t i
<|SLV|>kašelj	k àː ʃ ə l
<|SLV|>ki	k i
<|SLV|>kis	k íː s
<|SLV|>kit	k íː t
<|SLV|>kitajka	k i t áː j k a
<|SLV|>kjer	k j éː r
<|SLV|>klavir	k l a ʋ íː r
<|SLV|>klic	k l íː t͡s
<|SLV|>klicati	k l ìː t͡s a t i
<|SLV|>klobasa	k l ɔ b àː s a
<|SLV|>kmalu	k m áː l u
<|SLV|>kmet	k m ɛ́ t
<|SLV|>kmetija	k m ɛ t íː j a
<|SLV|>knez	k n éː s
<|SLV|>knjiga	k n j ìː ɡ a
<|SLV|>knjigarna	k n j i ɡ áː r n a
<|SLV|>književnost	k n j i ʒ éː ʋ n ɔ s t
<|SLV|>ko	k ɔ
<|SLV|>kobarid	k ɔ b a r íː t
<|SLV|>kocka	k óː t͡s k a
<|SLV|>koder	k òː d ə r
<|SLV|>koledar	k ɔ l ɛ d àː r
<|SLV|>koleno	k ɔ l èː n ɔ
<|SLV|>količina	k ɔ l i t͡ʃ ìː n a
<|SLV|>komaj	k óː m a j
<|SLV|>komunizem	k ɔ m u n ìː z ə m
<|SLV|>kondom	k ɔ n d óː m
<|SLV|>konj	k ɔ́ n
<|SLV|>konkretno	k ɔ n k r éː t n ɔ
<|SLV|>kopalnica	k ɔ p áː l n i t͡s a
<|SLV|>korak	k ɔ r áː k
<|SLV|>koreja	k ɔ r ɛ́ː j a
<|SLV|>koroška	k ɔ r óː ʃ k a
<|SLV|>kos	k óː s
<|SLV|>kosilo	k ɔ s ìː l ɔ
<|SLV|>kovanec	k ɔ ʋ àː n ə t͡s
<|SLV|>kovač	k ɔ ʋ àː t͡ʃ
<|SLV|>kozarec	k ɔ z áː r ə t͡s
<|SLV|>koš	k ɔ́ ʃ
<|SLV|>košarka	k ɔ ʃ áː r k a
<|SLV|>koža	k òː ʒ a
<|SLV|>krajši	k r áː j ʃ i
<|SLV|>kralj	k r àː l
<|SLV|>kraljica	k r a l j ìː t͡s a
<|SLV|>kratek	k r àː t ə k
<|SLV|>krema	k r éː m a
<|SLV|>krilo	k r ìː l ɔ
<|SLV|>krona	k r óː n a
<|SLV|>kruh	k r ú x
<|SLV|>ksenon	k s éː n ɔ n
<|SLV|>kuhinja	k ùː x i n j a
<|SLV|>kura	k ùː r a
<|SLV|>lahek	l àː x ə k
<|SLV|>lahko	l a x k óː
<|SLV|>lani	l àː n i
<|SLV|>las	l áː s
<|SLV|>lastnost	l a s t n óː s t
<|SLV|>lažji	l áː ʒ j i
<|SLV|>le	l ɛ́
<|SLV|>led	l éː t
<|SLV|>lep	l éː p
<|SLV|>lepota	l ɛ p ɔ̀ː t a
<|SLV|>lepši	l éː p ʃ i
<|SLV|>les	l éː s
<|SLV|>let	l ɛ́ t
<|SLV|>letalo	l ɛ t àː l ɔ
<|SLV|>leten	l éː t ə n
<|SLV|>ležaj	l ɛ ʒ áː j
<|SLV|>list	l íː s t
<|SLV|>literatura	l i t ɛ r a t úː r a
<|SLV|>ljubezen	l j u b éː z ə n
<|SLV|>ljubljana	l j u b l j àː n a
<|SLV|>log	l óː k
<|SLV|>lopata	l ɔ p àː t a
<|SLV|>los	l óː s
<|SLV|>lovec	l ɔ̀ː ʋ ə t͡s
<|SLV|>luna	l ùː n a
<|SLV|>madžarska	m a d͡ʒ áː r s k a
<|SLV|>maj	m àː j
<|SLV|>maja	m àː j a
<|SLV|>makedonija	m a k ɛ d òː n i j a
<|SLV|>malezija	m a l èː z i j a
<|SLV|>malo	m àː l ɔ
<|SLV|>malto	m áː l t ɔ
<|SLV|>manjši	m áː n ʃ i
<|SLV|>marec	m àː r ə t͡s
<|SLV|>marko	m àː r k ɔ
<|SLV|>matej	m a t ɛ́ː j
<|SLV|>mati	m àː t i
<|SLV|>maša	m àː ʃ a
<|SLV|>me	m éː
<|SLV|>medicina	m ɛ d i t͡s íː n a
<|SLV|>medved	m ɛ̀ː d ʋ ɛ t
<|SLV|>meh	m éː x
<|SLV|>meja	m ɛ̀ː j a
<|SLV|>melodija	m ɛ l ɔ d íː j a
<|SLV|>merjasec	m ɛ r j àː s ə t͡s
<|SLV|>meso	m ɛ s óː
<|SLV|>mesto	m èː s t ɔ
<|SLV|>met	m ɛ́ t
<|SLV|>metati	m ɛ t àː t i
<|SLV|>meč	m ɛ́ t͡ʃ
<|SLV|>mi	m íː
<|SLV|>mihaela	m íː x a ɛ l a
<|SLV|>milijon	m i l i j óː n
<|SLV|>mir	m íː r
<|SLV|>miti	m ìː t i
<|SLV|>miza	m ìː z a
<|SLV|>mleko	m l èː k ɔ
<|SLV|>moder	m òː d ə r
<|SLV|>mogoče	m ɔ ɡ òː t͡ʃ ɛ
<|SLV|>moj	m òː j
<|SLV|>mojzes	m óː j z ɛ s
<|SLV|>morda	m ɔ r d á
<|SLV|>morski	m ɔ̀ː r s k i
<|SLV|>moč	m óː t͡ʃ
<|SLV|>moči	m ɔ̀ː t͡ʃ i
<|SLV|>moški	m ɔ̀ː ʃ k i
<|SLV|>mož	m óː ʃ
<|SLV|>možnost	m òː ʒ n ɔ s t
<|SLV|>mraz	m r á s
<|SLV|>muslimanski	m u s l i m áː n s k i
<|SLV|>na	n a
<|SLV|>nad	n a t
<|SLV|>naenkrat	n a ɛ̀ː n k r a t
<|SLV|>nafta	n áː f t a
<|SLV|>naglas	n a ɡ l á s
<|SLV|>najbližje	n á j b l íː ʒ j ɛ
<|SLV|>najbolj	n á j b ɔ l
<|SLV|>najbolje	n á j b óː l j ɛ
<|SLV|>najboljše	n á j b óː l ʃ ɛ
<|SLV|>najboljši	n á j b óː l ʃ i
<|SLV|>najlepši	n á j l éː p ʃ i
<|SLV|>najmanjši	n á j m áː n ʃ i
<|SLV|>najpogosteje	n á j p ɔ ɡ óː s t ɛ j ɛ
<|SLV|>najpogostejše	n á j p ɔ ɡ óː s t ɛ j ʃ ɛ
<|SLV|>najslabše	n á j s l áː p ʃ ɛ
<|SLV|>najslabši	n á j s l áː p ʃ i
<|SLV|>najstarejši	n á j s t a r ɛ́ː j ʃ i
<|SLV|>najusodnejši	n á j u s òː d n ɛ j ʃ i
<|SLV|>največji	n á j ʋ éː t͡ʃ j i
<|SLV|>najvišji	n á j ʋ íː ʃ j i
<|SLV|>namera	n a m éː r a
<|SLV|>napad	n a p á t
<|SLV|>naprava	n a p r áː ʋ a
<|SLV|>naraven	n a r àː ʋ ə n
<|SLV|>naslednji	n a s l éː d n j i
<|SLV|>nastati	n a s t àː t i
<|SLV|>nataša	n a t áː ʃ a
<|SLV|>načelo	n a t͡ʃ ɛ̀ː l ɔ
<|SLV|>načrt	n a t͡ʃ ə́ r t
<|SLV|>naš	n á ʃ
<|SLV|>nedelja	n ɛ d èː l j a
<|SLV|>nekam	n èː k a m
<|SLV|>nemški	n èː m ʃ k i
<|SLV|>nemško	n èː m ʃ k ɔ
<|SLV|>neodvisen	n ɛ́ ɔ d ʋ ìː s ə n
<|SLV|>neptun	n ɛ p t úː n
<|SLV|>nikoli	n i k óː l i
<|SLV|>nit	n í t
<|SLV|>nizek	n ìː z ə k
<|SLV|>nič	n í t͡ʃ
<|SLV|>njen	n j èː n
<|SLV|>nos	n óː s
<|SLV|>nosilec	n ɔ s íː l ə t͡s
<|SLV|>nov	n ɔ́ ʋ
<|SLV|>november	n ɔ ʋ ɛ̀ː m b ə r
<|SLV|>noč	n óː t͡ʃ
<|SLV|>nož	n ɔ́ ʃ
<|SLV|>nuna	n ùː n a
<|SLV|>obiskati	ɔ b i s k àː t i
<|SLV|>oblast	ɔ b l áː s t
<|SLV|>oblika	ɔ b l íː k a
<|SLV|>obraz	ɔ b r á s
<|SLV|>obsedenost	ɔ p s éː d ɛ n ɔ s t
<|SLV|>občinstvo	ɔ p t͡ʃ íː n s t ʋ ɔ
<|SLV|>od	ɔ t
<|SLV|>oddajnik	ɔ d d áː j n i k
<|SLV|>oder	òː d ə r
<|SLV|>odličen	ɔ d l ìː t͡ʃ ə n
<|SLV|>odnos	ɔ d n ɔ́ s
<|SLV|>odpreti	ɔ t p r èː t i
<|SLV|>odrešenik	ɔ d r ɛ ʃ ɛ n ìː k
<|SLV|>oglas	ɔ ɡ l á s
<|SLV|>ogledalo	ɔ ɡ l ɛ d àː l ɔ
<|SLV|>oko	ɔ k óː
<|SLV|>oktober	ɔ k t òː b ə r
<|SLV|>olje	òː l j ɛ
<|SLV|>on	ɔ́ n
<|SLV|>ona	ɔ̀ː n a
<|SLV|>oni	ɔ̀ː n i
<|SLV|>oprostite	ɔ p r ɔ s t íː t ɛ
<|SLV|>optika	òː p t i k a
<|SLV|>organizacija	ɔ r ɡ a n i z àː t͡s i j a
<|SLV|>os	óː s
<|SLV|>osebnost	ɔ s éː b n ɔ s t
<|SLV|>osel	ɔ̀ː s ə ʋ
<|SLV|>oster	òː s t ə r
<|SLV|>otok	ɔ̀ː t ɔ k
<|SLV|>otrok	ɔ t r ɔ́ k
<|SLV|>ozek	òː z ə k
<|SLV|>oziroma	ɔ z íː r ɔ m a
<|SLV|>oznaka	ɔ z n áː k a
<|SLV|>pa	p a
<|SLV|>palma	p áː l m a
<|SLV|>pamet	p àː m ɛ t
<|SLV|>papež	p áː p ɛ ʃ
<|SLV|>papir	p a p íː r
<|SLV|>par	p àː r
<|SLV|>pavel	p áː ʋ ə l
<|SLV|>peljati	p ɛ l j àː t i
<|SLV|>pena	p èː n a
<|SLV|>pesem	p éː s ə m
<|SLV|>pet	p éː t
<|SLV|>petek	p èː t ə k
<|SLV|>peter	p èː t ə r
<|SLV|>pevec	p èː ʋ ə t͡s
<|SLV|>pečat	p ɛ t͡ʃ áː t
<|SLV|>pianist	p i j a n íː s t
<|SLV|>pila	p ìː l a
<|SLV|>pisarna	p i s áː r n a
<|SLV|>pismo	p ìː s m ɔ
<|SLV|>piščanec	p i ʃ t͡ʃ àː n ə t͡s
<|SLV|>pljučnica	p l j úː t͡ʃ n i t͡s a
<|SLV|>po	p ɔ
<|SLV|>poceni	p ɔ t͡s èː n i
<|SLV|>podgana	p ɔ d ɡ àː n a
<|SLV|>podrobnejši	p ɔ d r óː b n ɛ j ʃ i
<|SLV|>pogodba	p ɔ ɡ óː d b a
<|SLV|>pogoj	p ɔ ɡ ɔ́ j
<|SLV|>pogosteje	p ɔ ɡ óː s t ɛ j ɛ
<|SLV|>pogosto	p ɔ ɡ óː s t ɔ
<|SLV|>pogovarjati	p ɔ ɡ ɔ ʋ áː r j a t i
<|SLV|>pogovor	p ɔ ɡ ɔ́ː ʋ ɔ r
<|SLV|>pohištvo	p ɔ x íː ʃ t ʋ ɔ
<|SLV|>poklic	p ɔ k l íː t͡s
<|SLV|>pokrov	p ɔ k r ɔ́ ʋ
<|SLV|>polenovka	p ɔ l èː n ɔ ʋ k a
<|SLV|>poletje	p ɔ l éː t j ɛ
<|SLV|>poljski	p óː l s k i
<|SLV|>poljsko	p óː l s k ɔ
<|SLV|>poln	p ɔ́ː ʋ n
<|SLV|>polovica	p ɔ l ɔ ʋ ìː t͡s a
<|SLV|>položaj	p ɔ l ɔ ʒ áː j
<|SLV|>pomen	p ɔ m ɛ́ n
<|SLV|>pomoč	p ɔ m óː t͡ʃ
<|SLV|>pomočnik	p ɔ m ɔ t͡ʃ n ìː k
<|SLV|>popolnoma	p ɔ p ɔ́ː ʋ n ɔ m a
<|SLV|>poročilo	p ɔ r ɔ t͡ʃ ìː l ɔ
<|SLV|>poročnik	p ɔ r óː t͡ʃ n i k
<|SLV|>posebej	p ɔ s éː b ɛ j
<|SLV|>posel	p ɔ̀ː s ə ʋ
<|SLV|>postaja	p ɔ s t áː j a
<|SLV|>postati	p ɔ s t àː t i
<|SLV|>potok	p ɔ̀ː t ɔ k
<|SLV|>poudariti	p ɔ u d àː r i t i
<|SLV|>površina	p ɔ ʋ ə r ʃ ìː n a
<|SLV|>pozdrav	p ɔ z d r á ʋ
<|SLV|>pozen	p ɔ̀ː z ə n
<|SLV|>pozno	p ɔ̀ː z n ɔ
<|SLV|>počasi	p ɔ t͡ʃ áː s i
<|SLV|>počivati	p ɔ t͡ʃ ìː ʋ a t i
<|SLV|>požar	p ɔ ʒ áː r
<|SLV|>prah	p r áː x
<|SLV|>pravilneje	p r a ʋ íː l n ɛ j ɛ
<|SLV|>pravilno	p r a ʋ íː l n ɔ
<|SLV|>pravkar	p r á ʋ k a r
<|SLV|>pravo	p r áː ʋ ɔ
<|SLV|>prazen	p r àː z ə n
<|SLV|>pred	p r ɛ t
<|SLV|>predal	p r ɛ d áː l
<|SLV|>predlog	p r ɛ̀ː d l ɔ k
<|SLV|>predmet	p r ɛ̀ː d m ɛ t
<|SLV|>predsednik	p r ɛ t s éː d n i k
<|SLV|>predvideti	p r ɛ d ʋ ìː d ɛ t i
<|SLV|>presenečenje	p r ɛ s ɛ n éː t͡ʃ ɛ n j ɛ
<|SLV|>prestol	p r ɛ̀ː s t ɔ l
<|SLV|>prihodnji	p r i x óː d n j i
<|SLV|>prihodnost	p r i x óː d n ɔ s t
<|SLV|>prijatelj	p r i j áː t ɛ l
<|SLV|>prijeten	p r i j èː t ə n
<|SLV|>priložnost	p r i l òː ʒ n ɔ s t
<|SLV|>primer	p r i m éː r
<|SLV|>prisotnost	p r i s ɔ̀ː t n ɔ s t
<|SLV|>prispevek	p r i s p éː ʋ ə k
<|SLV|>priti	p r ìː t i
<|SLV|>pritisk	p r i t íː s k
<|SLV|>priznati	p r i z n àː t i
<|SLV|>programski	p r ɔ ɡ r áː m s k i
<|SLV|>prosim	p r òː s i m
<|SLV|>prostor	p r ɔ̀ː s t ɔ r
<|SLV|>prvak	p ə r ʋ àː k
<|SLV|>prvi	p ə́ r ʋ i
<|SLV|>prvoten	p ə r ʋ ɔ̀ː t ə n
<|SLV|>rana	r àː n a
<|SLV|>rasti	r àː s t i
<|SLV|>rastlina	r a s t l ìː n a
<|SLV|>raven	r àː ʋ ə n
<|SLV|>razlika	r a z l íː k a
<|SLV|>razred	r àː z r ɛ t
<|SLV|>razumeti	r a z u m èː t i
<|SLV|>razvoj	r a z ʋ ɔ́ j
<|SLV|>računalnik	r a t͡ʃ u n áː l n i k
<|SLV|>red	r éː t
<|SLV|>redko	r èː t k ɔ
<|SLV|>reka	r èː k a
<|SLV|>republika	r ɛ p ùː b l i k a
<|SLV|>revija	r ɛ ʋ íː j a
<|SLV|>reč	r éː t͡ʃ
<|SLV|>reči	r ɛ̀ː t͡ʃ i
<|SLV|>reši	r èː ʃ i
<|SLV|>rešitev	r ɛ ʃ íː t ə ʋ
<|SLV|>ris	r íː s
<|SLV|>risati	r íː s a t i
<|SLV|>rjav	ə r j á ʋ
<|SLV|>rojen	r ɔ̀ː j ɛ n
<|SLV|>roka	r ɔ̀ː k a
<|SLV|>roman	r ɔ m áː n
<|SLV|>romunija	r ɔ m ùː n i j a
<|SLV|>rozman	r óː z m a n
<|SLV|>rudar	r u d àː r
<|SLV|>rusija	r úː s i j a
<|SLV|>ruski	r úː s k i
<|SLV|>sanje	s àː n j ɛ
<|SLV|>sedem	s èː d ə m
<|SLV|>sedemdeset	s èː d ə m d ɛ s ɛ t
<|SLV|>seks	s éː k s
<|SLV|>sem	s ə́ m
<|SLV|>senca	s éː n t͡s a
<|SLV|>sestra	s ɛ̀ː s t r a
<|SLV|>seveda	s ɛ ʋ éː d a
<|SLV|>sila	s ìː l a
<|SLV|>simbol	s i m b óː l
<|SLV|>sin	s íː n
<|SLV|>sinonim	s i n ɔ n íː m
<|SLV|>sinoči	s i n óː t͡ʃ i
<|SLV|>sistem	s i s t éː m
<|SLV|>sit	s í t
<|SLV|>skala	s k àː l a
<|SLV|>skodelica	s k ɔ d éː l i t͡s a
<|SLV|>skrivnosten	s k r i ʋ n óː s t ə n
<|SLV|>skromnejši	s k r ɔ̀ː m n ɛ j ʃ i
<|SLV|>skupaj	s k úː p a j
<|SLV|>skupina	s k u p ìː n a
<|SLV|>skuša	s k ùː ʃ a
<|SLV|>slabo	s l a b óː
<|SLV|>slabše	s l áː p ʃ ɛ
<|SLV|>sladkor	s l àː t k ɔ r
<|SLV|>slap	s l áː p
<|SLV|>slišati	s l ìː ʃ a t i
<|SLV|>slop	s l ɔ́ p
<|SLV|>slovaška	s l ɔ ʋ áː ʃ k a
<|SLV|>slovaški	s l ɔ ʋ áː ʃ k i
<|SLV|>slovenec	s l ɔ ʋ èː n ə t͡s
<|SLV|>slovensko	s l ɔ ʋ èː n s k ɔ
<|SLV|>slovo	s l ɔ ʋ óː
<|SLV|>služba	s l úː ʒ b a
<|SLV|>smeh	s m éː x
<|SLV|>smel	s m éː ʋ
<|SLV|>smer	s m éː r
<|SLV|>smisel	s m íː s ə ʋ
<|SLV|>smo	s m ɔ́
<|SLV|>smrt	s m ə́ r t
<|SLV|>sneguljčica	s n ɛ ɡ úː l t͡ʃ i t͡s a
<|SLV|>so	s ɔ́
<|SLV|>soba	s ɔ̀ː b a
<|SLV|>sod	s óː t
<|SLV|>sodnik	s ɔ d n ìː k
<|SLV|>sol	s óː ʋ
<|SLV|>sonce	s óː n t͡s ɛ
<|SLV|>sončen	s óː n t͡ʃ ə n
<|SLV|>spem	s p ɛ́ː m
<|SLV|>spet	s p éː t
<|SLV|>spodaj	s p ɔ̀ː d a j
<|SLV|>spomin	s p ɔ m íː n
<|SLV|>sporočilo	s p ɔ r ɔ t͡ʃ ìː l ɔ
<|SLV|>spoznati	s p ɔ z n àː t i
<|SLV|>sprememba	s p r ɛ m éː m b a
<|SLV|>srce	s ə r t͡s éː
<|SLV|>srebro	s r ɛ b r óː
<|SLV|>sreda	s r éː d a
<|SLV|>središče	s r ɛ d ìː ʃ t͡ʃ ɛ
<|SLV|>srednjeveški	s r ɛ d n j ɛ ʋ éː ʃ k i
<|SLV|>srednji	s r éː d n j i
<|SLV|>sta	s t á
<|SLV|>stanje	s t àː n j ɛ
<|SLV|>star	s t á r
<|SLV|>starka	s t áː r k a
<|SLV|>stati	s t àː t i
<|SLV|>steklo	s t ɛ̀ː k l ɔ
<|SLV|>sto	s t óː
<|SLV|>stol	s t ɔ́ ʋ
<|SLV|>stolp	s t ɔ́ l p
<|SLV|>stopalo	s t ɔ p àː l ɔ
<|SLV|>stran	s t r áː n
<|SLV|>stranka	s t r áː n k a
<|SLV|>stroj	s t r ɔ́ j
<|SLV|>stvar	s t ʋ áː r
<|SLV|>sum	s úː m
<|SLV|>suša	s ùː ʃ a
<|SLV|>sva	s ʋ á
<|SLV|>svetloba	s ʋ ɛ t l ɔ̀ː b a
<|SLV|>ta	t áː
<|SLV|>tako	t a k óː
<|SLV|>takrat	t a k r á t
<|SLV|>tam	t á m
<|SLV|>tarča	t áː r t͡ʃ a
<|SLV|>teden	t éː d ə n
<|SLV|>tek	t éː k
<|SLV|>tekočina	t ɛ k ɔ t͡ʃ ìː n a
<|SLV|>telo	t ɛ l óː
<|SLV|>temperatura	t ɛ m p ɛ r a t úː r a
<|SLV|>tenis	t éː n i s
<|SLV|>teta	t ɛ̀ː t a
<|SLV|>tečaj	t ɛ t͡ʃ áː j
<|SLV|>teči	t ɛ̀ː t͡ʃ i
<|SLV|>težji	t éː ʒ j i
<|SLV|>ti	t íː
<|SLV|>tih	t íː x
<|SLV|>tip	t íː p
<|SLV|>tipka	t íː p k a
<|SLV|>tisoč	t íː s ɔ t͡ʃ
<|SLV|>tla	t l á
<|SLV|>tlak	t l áː k
<|SLV|>to	t óː
<|SLV|>tomaž	t ɔ m áː ʃ
<|SLV|>top	t ɔ́ p
<|SLV|>toplota	t ɔ p l ɔ̀ː t a
<|SLV|>torba	t óː r b a
<|SLV|>torek	t ɔ̀ː r ə k
<|SLV|>trava	t r àː ʋ a
<|SLV|>trebuh	t r èː b u x
<|SLV|>trener	t r ɛ n ɛ́ː r
<|SLV|>trenutek	t r ɛ n úː t ə k
<|SLV|>trg	t ə́ r k
<|SLV|>tri	t r íː
<|SLV|>trideset	t r íː d ɛ s ɛ t
<|SLV|>trije	t r íː j ɛ
<|SLV|>trikotnik	t r i k óː t n i k
<|SLV|>truplo	t r ùː p l ɔ
<|SLV|>tu	t ú
<|SLV|>tukaj	t úː k a j
<|SLV|>turizem	t u r ìː z ə m
<|SLV|>tvoj	t ʋ òː j
<|SLV|>uganka	u ɡ áː n k a
<|SLV|>ukaz	u k á s
<|SLV|>ulic	u l i t s
<|SLV|>ulica	ùː l i t͡s a
<|SLV|>ulici	u l i t͡s i
<|SLV|>univerza	u n i ʋ ɛ́ː r z a
<|SLV|>uporaba	u p ɔ r áː b a
<|SLV|>uporabnik	u p ɔ r áː b n i k
<|SLV|>uspeh	u s p ɛ́ x
<|SLV|>usta	ùː s t a
<|SLV|>ustava	u s t áː ʋ a
<|SLV|>ustrezen	u s t r èː z ə n
<|SLV|>učinek	u t͡ʃ íː n ə k
<|SLV|>učitelj	u t͡ʃ íː t ɛ l
<|SLV|>uživati	u ʒ ìː ʋ a t i
<|SLV|>vas	ʋ áː s
<|SLV|>vaš	ʋ á ʃ
<|SLV|>ve	ʋ éː
<|SLV|>veber	ʋ èː b ə r
<|SLV|>vedeti	ʋ èː d ɛ t i
<|SLV|>vedno	ʋ èː d n ɔ
<|SLV|>veja	ʋ ɛ́ː j a
<|SLV|>veleposlaništvo	ʋ ɛ́ l ɛ p ɔ s l àː n i ʃ t ʋ ɔ
<|SLV|>velik	ʋ ɛ̀ː l i k
<|SLV|>velikan	ʋ ɛ l i k áː n
<|SLV|>veliko	ʋ ɛ l ìː k ɔ
<|SLV|>vera	ʋ èː r a
<|SLV|>verjeti	ʋ ɛ r j èː t i
<|SLV|>vesel	ʋ ɛ s éː ʋ
<|SLV|>veselje	ʋ ɛ s ɛ̀ː l j ɛ
<|SLV|>vest	ʋ éː s t
<|SLV|>veter	ʋ éː t ə r
<|SLV|>več	ʋ ɛ́ t͡ʃ
<|SLV|>večer	ʋ ɛ t͡ʃ éː r
<|SLV|>večerja	ʋ ɛ t͡ʃ éː r j a
<|SLV|>večji	ʋ éː t͡ʃ j i
<|SLV|>vi	ʋ íː
<|SLV|>videti	ʋ ìː d ɛ t i
<|SLV|>vihar	ʋ i x áː r
<|SLV|>vijak	ʋ i j àː k
<|SLV|>vila	ʋ íː l a
<|SLV|>vir	ʋ íː r
<|SLV|>visok	ʋ i s ɔ́ k
<|SLV|>vitez	ʋ íː t ɛ s
<|SLV|>višji	ʋ íː ʃ j i
<|SLV|>vključiti	ʋ k l j ùː t͡ʃ i t i
<|SLV|>vlada	ʋ l áː d a
<|SLV|>voda	ʋ ɔ̀ː d a
<|SLV|>vodja	ʋ óː d j a
<|SLV|>vojak	ʋ ɔ j àː k
<|SLV|>vojska	ʋ ɔ̀ː j s k a
<|SLV|>volan	ʋ ɔ l áː n
<|SLV|>volja	ʋ òː l j a
<|SLV|>vosek	ʋ óː s ə k
<|SLV|>vožnja	ʋ ɔ̀ː ʒ n j a
<|SLV|>vprašanje	ʋ p r a ʃ áː n j ɛ
<|SLV|>vrat	ʋ r áː t
<|SLV|>vrednost	ʋ r èː d n ɔ s t
<|SLV|>vreme	ʋ r ɛ̀ː m ɛ
<|SLV|>vreči	ʋ r èː t͡ʃ i
<|SLV|>vrst	ʋ ə́ r s t
<|SLV|>vrsta	ʋ ə̀ r s t a
<|SLV|>vsebina	ʋ s ɛ b ìː n a
<|SLV|>vtis	ʋ t íː s
<|SLV|>včasih	ʋ t͡ʃ áː s i x
<|SLV|>včeraj	ʋ t͡ʃ èː r a j
<|SLV|>všeč	ʋ ʃ éː t͡ʃ
<|SLV|>za	z a
<|SLV|>zadnji	z áː d n j i
<|SLV|>zahod	z a x ɔ́ t
<|SLV|>zahteva	z a x t éː ʋ a
<|SLV|>zakon	z àː k ɔ n
<|SLV|>zalar	z áː l a r
<|SLV|>zaliv	z a l íː ʋ
<|SLV|>zaman	z a m á n
<|SLV|>zapor	z a p ɔ́ r
<|SLV|>zapreti	z a p r èː t i
<|SLV|>zaspati	z a s p àː t i
<|SLV|>začeti	z a t͡ʃ èː t i
<|SLV|>zbrati	z b r àː t i
<|SLV|>zdrav	z d r á ʋ
<|SLV|>zdravilo	z d r a ʋ ìː l ɔ
<|SLV|>zdravje	z d r áː ʋ j ɛ
<|SLV|>zdravnik	z d r a ʋ n ìː k
<|SLV|>zdravstvo	z d r áː ʋ s t ʋ ɔ
<|SLV|>zelo	z ɛ l óː
<|SLV|>zgodaj	z ɡ óː d a j
<|SLV|>zgodba	z ɡ óː d b a
<|SLV|>zgoraj	z ɡ ɔ̀ː r a j
<|SLV|>zima	z ìː m a
<|SLV|>zlato	z l a t óː
<|SLV|>zmaga	z m áː ɡ a
<|SLV|>zmagovalec	z m a ɡ ɔ ʋ áː l ə t͡s
<|SLV|>zmeraj	z m éː r a j
<|SLV|>znanje	z n áː n j ɛ
<|SLV|>znanost	z n àː n ɔ s t
<|SLV|>znotraj	z n òː t r a j
<|SLV|>zob	z óː p
<|SLV|>zobozdravnik	z ɔ b ɔ z d r a ʋ n ìː k
<|SLV|>zrak	z r á k
<|SLV|>zunaj	z ùː n a j
<|SLV|>zver	z ʋ éː r
<|SLV|>zverina	z ʋ ɛ r ìː n a
<|SLV|>zvezda	z ʋ èː z d a
<|SLV|>zvezek	z ʋ éː z ə k
<|SLV|>zvečer	z ʋ ɛ t͡ʃ éː r
<|SLV|>zvok	z ʋ óː k
<|SLV|>zvon	z ʋ óː n
<|SLV|>čaj	t͡ʃ áː j
<|SLV|>čakati	t͡ʃ àː k a t i
<|SLV|>čas	t͡ʃ á s
<|SLV|>časnik	t͡ʃ áː s n i k
<|SLV|>časopis	t͡ʃ a s ɔ p íː s
<|SLV|>čast	t͡ʃ áː s t
<|SLV|>čaša	t͡ʃ àː ʃ a
<|SLV|>če	t͡ʃ ɛ
<|SLV|>čefur	t͡ʃ ɛ f ùː r
<|SLV|>čembalo	t͡ʃ éː m b a l ɔ
<|SLV|>čeprav	t͡ʃ ɛ p r á ʋ
<|SLV|>četrtek	t͡ʃ ɛ t ə̀ r t ə k
<|SLV|>čevelj	t͡ʃ éː ʋ ə l
<|SLV|>čist	t͡ʃ íː s t
<|SLV|>član	t͡ʃ l áː n
<|SLV|>članek	t͡ʃ l áː n ə k
<|SLV|>človek	t͡ʃ l ɔ̀ː ʋ ɛ k
<|SLV|>človeški	t͡ʃ l ɔ ʋ èː ʃ k i
<|SLV|>črn	t͡ʃ ə̀ r n
<|SLV|>čustven	t͡ʃ úː s t ʋ ə n
<|SLV|>čuti	t͡ʃ ùː t i
<|SLV|>šest	ʃ éː s t
<|SLV|>šestdeset	ʃ éː z d d ɛ s ɛ t
<|SLV|>šola	ʃ óː l a
<|SLV|>španija	ʃ p àː n i j a
<|SLV|>število	ʃ t ɛ ʋ ìː l ɔ
<|SLV|>štiri	ʃ t ìː r i
<|SLV|>štirje	ʃ t ìː r j ɛ
<|SLV|>študent	ʃ t u d ɛ́ n t
<|SLV|>šved	ʃ ʋ éː t
<|SLV|>švedska	ʃ ʋ éː t s k a
<|SLV|>žalost	ʒ àː l ɔ s t
<|SLV|>žara	ʒ àː r a
<|SLV|>žena	ʒ ɛ̀ː n a
<|SLV|>žerjav	ʒ ɛ r j á ʋ
<|SLV|>živahen	ʒ i ʋ àː x ə n
<|SLV|>žival	ʒ i ʋ áː ʋ
<|SLV|>živeti	ʒ i ʋ èː t i
<|SLV|>življenje	ʒ i ʋ l j ɛ̀ː n j ɛ
<|SLV|>žvečiti	ʒ ʋ èː t͡ʃ i t i
