ئائىت	ʔ ɑ ʔ i t
ئابباس	ʔ ɑ b b ɑ s
ئابدال	ʔ ɑ b d ɑ l
ئابدۇلئەھەد	ʔ ɑ b d u l ʔ ɛ h ɛ t
ئابدۇللا	ʔ ɑ b d u l l ɑ
ئابلىز	ʔ ɑ b l i z
ئابنۇس	ʔ ɑ b n u s
ئات	ʔ ɑ t
ئاتا	ʔ ɑ t ɑ
ئاتلىقلار	ʔ ɑ t l i q l ɑ r
ئاتمىش	ʔ ɑ t m i ʃ
ئاجايىپ	ʔ ɑ d͡ʒ ɑ j i p
ئاخشام	ʔ ɑ χ ʃ ɑ m
ئاخىر	ʔ ɑ χ i r
ئاخىرەت	ʔ ɑ χ i r ɛ t
ئادالەت	ʔ ɑ d ɑ l ɛ t
ئادرىس	ʔ ɑ d r i s
ئادىل	ʔ ɑ d i l
ئادۋوكات	ʔ ɑ d w o k ɑ t
ئادەت	ʔ ɑ d ɛ t
ئادەم	ʔ ɑ d ɛ m
ئارزۇ	ʔ ɑ r z u
ئارسلان	ʔ ɑ r s l ɑ n
ئارغىماق	ʔ ɑ r ʁ i m ɑ q
ئارغۇن	ʔ ɑ r ʁ u n
ئارقا	ʔ ɑ r q ɑ
ئارماغان	ʔ ɑ r m ɑ ʁ ɑ n
ئارىسىدا	ʔ ɑ r i s i d ɑ
ئارىفمېتىكا	ʔ ɑ r i p m e t i k ɑ
ئارگون	ʔ ɑ r ɡ o n
ئاز	ʔ ɑ z
ئازاپ	ʔ ɑ z ɑ p
ئازوت	ʔ ɑ z o t
ئاسارەت	ʔ ɑ s ɑ r ɛ t
ئاساسەن	ʔ ɑ s ɑ s ɛ n
ئاسان	ʔ ɑ s ɑ n
ئاسايىش	ʔ ɑ s ɑ j i ʃ
ئاسفالت	ʔ ɑ s p ɑ l t
ئاسلان	ʔ ɑ s l ɑ n
ئاسماق	ʔ ɑ s m ɑ q
ئاسمان	ʔ ɑ s m ɑ n
ئاسى	ʔ ɑ s i
ئاسىيا	ʔ ɑ s i j ɑ
ئاش	ʔ ɑ ʃ
ئاشقازان	ʔ ɑ ʃ q ɑ z ɑ n
ئاشكارا	ʔ ɑ ʃ k ɑ r ɑ
ئاشىق	ʔ ɑ ʃ i q
ئاشيان	ʔ ɑ ʃ j ɑ n
ئاشپەز	ʔ ɑ ʃ p ɛ z
ئاغ	ʔ ɑ ʁ
ئاغرىتماق	ʔ ɑ ʁ r i t m ɑ q
ئاغرىق	ʔ ɑ ʁ r i q
ئاغىنە	ʔ ɑ ʁ i n ɛ
ئاق	ʔ ɑ q
ئاقرابا	ʔ ɑ q r ɑ b ɑ
ئاقراپ	ʔ ɑ q r ɑ p
ئاقساقال	ʔ ɑ q s ɑ q ɑ l
ئاققۇ	ʔ ɑ q q u
ئاقماق	ʔ ɑ q m ɑ q
ئاقىل	ʔ ɑ q i l
ئاقىۋەت	ʔ ɑ q i w ɛ t
ئاكا	ʔ ɑ k ɑ
ئاكتىنىي	ʔ ɑ k t i n i j
ئالا	ʔ ɑ l ɑ
ئالاقاغا	ʔ ɑ l ɑ q ɑ ʁ ɑ
ئالاقە	ʔ ɑ l ɑ q ɛ
ئالامەت	ʔ ɑ l ɑ m ɛ t
ئالاڭ	ʔ ɑ l ɑ ŋ
ئالتىنچى	ʔ ɑ l t i n t͡ʃ i
ئالتە	ʔ ɑ l t ɛ
ئالقىش	ʔ ɑ l q i ʃ
ئالما	ʔ ɑ l m ɑ
ئالماس	ʔ ɑ l m ɑ s
ئالىم	ʔ ɑ l i m
ئالىي	ʔ ɑ l i j
ئالىيجاناب	ʔ ɑ l i j d͡ʒ ɑ n ɑ p
ئاليۇمىن	ʔ ɑ l j u m i n
ئالپ	ʔ ɑ l p
ئالگېبرا	ʔ ɑ l ɡ e b r ɑ
ئالەت	ʔ ɑ l ɛ t
ئامال	ʔ ɑ m ɑ l
ئامانەت	ʔ ɑ m ɑ n ɛ t
ئامراق	ʔ ɑ m r ɑ q
ئامېرىتسىي	ʔ ɑ m e r i t s i j
ئانا	ʔ ɑ n ɑ
ئاناتومىيە	ʔ ɑ n ɑ t o m i j ɛ
ئانار	ʔ ɑ n ɑ r
ئانت	ʔ ɑ n t
ئاي	ʔ ɑ j
ئاياغلار	ʔ ɑ j ɑ ʁ l ɑ r
ئاياق	ʔ ɑ j ɑ q
ئاياقلار	ʔ ɑ j ɑ q l ɑ r
ئايال	ʔ ɑ j ɑ l
ئايران	ʔ ɑ j r ɑ n
ئايماق	ʔ ɑ j m ɑ q
ئاپارماق	ʔ ɑ p ɑ r m ɑ q
ئاپتوموبىل	ʔ ɑ p t o m o b i l
ئاپتونوم	ʔ ɑ p t o n o m
ئاپتوۋۇز	ʔ ɑ p t o w u z
ئاچ	ʔ ɑ t͡ʃ
ئاچقۇچ	ʔ ɑ t͡ʃ q u t͡ʃ
ئاچچىق	ʔ ɑ t͡ʃ t͡ʃ i q
ئاڭلىماق	ʔ ɑ ŋ l i m ɑ q
ئاھالە	ʔ ɑ h ɑ l ɛ
ئاھاڭ	ʔ ɑ h ɑ ŋ
ئاۋارە	ʔ ɑ w ɑ r ɛ
ئاۋغۇست	ʔ ɑ w ʁ u s t
ئاۋىئاتسىيە	ʔ ɑ w i ʔ ɑ t s i j ɛ
ئاۋۇچ	ʔ ɑ w u t͡ʃ
ئاۋۋال	ʔ ɑ w w ɑ l
ئوبلاست	ʔ o b l ɑ s t
ئوت	ʔ o t
ئوخشىماق	ʔ o χ ʃ i m ɑ q
ئورتاق	ʔ o r t ɑ q
ئورمان	ʔ o r m ɑ n
ئوغرى	ʔ o ʁ r i
ئوغۇز	ʔ o ʁ u z
ئوق	ʔ o q
ئوقۇتقۇچى	ʔ o q u t q u t͡ʃ i
ئوقۇماق	ʔ o q u m ɑ q
ئومۇم	ʔ o m u m
ئومۇمىيەت	ʔ o m u m i j ɛ t
ئومۇمەن	ʔ o m u m ɛ n
ئون	ʔ o n
ئونىنچى	ʔ o n i n t͡ʃ i
ئويۇن	ʔ o j u n
ئىبادەت	ʔ i b ɑ d ɛ t
ئىبارە	ʔ i b ɑ r ɛ
ئىبراھىم	ʔ i b r ɑ h i m
ئىبلىس	ʔ i b l i s
ئىت	ʔ i t
ئىتترىي	ʔ i t t r i j
ئىتتىپاقداش	ʔ i t t i p ɑ q d ɑ ʃ
ئىتتېربىي	ʔ i t t e r b i j
ئىجات	ʔ i d͡ʒ ɑ t
ئىجازەت	ʔ i d͡ʒ ɑ z ɛ t
ئىجتىمائىي	ʔ i d͡ʒ t i m ɑ ʔ i j
ئىجتىمائىيەت	ʔ i d͡ʒ t i m ɑ ʔ i j ɛ t
ئىختىيارىي	ʔ i χ t i j ɑ r i j
ئىددەت	ʔ i d d ɛ t
ئىدراك	ʔ i d r ɑ k
ئىرادە	ʔ i r ɑ d ɛ
ئىرانلىق	ʔ i r ɑ n l i q
ئىرق	ʔ i r q
ئىرقىي	ʔ i r q i j
ئىرىدىي	ʔ i r i d i j
ئىزاھ	ʔ i z ɑ h
ئىزاھات	ʔ i z ɑ h ɑ t
ئىززەت	ʔ i z z ɛ t
ئىس	ʔ i s
ئىستىراھەت	ʔ i s t i r ɑ h ɛ t
ئىستىقبال	ʔ i s t i q b ɑ l
ئىستىقلال	ʔ i s t i q l ɑ l
ئىستىقلالىيەت	ʔ i s t i q l ɑ l i j ɛ t
ئىستىلا	ʔ i s t i l ɑ
ئىستېلا	ʔ i s t e l ɑ
ئىستەك	ʔ i s t ɛ k
ئىسراپ	ʔ i s r ɑ p
ئىسلام	ʔ i s l ɑ m
ئىسلاند	ʔ i s l ɑ n t
ئىسلاھ	ʔ i s l ɑ h
ئىسلاھات	ʔ i s l ɑ h ɑ t
ئىسيان	ʔ i s j ɑ n
ئىسيانچى	ʔ i s j ɑ n t͡ʃ i
ئىسپات	ʔ i s p ɑ t
ئىشارەت	ʔ i ʃ ɑ r ɛ t
ئىشتىراك	ʔ i ʃ t i r ɑ k
ئىشتىياق	ʔ i ʃ t i j ɑ q
ئىشتىھا	ʔ i ʃ t i h ɑ
ئىشق	ʔ i ʃ q
ئىشلەتكۈچى	ʔ i ʃ l ɛ t k y t͡ʃ i
ئىشىتمەك	ʔ i ʃ i t m ɛ k
ئىشچى	ʔ i ʃ t͡ʃ i
ئىقبال	ʔ i q b ɑ l
ئىقتىدار	ʔ i q t i d ɑ r
ئىقتىسات	ʔ i q t i s ɑ t
ئىقتىساد	ʔ i q t i s ɑ t
ئىقرار	ʔ i q r ɑ r
ئىكرام	ʔ i k r ɑ m
ئىككى	ʔ i k k i
ئىككىنچى	ʔ i k k i n t͡ʃ i
ئىلاج	ʔ i l ɑ d͡ʒ
ئىلاھ	ʔ i l ɑ h
ئىلاھىيەت	ʔ i l ɑ h i j ɛ t
ئىلتىماس	ʔ i l t i m ɑ s
ئىلتىپات	ʔ i l t i p ɑ t
ئىلمىي	ʔ i l m i j
ئىلىم	ʔ i l i m
ئىلھام	ʔ i l h ɑ m
ئىم	ʔ i m
ئىمارەت	ʔ i m ɑ r ɛ t
ئىمامەت	ʔ i m ɑ m ɛ t
ئىمزا	ʔ i m z ɑ
ئىمكانىيەت	ʔ i m k ɑ n i j ɛ t
ئىن	ʔ i n
ئىناۋەت	ʔ i n ɑ w ɛ t
ئىنتىزام	ʔ i n t i z ɑ m
ئىنتىقام	ʔ i n t i q ɑ m
ئىنجىل	ʔ i n d͡ʒ i l
ئىندىي	ʔ i n d i j
ئىنسانىيەت	ʔ i n s ɑ n i j ɛ t
ئىنساپ	ʔ i n s ɑ p
ئىنكار	ʔ i n k ɑ r
ئىنى	ʔ i n i
ئىيۇل	ʔ i j u l
ئىپادە	ʔ i p ɑ d ɛ
ئىپتار	ʔ i p t ɑ r
ئىپتىخار	ʔ i p t i χ ɑ r
ئىپتىدا	ʔ i p t i d ɑ
ئىپتىدائىي	ʔ i p t i d ɑ ʔ i j
ئىڭەك	ʔ i ŋ ɛ k
ئۆت	ʔ ø t
ئۆز	ʔ ø z
ئۆزبېك	ʔ ø z b e k
ئۆشكە	ʔ ø ʃ k ɛ
ئۆكتەبر	ʔ ø k t ɛ b r
ئۆكۈز	ʔ ø k y z
ئۆلمەك	ʔ ø l m ɛ k
ئۆلۈم	ʔ ø l y m
ئۆي	ʔ ø j
ئۆيلەر	ʔ ø j l ɛ r
ئۆپكە	ʔ ø p k ɛ
ئۆچكە	ʔ ø t͡ʃ k ɛ
ئۆگەي	ʔ ø ɡ ɛ j
ئۇجرەت	ʔ u d͡ʒ r ɛ t
ئۇد	ʔ u t
ئۇرماق	ʔ u r m ɑ q
ئۇرپ	ʔ u r p
ئۇرۇق	ʔ u r u q
ئۇزۇن	ʔ u z u n
ئۇستا	ʔ u s t ɑ
ئۇستات	ʔ u s t ɑ t
ئۇستاز	ʔ u s t ɑ z
ئۇستۇرا	ʔ u s t u r ɑ
ئۇسلۇپ	ʔ u s l u p
ئۇسۇل	ʔ u s u l
ئۇل	ʔ u l
ئۇلار	ʔ u l ɑ r
ئۇلۇغ	ʔ u l u ʁ
ئۇمۇرتقا	ʔ u m u r t q ɑ
ئۇن	ʔ u n
ئۇنسۇر	ʔ u n s u r
ئۇنناپ	ʔ u n n ɑ p
ئۇنى	ʔ u n i
ئۇنىڭغا	ʔ u n i ŋ ʁ ɑ
ئۇنىۋېرسىتېت	ʔ u n i w e r s i t e t
ئۇنىۋېرسىتېتى	ʔ u n i w e r s i t e t i
ئۇنۋان	ʔ u n w ɑ n
ئۇيات	ʔ u j ɑ t
ئۇيغۇر	ʔ u j ʁ u r
ئۇيغۇرلار	ʔ u j ʁ u r l ɑ r
ئۇپۇق	ʔ u p u q
ئۇۋا	ʔ u w ɑ
ئۇۋاق	ʔ u w ɑ q
ئۈزەڭگە	ʔ y z ɛ ŋ ɡ ɛ
ئۈلپەت	ʔ y l p ɛ t
ئۈچىنچى	ʔ y t͡ʃ i n t͡ʃ i
ئېتىبارەن	ʔ e t i b ɑ r ɛ n
ئېتىراز	ʔ e t i r ɑ z
ئېتىقات	ʔ e t i q ɑ t
ئېتىقاد	ʔ e t i q ɑ t
ئېتىكاپ	ʔ e t i k ɑ p
ئېتىماد	ʔ e t i m ɑ t
ئېتىۋار	ʔ e t i w ɑ r
ئېرا	ʔ e r ɑ
ئېرىق	ʔ e r i q
ئېسىل	ʔ e s i l
ئېغىر	ʔ e ʁ i r
ئېغىرلىق	ʔ e ʁ i r l i q
ئېغىز	ʔ e ʁ i z
ئېغىل	ʔ e ʁ i l
ئېكران	ʔ e k r ɑ n
ئېكىن	ʔ e k i n
ئېكۋاتور	ʔ e k w ɑ t o r
ئېلان	ʔ e l ɑ n
ئېلىپ	ʔ e l i p
ئېلىپبە	ʔ e l i p b ɛ
ئېلېمېنت	ʔ e l e m e n t
ئېنقىلاب	ʔ e n q i l ɑ p
ئېنېرگىيە	ʔ e n e r ɡ i j ɛ
ئېينشتېينىي	ʔ e j n ʃ t e j n i j
ئېپىك	ʔ e p i k
ئېھاتە	ʔ e h ɑ t ɛ
ئېھتىرام	ʔ e h t i r ɑ m
ئېھتىلام	ʔ e h t i l ɑ m
ئېھتىمال	ʔ e h t i m ɑ l
ئېھتىيات	ʔ e h t i j ɑ t
ئېھسان	ʔ e h s ɑ n
ئەبلەھ	ʔ ɛ b l ɛ h
ئەبەت	ʔ ɛ b ɛ t
ئەبەد	ʔ ɛ b ɛ t
ئەبەدىي	ʔ ɛ b ɛ d i j
ئەتتارىد	ʔ ɛ t t ɑ r i t
ئەتراپ	ʔ ɛ t r ɑ p
ئەتلەس	ʔ ɛ t l ɛ s
ئەتىۋار	ʔ ɛ t i w ɑ r
ئەجدات	ʔ ɛ d͡ʒ d ɑ t
ئەجنەبى	ʔ ɛ d͡ʒ n ɛ b i
ئەجەب	ʔ ɛ d͡ʒ ɛ p
ئەجەل	ʔ ɛ d͡ʒ ɛ l
ئەخلاقىي	ʔ ɛ χ l ɑ q i j
ئەخلەت	ʔ ɛ χ l ɛ t
ئەخمەق	ʔ ɛ χ m ɛ q
ئەدىب	ʔ ɛ d i p
ئەدىيال	ʔ ɛ d i j ɑ l
ئەدەبىي	ʔ ɛ d ɛ b i j
ئەر	ʔ ɛ r
ئەردەم	ʔ ɛ r d ɛ m
ئەرش	ʔ ɛ r ʃ
ئەرپە	ʔ ɛ r p ɛ
ئەرۋاھ	ʔ ɛ r w ɑ h
ئەرەبچە	ʔ ɛ r ɛ b t͡ʃ ɛ
ئەزا	ʔ ɛ z ɑ
ئەزان	ʔ ɛ z ɑ n
ئەزىز	ʔ ɛ z i z
ئەستەر	ʔ ɛ s t ɛ r
ئەسرار	ʔ ɛ s r ɑ r
ئەسكى	ʔ ɛ s k i
ئەسكەر	ʔ ɛ s k ɛ r
ئەسل	ʔ ɛ s l
ئەسلى	ʔ ɛ s l i
ئەسىر	ʔ ɛ s i r
ئەسۋاپ	ʔ ɛ s w ɑ p
ئەسەبى	ʔ ɛ s ɛ b i
ئەسەپ	ʔ ɛ s ɛ p
ئەقلىي	ʔ ɛ q l i j
ئەقىدە	ʔ ɛ q i d ɛ
ئەكەلمەك	ʔ ɛ k ɛ l m ɛ k
ئەللىك	ʔ ɛ l l i k
ئەلچى	ʔ ɛ l t͡ʃ i
ئەلگەك	ʔ ɛ l ɡ ɛ k
ئەلۋەتتە	ʔ ɛ l w ɛ t t ɛ
ئەلەم	ʔ ɛ l ɛ m
ئەمما	ʔ ɛ m m ɑ
ئەمەل	ʔ ɛ m ɛ l
ئەمەلىيەت	ʔ ɛ m ɛ l i j ɛ t
ئەنجۈر	ʔ ɛ n d͡ʒ y r
ئەندىشە	ʔ ɛ n d i ʃ ɛ
ئەيب	ʔ ɛ j p
ئەينەن	ʔ ɛ j n ɛ n
ئەپسانىۋىي	ʔ ɛ p s ɑ n i w i j
ئەپسانە	ʔ ɛ p s ɑ n ɛ
ئەپۇ	ʔ ɛ p u
ئەپەندى	ʔ ɛ p ɛ n d i
ئەڭ	ʔ ɛ ŋ
ئەگرى	ʔ ɛ ɡ r i
ئەگەر	ʔ ɛ ɡ ɛ r
ئەھد	ʔ ɛ h t
ئەھمىيەت	ʔ ɛ h m i j ɛ t
ئەھمەد	ʔ ɛ h m ɛ t
ئەھەد	ʔ ɛ h ɛ t
ئەۋۋەلەن	ʔ ɛ w w ɛ l ɛ n
باتراق	b ɑ t r ɑ q
باتىل	b ɑ t i l
باتۇر	b ɑ t u r
باج	b ɑ d͡ʒ
بار	b ɑ r
بارماق	b ɑ r m ɑ q
بارىي	b ɑ r i j
باشاق	b ɑ ʃ ɑ q
باققال	b ɑ q q ɑ l
باقماق	b ɑ q m ɑ q
باقى	b ɑ q i
باقىي	b ɑ q i j
بالا	b ɑ l ɑ
بالكون	b ɑ l k o n
بانان	b ɑ n ɑ n
باي	b ɑ j
بايانات	b ɑ j ɑ n ɑ t
بايراق	b ɑ j r ɑ q
بايرام	b ɑ j r ɑ m
بايقۇش	b ɑ j q u ʃ
باپ	b ɑ p
باھا	b ɑ h ɑ
بروم	b r o m
بوخچا	b o χ t͡ʃ ɑ
بورچ	b o r t͡ʃ
بوستان	b o s t ɑ n
بوشلۇق	b o ʃ l u q
بولكا	b o l k ɑ
بومبا	b o m b ɑ
بويۇن	b o j u n
بىتون	b i t o n
بىر	b i r
بىرىليانت	b i r i l j ɑ n t
بىرىنچى	b i r i n t͡ʃ i
بىسمۇت	b i s m u t
بىلەن	b i l ɛ n
بۆرەك	b ø r ɛ k
بۆشۈك	b ø ʃ y k
بۆك	b ø k
بۆھتان	b ø h t ɑ n
بۆھران	b ø h r ɑ n
بۇت	b u t
بۇدجېت	b u d d͡ʒ e t
بۇرژۇئا	b u r ʒ u ʔ ɑ
بۇرژۇئازىيە	b u r ʒ u ʔ ɑ z i j ɛ
بۇرۇت	b u r u t
بۇرۇن	b u r u n
بۇغ	b u ʁ
بۇقا	b u q ɑ
بۇلاق	b u l ɑ q
بۇلبۇل	b u l b u l
بۇلجۇڭ	b u l d͡ʒ u ŋ
بۇلغارىيە	b u l ʁ ɑ r i j ɛ
بۇلۇت	b u l u t
بۇيرۇتماق	b u j r u t m ɑ q
بۇيرۇق	b u j r u q
بۈيۈك	b y j y k
بېخىل	b e χ i l
بېركلىي	b e r k l i j
بېرىللىي	b e r i l l i j
بېشارەت	b e ʃ ɑ r ɛ t
بېغىر	b e ʁ i r
بېقىندىلىق	b e q i n d i l i q
بېلوك	b e l o k
بېلىق	b e l i q
بېلەت	b e l ɛ t
بېنزىن	b e n z i n
بېيىت	b e j i t
بېگېموت	b e ɡ e m o t
بەدەۋى	b ɛ d ɛ w i
بەركە	b ɛ r k ɛ
بەرمەك	b ɛ r m ɛ k
بەز	b ɛ z
بەسەي	b ɛ s ɛ j
بەش	b ɛ ʃ
بەشىنچى	b ɛ ʃ i n t͡ʃ i
بەك	b ɛ k
بەل	b ɛ l
بەلغەم	b ɛ l ʁ ɛ m
بەلكى	b ɛ l k i
بەنزە	b ɛ n z ɛ
بەنسىيۇەن	b ɛ n s i j u ɛ n
بەياز	b ɛ j ɑ z
بەگ	b ɛ k
تائام	t ɑ ʔ ɑ m
تاتار	t ɑ t ɑ r
تاج	t ɑ d͡ʒ
تاجاۋۇز	t ɑ d͡ʒ ɑ w u z
تاختا	t ɑ χ t ɑ
تار	t ɑ r
تاراۋى	t ɑ r ɑ w i
تارتماق	t ɑ r t m ɑ q
تارىخىي	t ɑ r i χ i j
تاسادىپىي	t ɑ s ɑ d i p i j
تاسادىپەن	t ɑ s ɑ d i p ɛ n
تاش	t ɑ ʃ
تاشماق	t ɑ ʃ m ɑ q
تاغ	t ɑ ʁ
تاكتىكا	t ɑ k t i k ɑ
تاكسى	t ɑ k s i
تالاق	t ɑ l ɑ q
تاللىي	t ɑ l l i j
تالىپ	t ɑ l i p
تامغا	t ɑ m ʁ ɑ
تاملار	t ɑ m l ɑ r
تانتال	t ɑ n t ɑ l
تانكا	t ɑ n k ɑ
تاي	t ɑ j
تاپشۇرماق	t ɑ p ʃ u r m ɑ q
تاڭ	t ɑ ŋ
تاھارەت	t ɑ h ɑ r ɛ t
تاھىر	t ɑ h i r
تاۋا	t ɑ w ɑ
تاۋار	t ɑ w ɑ r
تاۋۇت	t ɑ w u t
تاۋۇز	t ɑ w u z
ترامپ	t r ɑ m p
توخۇ	t o χ u
تورىي	t o r i j
تورۇق	t o r u q
توز	t o z
توسۇن	t o s u n
توشقان	t o ʃ q ɑ n
توق	t o q
توققۇز	t o q q u z
توققۇزىنچى	t o q q u z i n t͡ʃ i
توقۇنماق	t o q u n m ɑ q
تومۇر	t o m u r
توپ	t o p
توپلىماق	t o p l i m ɑ q
توپچى	t o p t͡ʃ i
توپۇق	t o p u q
توڭگۇز	t o ŋ ɡ u z
توۋا	t o w ɑ
تىبابەت	t i b ɑ b ɛ t
تىتان	t i t ɑ n
تىجارىي	t i d͡ʒ ɑ r i j
تىجارەت	t i d͡ʒ ɑ r ɛ t
تىرىك	t i r i k
تىرەك	t i r ɛ k
تىزگىن	t i z ɡ i n
تىكەن	t i k ɛ n
تىل	t i l
تىلاۋەت	t i l ɑ w ɛ t
تىلسىم	t i l s i m
تىللار	t i l l ɑ r
تىمساخ	t i m s ɑ χ
تىيىن	t i j i n
تۆت	t ø t
تۆتىنچى	t ø t i n t͡ʃ i
تۆپە	t ø p ɛ
تۆگە	t ø ɡ ɛ
تۆھمەت	t ø h m ɛ t
تۇتماق	t u t m ɑ q
تۇخۇم	t u χ u m
تۇرنا	t u r n ɑ
تۇرپان	t u r p ɑ n
تۇرۇپ	t u r u p
تۇزاق	t u z ɑ q
تۇمان	t u m ɑ n
تۇياق	t u j ɑ q
تۇچ	t u t͡ʃ
تۈتۈن	t y t y n
تۈر	t y r
تۈرداش	t y r d ɑ ʃ
تۈركىي	t y r k i j
تۈك	t y k
تۈلكە	t y l k ɛ
تۈگمە	t y ɡ m ɛ
تېتىك	t e t i k
تېربىي	t e r b i j
تېز	t e z
تېكە	t e k ɛ
تېللۇر	t e l l u r
تېلېسكوپ	t e l e s k o p
تېۋىپ	t e w i p
تەبرىك	t ɛ b r i k
تەبلىغ	t ɛ b l i ʁ
تەبىر	t ɛ b i r
تەبىقە	t ɛ b i q ɛ
تەبىي	t ɛ b i j
تەبىەت	t ɛ b i ɛ t
تەبەسسۈم	t ɛ b ɛ s s y m
تەتبىق	t ɛ t b i q
تەتقىق	t ɛ t q i q
تەتىل	t ɛ t i l
تەجرىبىخانا	t ɛ d͡ʒ r i b i χ ɑ n ɑ
تەجرىبە	t ɛ d͡ʒ r i b ɛ
تەجەللى	t ɛ d͡ʒ ɛ l l i
تەخسە	t ɛ χ s ɛ
تەخمىن	t ɛ χ m i n
تەخەللۇس	t ɛ χ ɛ l l u s
تەدرىج	t ɛ d r i d͡ʒ
تەدرىجىي	t ɛ d r i d͡ʒ i j
تەر	t ɛ r
تەربىيىۋى	t ɛ r b i j i w i
تەربىيە	t ɛ r b i j ɛ
تەرجىمە	t ɛ r d͡ʒ i m ɛ
تەرز	t ɛ r z
تەرغىبات	t ɛ r ʁ i b ɑ t
تەرغىپ	t ɛ r ʁ i p
تەرك	t ɛ r k
تەرىپ	t ɛ r i p
تەرەددۇت	t ɛ r ɛ d d u t
تەزكىرە	t ɛ z k i r ɛ
تەزىيە	t ɛ z i j ɛ
تەس	t ɛ s
تەستىق	t ɛ s t i q
تەسكىن	t ɛ s k i n
تەسىر	t ɛ s i r
تەسىس	t ɛ s i s
تەسۋى	t ɛ s w i
تەسۋىر	t ɛ s w i r
تەسەللى	t ɛ s ɛ l l i
تەسەۋۋۇر	t ɛ s ɛ w w u r
تەسەۋۋۇپ	t ɛ s ɛ w w u p
تەشرىپ	t ɛ ʃ r i p
تەشكىل	t ɛ ʃ k i l
تەشۋىش	t ɛ ʃ w i ʃ
تەشۋىقات	t ɛ ʃ w i q ɑ t
تەشەببۇس	t ɛ ʃ ɛ b b u s
تەشەككۈر	t ɛ ʃ ɛ k k y r
تەقدىر	t ɛ q d i r
تەقدىم	t ɛ q d i m
تەقرىبەن	t ɛ q r i b ɛ n
تەقسىم	t ɛ q s i m
تەقلىت	t ɛ q l i t
تەقىپ	t ɛ q i p
تەكبىر	t ɛ k b i r
تەكرار	t ɛ k r ɑ r
تەكشۈرۈش	t ɛ k ʃ y r y ʃ
تەكلىپ	t ɛ k l i p
تەكىت	t ɛ k i t
تەكەببۇر	t ɛ k ɛ b b u r
تەكەللۇپ	t ɛ k ɛ l l u p
تەلىم	t ɛ l i m
تەلۋە	t ɛ l w ɛ
تەلەپ	t ɛ l ɛ p
تەلەپپۇز	t ɛ l ɛ p p u z
تەمبۈر	t ɛ m b y r
تەمسىل	t ɛ m s i l
تەمىر	t ɛ m i r
تەمىنات	t ɛ m i n ɑ t
تەنبىھ	t ɛ n b i h
تەنبەل	t ɛ n b ɛ l
تەنقىت	t ɛ n q i t
تەنھا	t ɛ n h ɑ
تەنەززۇل	t ɛ n ɛ z z u l
تەپتىش	t ɛ p t i ʃ
تەپرىقە	t ɛ p r i q ɛ
تەپسىر	t ɛ p s i r
تەپسىلات	t ɛ p s i l ɑ t
تەپسىلىي	t ɛ p s i l i j
تەپەككۇر	t ɛ p ɛ k k u r
تەڭ	t ɛ ŋ
تەگمەك	t ɛ ɡ m ɛ k
تەھدىت	t ɛ h d i t
تەھرىر	t ɛ h r i r
تەھسىل	t ɛ h s i l
تەھسىن	t ɛ h s i n
تەھقىر	t ɛ h q i r
تەھقىق	t ɛ h q i q
تەھلىكە	t ɛ h l i k ɛ
تەھلىل	t ɛ h l i l
تەۋرات	t ɛ w r ɑ t
تەۋەججۇ	t ɛ w ɛ d͡ʒ d͡ʒ u
تەۋەززۇ	t ɛ w ɛ z z u
تەۋەككۈل	t ɛ w ɛ k k y l
تەۋەللۇت	t ɛ w ɛ l l u t
جائىز	d͡ʒ ɑ ʔ i z
جادۇ	d͡ʒ ɑ d u
جادۇگەر	d͡ʒ ɑ d u ɡ ɛ r
جازا	d͡ʒ ɑ z ɑ
جاسارەت	d͡ʒ ɑ s ɑ r ɛ t
جاسۇس	d͡ʒ ɑ s u s
جامائەت	d͡ʒ ɑ m ɑ ʔ ɛ t
جامال	d͡ʒ ɑ m ɑ l
جامى	d͡ʒ ɑ m i
جانان	d͡ʒ ɑ n ɑ n
جانسىز	d͡ʒ ɑ n s i z
جانلىق	d͡ʒ ɑ n l i q
جاڭيۇ	d͡ʒ ɑ ŋ j u
جاھاز	d͡ʒ ɑ h ɑ z
جاھالەت	d͡ʒ ɑ h ɑ l ɛ t
جاھان	d͡ʒ ɑ h ɑ n
جاھىل	d͡ʒ ɑ h i l
جاۋاپ	d͡ʒ ɑ w ɑ p
جوزا	d͡ʒ o z ɑ
جىددىي	d͡ʒ i d d i j
جىن	d͡ʒ i n
جىنازا	d͡ʒ i n ɑ z ɑ
جىنايەت	d͡ʒ i n ɑ j ɛ t
جىنايەتچى	d͡ʒ i n ɑ j ɛ t t͡ʃ i
جىنس	d͡ʒ i n s
جىگەر	d͡ʒ i ɡ ɛ r
جۇدا	d͡ʒ u d ɑ
جۇڭگو	d͡ʒ u ŋ ɡ o
جۈمە	d͡ʒ y m ɛ
جەدۋەل	d͡ʒ ɛ d w ɛ l
جەرەن	d͡ʒ ɛ r ɛ n
جەزىبە	d͡ʒ ɛ z i b ɛ
جەسەت	d͡ʒ ɛ s ɛ t
جەڭچى	d͡ʒ ɛ ŋ t͡ʃ i
جەھەت	d͡ʒ ɛ h ɛ t
جەۋھەر	d͡ʒ ɛ w h ɛ r
خائىن	χ ɑ ʔ i n
خاتىمە	χ ɑ t i m ɛ
خادىمە	χ ɑ d i m ɛ
خاسىيەت	χ ɑ s i j ɛ t
خاۋاتىر	χ ɑ w ɑ t i r
خوتەن	χ o t ɛ n
خوراز	χ o r ɑ z
خىت	χ i t
خىتاب	χ i t ɑ p
خىزمەتچى	χ i z m ɛ t t͡ʃ i
خىل	χ i l
خىيال	χ i j ɑ l
خىيانەت	χ i j ɑ n ɛ t
خۇتبە	χ u t b ɛ
خۇراپىي	χ u r ɑ p i j
خۇسۇس	χ u s u s
خۇسۇسىي	χ u s u s i j
خۇسۇسىيەت	χ u s u s i j ɛ t
خۇسۇسەن	χ u s u s ɛ n
خۇلاسە	χ u l ɑ s ɛ
خېمىر	χ e m i r
خېچىر	χ e t͡ʃ i r
خەتتات	χ ɛ t t ɑ t
خەتمە	χ ɛ t m ɛ
خەتىپ	χ ɛ t i p
خەتەر	χ ɛ t ɛ r
خەرىتە	χ ɛ r i t ɛ
خەزىنە	χ ɛ z i n ɛ
خەنزۇ	χ ɛ n z u
خەير	χ ɛ j r
دائىرە	d ɑ ʔ i r ɛ
دائىمى	d ɑ ʔ i m i
دادا	d ɑ d ɑ
دارۋاز	d ɑ r w ɑ z
داستان	d ɑ s t ɑ n
دالالەت	d ɑ l ɑ l ɛ t
داۋام	d ɑ w ɑ m
داۋۇت	d ɑ w u t
دوستانە	d o s t ɑ n ɛ
دومبىرا	d o m b i r ɑ
دىابېت	d i ɑ b e t
دىسپروزىي	d i s p r o z i j
دىققەت	d i q q ɛ t
دىماغ	d i m ɑ ʁ
دىماق	d i m ɑ q
دىن	d i n
دىيار	d i j ɑ r
دىۋان	d i w ɑ n
دۇتتار	d u t t ɑ r
دۇربۇن	d u r b u n
دۇش	d u ʃ
دۇنيا	d u n j ɑ
دۇنياۋى	d u n j ɑ w i
دۈدۈك	d y d y k
دۈشمەن	d y ʃ m ɛ n
دۈشەنبە	d y ʃ ɛ n b ɛ
دېكابر	d e k ɑ b r
دېموكراتىيە	d e m o k r ɑ t i j ɛ
دېمەك	d e m ɛ k
دېڭىز	d e ŋ i z
دەججال	d ɛ d͡ʒ d͡ʒ ɑ l
دەرۋازا	d ɛ r w ɑ z ɑ
دەستە	d ɛ s t ɛ
دەلىل	d ɛ l i l
دەپئە	d ɛ p ʔ ɛ
دەپئەتەن	d ɛ p ʔ ɛ t ɛ n
دەپتەر	d ɛ p t ɛ r
دەھشەت	d ɛ h ʃ ɛ t
دەھلىز	d ɛ h l i z
دەۋا	d ɛ w ɑ
دەۋران	d ɛ w r ɑ n
دەۋرىي	d ɛ w r i j
دەۋەت	d ɛ w ɛ t
راھەت	r ɑ h ɛ t
روبرۇ	r o b r u
روھ	r o h
روھىي	r o h i j
رىئايە	r i ʔ ɑ j ɛ
رىزالەت	r i z ɑ l ɛ t
رىشات	r i ʃ ɑ t
رىغبەت	r i ʁ b ɛ t
رىيا	r i j ɑ
رىۋايەت	r i w ɑ j ɛ t
رۇبائىي	r u b ɑ ʔ i j
رۇبائىيات	r u b ɑ ʔ i j ɑ t
رۇسىيە	r u s i j ɛ
رېفېراندۇم	r e p e r ɑ n d u m
رەئىشە	r ɛ ʔ i ʃ ɛ
رەئىيەت	r ɛ ʔ i j ɛ t
رەسسام	r ɛ s s ɑ m
رەسمىيەت	r ɛ s m i j ɛ t
رەھمەت	r ɛ h m ɛ t
زالالەت	z ɑ l ɑ l ɛ t
زامىن	z ɑ m i n
زاپاس	z ɑ p ɑ s
زاھىر	z ɑ h i r
زاھىرەن	z ɑ h i r ɛ n
زوق	z o q
زىت	z i t
زىددىيەت	z i d d i j ɛ t
زىرە	z i r ɛ
زىكىر	z i k i r
زىيارەت	z i j ɑ r ɛ t
زىياپەت	z i j ɑ p ɛ t
زۇلۇم	z u l u m
زۇمرەت	z u m r ɛ t
زېھنىي	z e h n i j
زەئىپ	z ɛ ʔ i p
زەبۇر	z ɛ b u r
زەربە	z ɛ r b ɛ
زەررە	z ɛ r r ɛ
زەرەر	z ɛ r ɛ r
زەمبىرەك	z ɛ m b i r ɛ k
زەنجىر	z ɛ n d͡ʒ i r
زەنجىۋىل	z ɛ n d͡ʒ i w i l
سائادەت	s ɑ ʔ ɑ d ɛ t
سائەت	s ɑ ʔ ɛ t
سابىق	s ɑ b i q
ساخاۋەت	s ɑ χ ɑ w ɛ t
ساداق	s ɑ d ɑ q
ساداقەت	s ɑ d ɑ q ɛ t
سارراپ	s ɑ r r ɑ p
ساق	s ɑ q
ساقاق	s ɑ q ɑ q
ساقچى	s ɑ q t͡ʃ i
سال	s ɑ l
سالاھىيەت	s ɑ l ɑ h i j ɛ t
ساما	s ɑ m ɑ
سامان	s ɑ m ɑ n
سامسا	s ɑ m s ɑ
سانائەت	s ɑ n ɑ ʔ ɛ t
ساناق	s ɑ n ɑ q
ساناقسىز	s ɑ n ɑ q s i z
ساناقلىق	s ɑ n ɑ q l i q
سايە	s ɑ j ɛ
ساپ	s ɑ p
ساپان	s ɑ p ɑ n
ساۋاقداش	s ɑ w ɑ q d ɑ ʃ
ساۋاپ	s ɑ w ɑ p
سوئال	s o ʔ ɑ l
سوراق	s o r ɑ q
سىرەك	s i r ɛ k
سىنك	s i n k
سىنىپ	s i n i p
سىنىپداش	s i n i p d ɑ ʃ
سىياسى	s i j ɑ s i
سىياسەت	s i j ɑ s ɛ t
سىڭىر	s i ŋ i r
سىڭىل	s i ŋ i l
سۆز	s ø z
سۆيمەك	s ø j m ɛ k
سۆگەت	s ø ɡ ɛ t
سۆھبەت	s ø h b ɛ t
سۇ	s u
سۇيىئىستېمال	s u j i ʔ i s t e m ɑ l
سۈت	s y t
سۈرەت	s y r ɛ t
سۈلھ	s y l h
سۈمۈرمەك	s y m y r m ɛ k
سۈيدۈك	s y j d y k
سۈپۈرگە	s y p y r ɡ ɛ
سېغىزخان	s e ʁ i z χ ɑ n
سېلىشتۇرماق	s e l i ʃ t u r m ɑ q
سېمىز	s e m i z
سېنتەبر	s e n t ɛ b r
سېھرىي	s e h r i j
سېھىر	s e h i r
سېھىرگەر	s e h i r ɡ ɛ r
سېۋەت	s e w ɛ t
سەكسەن	s ɛ k s ɛ n
سەكسەنپۇت	s ɛ k s ɛ n p u t
سەمەرقەند	s ɛ m ɛ r q ɛ n t
سەنئەت	s ɛ n ʔ ɛ t
سەنئەتكار	s ɛ n ʔ ɛ t k ɑ r
سەي	s ɛ j
سەيشەنبە	s ɛ j ʃ ɛ n b ɛ
سەپەر	s ɛ p ɛ r
سەھىيە	s ɛ h i j ɛ
سەھەر	s ɛ h ɛ r
سەۋر	s ɛ w r
شارائىت	ʃ ɑ r ɑ ʔ i t
شاراب	ʃ ɑ r ɑ p
شام	ʃ ɑ m
شامان	ʃ ɑ m ɑ n
شاپائەت	ʃ ɑ p ɑ ʔ ɛ t
شاپتۇل	ʃ ɑ p t u l
شاھ	ʃ ɑ h
شاھادەت	ʃ ɑ h ɑ d ɛ t
شاھىت	ʃ ɑ h i t
شوخلا	ʃ o χ l ɑ
شوپۇر	ʃ o p u r
شىددەت	ʃ i d d ɛ t
شىركەت	ʃ i r k ɛ t
شىرىن	ʃ i r i n
شىكايەت	ʃ i k ɑ j ɛ t
شىمالىي	ʃ i m ɑ l i j
شىنجاڭ	ʃ i n d͡ʒ ɑ ŋ
شىپا	ʃ i p ɑ
شۆھرەت	ʃ ø h r ɛ t
شۈبھە	ʃ y b h ɛ
شۈكۈر	ʃ y k y r
شېئىر	ʃ e ʔ i r
شېئىرىي	ʃ e ʔ i r i j
شەترەنج	ʃ ɛ t r ɛ n d͡ʒ
شەخس	ʃ ɛ χ s
شەخسىي	ʃ ɛ χ s i j
شەخسەن	ʃ ɛ χ s ɛ n
شەربەت	ʃ ɛ r b ɛ t
شەرقىي	ʃ ɛ r q i j
شەنبە	ʃ ɛ n b ɛ
شەيتان	ʃ ɛ j t ɑ n
شەپكە	ʃ ɛ p k ɛ
غازى	ʁ ɑ z i
غالىپ	ʁ ɑ l i p
غايە	ʁ ɑ j ɛ
غاپىل	ʁ ɑ p i l
غىجەك	ʁ i d͡ʒ ɛ k
غۇرۇر	ʁ u r u r
غۇلاچ	ʁ u l ɑ t͡ʃ
غەربىي	ʁ ɛ r b i j
غەرەز	ʁ ɛ r ɛ z
غەزەل	ʁ ɛ z ɛ l
غەلىبە	ʁ ɛ l i b ɛ
غەم	ʁ ɛ m
غەمزە	ʁ ɛ m z ɛ
غەنى	ʁ ɛ n i
غەنىمەت	ʁ ɛ n i m ɛ t
غەيرەت	ʁ ɛ j r ɛ t
غەيۇر	ʁ ɛ j u r
غەيۋەت	ʁ ɛ j w ɛ t
غەپلەت	ʁ ɛ p l ɛ t
غەۋغا	ʁ ɛ w ʁ ɑ
فاشىست	p ɑ ʃ i s t
فرانسىيە	p r ɑ n s i j ɛ
فېۋرال	p e w r ɑ l
قادىر	q ɑ d i r
قار	q ɑ r
قارار	q ɑ r ɑ r
قارارگاھ	q ɑ r ɑ r ɡ ɑ h
قاراچاي	q ɑ r ɑ t͡ʃ ɑ j
قازاق	q ɑ z ɑ q
قازانماق	q ɑ z ɑ n m ɑ q
قاسىم	q ɑ s i m
قاغا	q ɑ ʁ ɑ
قالقان	q ɑ l q ɑ n
قالپاق	q ɑ l p ɑ q
قالۇن	q ɑ l u n
قامچا	q ɑ m t͡ʃ ɑ
قامۇس	q ɑ m u s
قامەت	q ɑ m ɛ t
قانائەت	q ɑ n ɑ ʔ ɛ t
قانال	q ɑ n ɑ l
قانجۇق	q ɑ n d͡ʒ u q
قانۇن	q ɑ n u n
قانۇنسىز	q ɑ n u n s i z
قايسى	q ɑ j s i
قايغۇ	q ɑ j ʁ u
قايماق	q ɑ j m ɑ q
قاپىيە	q ɑ p i j ɛ
قاچا	q ɑ t͡ʃ ɑ
قاچاق	q ɑ t͡ʃ ɑ q
قوبۇل	q o b u l
قورشىماق	q o r ʃ i m ɑ q
قورقاق	q o r q ɑ q
قورقۇنچ	q o r q u n t͡ʃ
قوزىقۇلاق	q o z i q u l ɑ q
قوزۇق	q o z u q
قوشۇق	q o ʃ u q
قوغۇشۇن	q o ʁ u ʃ u n
قوغۇن	q o ʁ u n
قولمۇقول	q o l m u q o l
قومۇش	q o m u ʃ
قونچ	q o n t͡ʃ
قوي	q o j
قويۇق	q o j u q
قويۇن	q o j u n
قوڭغۇز	q o ŋ ʁ u z
قوۋۇرغا	q o w u r ʁ ɑ
قىرائەت	q i r ɑ ʔ ɛ t
قىرغىز	q i r ʁ i z
قىرغىن	q i r ʁ i n
قىرىق	q i r i q
قىز	q i z
قىزىلغاز	q i z i l ʁ ɑ z
قىساس	q i s ɑ s
قىسسە	q i s s ɛ
قىسقاچ	q i s q ɑ t͡ʃ
قىسمەت	q i s m ɛ t
قىسىر	q i s i r
قىلىچ	q i l i t͡ʃ
قىمار	q i m ɑ r
قىن	q i n
قىياسىي	q i j ɑ s i j
قىياپەت	q i j ɑ p ɛ t
قۇببە	q u b b ɛ
قۇتلۇق	q u t l u q
قۇدرەت	q u d r ɛ t
قۇدۇق	q u d u q
قۇرئان	q u r ʔ ɑ n
قۇرغاق	q u r ʁ ɑ q
قۇزغۇن	q u z ʁ u n
قۇسماق	q u s m ɑ q
قۇسۇر	q u s u r
قۇش	q u ʃ
قۇلۇن	q u l u n
قۇيرۇق	q u j r u q
قۇچاق	q u t͡ʃ ɑ q
قۇۋانچ	q u w ɑ n t͡ʃ
قېلىن	q e l i n
قېلىپ	q e l i p
قېنى	q e n i
قېيىق	q e j i q
قەبرە	q ɛ b r ɛ
قەتئى	q ɛ t ʔ i
قەتئىيەت	q ɛ t ʔ i j ɛ t
قەترە	q ɛ t r ɛ
قەدىم	q ɛ d i m
قەدەر	q ɛ d ɛ r
قەدەھ	q ɛ d ɛ h
قەرز	q ɛ r z
قەرەنفىل	q ɛ r ɛ n p i l
قەستەن	q ɛ s t ɛ n
قەسىدە	q ɛ s i d ɛ
قەغەز	q ɛ ʁ ɛ z
قەلئە	q ɛ l ʔ ɛ
قەلب	q ɛ l p
قەلەم	q ɛ l ɛ m
قەلەندەر	q ɛ l ɛ n d ɛ r
قەلەي	q ɛ l ɛ j
قەمەر	q ɛ m ɛ r
قەيسەر	q ɛ j s ɛ r
قەپەز	q ɛ p ɛ z
قەھر	q ɛ h r
قەھرىۋا	q ɛ h r i w ɑ
كائىنات	k ɑ ʔ i n ɑ t
كابىل	k ɑ b i l
كابىنېت	k ɑ b i n e t
كاتالوگ	k ɑ t ɑ l o k
كاتالىزاتور	k ɑ t ɑ l i z ɑ t o r
كاتولىك	k ɑ t o l i k
كاتىپ	k ɑ t i p
كاتېگورىيە	k ɑ t e ɡ o r i j ɛ
كادمىي	k ɑ d m i j
كارامەت	k ɑ r ɑ m ɛ t
كارانتىن	k ɑ r ɑ n t i n
كارىدور	k ɑ r i d o r
كارىز	k ɑ r i z
كارۋات	k ɑ r w ɑ t
كاسا	k ɑ s ɑ
كاستۇم	k ɑ s t u m
كاكاۋۇ	k ɑ k ɑ w u
كالتسىي	k ɑ l t s i j
كالىفورنىي	k ɑ l i p o r n i j
كالىي	k ɑ l i j
كامال	k ɑ m ɑ l
كامالەت	k ɑ m ɑ l ɛ t
كامىل	k ɑ m i l
كاپالەت	k ɑ p ɑ l ɛ t
كاپىر	k ɑ p i r
كاھىن	k ɑ h i n
كاۋاپ	k ɑ w ɑ p
كاۋچۇك	k ɑ w t͡ʃ u k
كرىمنىي	k r i m n i j
كرىپتون	k r i p t o n
كسېنون	k s e n o n
كوبالت	k o b ɑ l t
كورلۇق	k o r l u q
كوسا	k o s ɑ
كوفېيىن	k o p e j i n
كولخوز	k o l χ o z
كومىنتېرن	k o m i n t e r n
كومپاس	k o m p ɑ s
كونسۇل	k o n s u l
كويزا	k o j z ɑ
كىت	k i t
كىتاب	k i t ɑ p
كىر	k i r
كىرا	k i r ɑ
كىرىچ	k i r i t͡ʃ
كىرپىك	k i r p i k
كىرپىچ	k i r p i t͡ʃ
كىرپە	k i r p ɛ
كىشنەمەك	k i ʃ n ɛ m ɛ k
كىلو	k i l o
كىلومېتىر	k i l o m e t i r
كىلوگىرام	k i l o ɡ i r ɑ m
كىنايە	k i n ɑ j ɛ
كىنو	k i n o
كىيمەك	k i j m ɛ k
كىيىك	k i j i k
كىپەك	k i p ɛ k
كىچىك	k i t͡ʃ i k
كيۇرىي	k j u r i j
كۆت	k ø t
كۆرۈك	k ø r y k
كۆزگۈ	k ø z ɡ y
كۆل	k ø l
كۆمۈر	k ø m y r
كۆمەك	k ø m ɛ k
كۆن	k ø n
كۆپىيىش	k ø p i j i ʃ
كۆچ	k ø t͡ʃ
كۆچكۈن	k ø t͡ʃ k y n
كۆچمەك	k ø t͡ʃ m ɛ k
كۆڭۈل	k ø ŋ y l
كۈرەش	k y r ɛ ʃ
كۈل	k y l
كۈن	k y n
كۈنجۈت	k y n d͡ʒ y t
كۈنلۈك	k y n l y k
كۈپ	k y p
كېلىش	k e l i ʃ
كېلىن	k e l i n
كېمىرمەك	k e m i r m ɛ k
كېمىچى	k e m i t͡ʃ i
كېپەن	k e p ɛ n
كەبى	k ɛ b i
كەررە	k ɛ r r ɛ
كەرەم	k ɛ r ɛ m
كەسىر	k ɛ s i r
كەسىپ	k ɛ s i p
كەشپ	k ɛ ʃ p
كەكلىك	k ɛ k l i k
كەلمەك	k ɛ l m ɛ k
كەنت	k ɛ n t
كەندىر	k ɛ n d i r
كەيپ	k ɛ j p
كەيپىيات	k ɛ j p i j ɑ t
كەچ	k ɛ t͡ʃ
كەھرىبا	k ɛ h r i b ɑ
كەۋسەر	k ɛ w s ɛ r
لازا	l ɑ z ɑ
لازىم	l ɑ z i m
لازىمەت	l ɑ z i m ɛ t
لال	l ɑ l
لانتان	l ɑ n t ɑ n
لاچىن	l ɑ t͡ʃ i n
لاڭتۇ	l ɑ ŋ t u
لاۋرېنتسىي	l ɑ w r e n t s i j
لوقما	l o q m ɑ
لوم	l o m
لوگارىفما	l o ɡ ɑ r i p m ɑ
لىباس	l i b ɑ s
لىبېرال	l i b e r ɑ l
لىتىي	l i t i j
لىفت	l i p t
لىمونات	l i m o n ɑ t
لىڭجەن	l i ŋ d͡ʒ ɛ n
لۇتپۇللا	l u t p u l l ɑ
لۇغەت	l u ʁ ɛ t
لۈتۈپ	l y t y p
لېزىز	l e z i z
لېكىن	l e k i n
لېۋەن	l e w ɛ n
لەتىپ	l ɛ t i p
لەتىپە	l ɛ t i p ɛ
لەززەت	l ɛ z z ɛ t
لەقەم	l ɛ q ɛ m
لەنەت	l ɛ n ɛ t
لەيتەكس	l ɛ j t ɛ k s
لەپ	l ɛ p
لەھجە	l ɛ h d͡ʒ ɛ
لەھزە	l ɛ h z ɛ
لەھەت	l ɛ h ɛ t
مائاش	m ɑ ʔ ɑ ʃ
مائاۋىن	m ɑ ʔ ɑ w i n
ماتكا	m ɑ t k ɑ
ماتور	m ɑ t o r
ماتېماتىكا	m ɑ t e m ɑ t i k ɑ
ماتەم	m ɑ t ɛ m
ماجال	m ɑ d͡ʒ ɑ l
ماددا	m ɑ d d ɑ
ماددىي	m ɑ d d i j
مارافون	m ɑ r ɑ p o n
ماراكەش	m ɑ r ɑ k ɛ ʃ
مارال	m ɑ r ɑ l
مارت	m ɑ r t
مارگانېتىس	m ɑ r ɡ ɑ n e t i s
مازار	m ɑ z ɑ r
ماشىنا	m ɑ ʃ i n ɑ
ماقال	m ɑ q ɑ l
ماقالا	m ɑ q ɑ l ɑ
ماقالە	m ɑ q ɑ l ɛ
ماقۇل	m ɑ q u l
مالىيە	m ɑ l i j ɛ
مالېكۇلا	m ɑ l e k u l ɑ
مامونت	m ɑ m o n t
مانجىت	m ɑ n d͡ʒ i t
مانىفېست	m ɑ n i p e s t
مانېۋىر	m ɑ n e w i r
ماگنىت	m ɑ ɡ n i t
ماگنىي	m ɑ ɡ n i j
ماھارەت	m ɑ h ɑ r ɛ t
ماھىر	m ɑ h i r
ماھىيەت	m ɑ h i j ɛ t
ماۋزۇ	m ɑ w z u
ماۋزۇر	m ɑ w z u r
مودېل	m o d e l
مول	m o l
مولىبدېن	m o l i b d e n
موم	m o m
مونچاق	m o n t͡ʃ ɑ q
موڭغۇل	m o ŋ ʁ u l
موڭغۇلىيە	m o ŋ ʁ u l i j ɛ
مىخ	m i χ
مىراس	m i r ɑ s
مىزان	m i z ɑ n
مىسال	m i s ɑ l
مىسرا	m i s r ɑ
مىسكىن	m i s k i n
مىسۋاك	m i s w ɑ k
مىقدار	m i q d ɑ r
مىكروفون	m i k r o p o n
مىكروپ	m i k r o p
مىليون	m i l j o n
مىنا	m i n ɑ
مىننەت	m i n n ɛ t
مىننەتدار	m i n n ɛ t d ɑ r
مىنىستىر	m i n i s t i r
مىنۇت	m i n u t
مىنۇس	m i n u s
مۆجىزە	m ø d͡ʒ i z ɛ
مۆمىن	m ø m i n
مۆڭ	m ø ŋ
مۆھلەت	m ø h l ɛ t
مۆھۈر	m ø h y r
مۇئاش	m u ʔ ɑ ʃ
مۇئامىلە	m u ʔ ɑ m i l ɛ
مۇئاھىدە	m u ʔ ɑ h i d ɛ
مۇئەسسەسە	m u ʔ ɛ s s ɛ s ɛ
مۇئەمما	m u ʔ ɛ m m ɑ
مۇبارەك	m u b ɑ r ɛ k
مۇباھ	m u b ɑ h
مۇتتەھەم	m u t t ɛ h ɛ m
مۇتلەق	m u t l ɛ q
مۇتەئەسسىپ	m u t ɛ ʔ ɛ s s i p
مۇتەخەسسىس	m u t ɛ χ ɛ s s i s
مۇتەكەببۇر	m u t ɛ k ɛ b b u r
مۇتەپەككۇر	m u t ɛ p ɛ k k u r
مۇخالىپ	m u χ ɑ l i p
مۇخبىر	m u χ b i r
مۇختار	m u χ t ɑ r
مۇختاريەت	m u χ t ɑ r j ɛ t
مۇداخىلە	m u d ɑ χ i l ɛ
مۇداپىە	m u d ɑ p i ɛ
مۇددەت	m u d d ɛ t
مۇدھىش	m u d h i ʃ
مۇراد	m u r ɑ t
مۇرىت	m u r i t
مۇرەببى	m u r ɛ b b i
مۇرەككەپ	m u r ɛ k k ɛ p
مۇزېي	m u z e j
مۇسا	m u s ɑ
مۇسابىقە	m u s ɑ b i q ɛ
مۇسادىرە	m u s ɑ d i r ɛ
مۇساپىر	m u s ɑ p i r
مۇساپە	m u s ɑ p ɛ
مۇسبەت	m u s b ɛ t
مۇستەسنا	m u s t ɛ s n ɑ
مۇستەقىل	m u s t ɛ q i l
مۇستەملىكە	m u s t ɛ m l i k ɛ
مۇسكۇل	m u s k u l
مۇسىبەت	m u s i b ɛ t
مۇسھەپ	m u ʃ ɛ p
مۇشەققەت	m u ʃ ɛ q q ɛ t
مۇقام	m u q ɑ m
مۇقىم	m u q i m
مۇقەددىمە	m u q ɛ d d i m ɛ
مۇقەررەر	m u q ɛ r r ɛ r
مۇكاپات	m u k ɑ p ɑ t
مۇكەممەل	m u k ɛ m m ɛ l
مۇلايىم	m u l ɑ j i m
مۇناجات	m u n ɑ d͡ʒ ɑ t
مۇناسىپ	m u n ɑ s i p
مۇناسىۋەت	m u n ɑ s i w ɛ t
مۇناپىق	m u n ɑ p i q
مۇنبەر	m u n b ɛ r
مۇنتىزىم	m u n t i z i m
مۇندەرىجە	m u n d ɛ r i d͡ʒ ɛ
مۇنەۋۋەر	m u n ɛ w w ɛ r
مۇپتىلا	m u p t i l ɑ
مۇپەتتىش	m u p ɛ t t i ʃ
مۇھارىبە	m u h ɑ r i b ɛ
مۇھاپىزەت	m u h ɑ p i z ɛ t
مۇھتاج	m u h t ɑ d͡ʒ
مۇھتەرەم	m u h t ɛ r ɛ m
مۇھىت	m u h i t
مۇھەببەت	m u h ɛ b b ɛ t
مۇھەققەق	m u h ɛ q q ɛ q
مۇھەممەس	m u h ɛ m m ɛ s
مۇۋازىنەت	m u w ɑ z i n ɛ t
مۇۋاپىق	m u w ɑ p i q
مۇۋەققەت	m u w ɛ q q ɛ t
مۇۋەپپەق	m u w ɛ p p ɛ q
مۈشكۈل	m y ʃ k y l
مۈشكۈلات	m y ʃ k y l ɑ t
مۈشۈك	m y ʃ y k
مۈلۈك	m y l y k
مۈمكىن	m y m k i n
مېتان	m e t ɑ n
مېترو	m e t r o
مېتود	m e t o t
مېتىر	m e t i r
مېدال	m e d ɑ l
مېردىيان	m e r d i j ɑ n
مېركۇرى	m e r k u r i
مېندېلېيېۋىي	m e n d e l e j e w i j
مېنىنگىت	m e n i n ɡ i t
مېيىت	m e j i t
مېھراپ	m e h r ɑ p
مېھمان	m e h m ɑ n
مېۋە	m e w ɛ
مەبلەغ	m ɛ b l ɛ ʁ
مەبۇد	m ɛ b u t
مەتبۇئات	m ɛ t b u ʔ ɑ t
مەتبە	m ɛ t b ɛ
مەتبەئە	m ɛ t b ɛ ʔ ɛ
مەجبۇر	m ɛ d͡ʒ b u r
مەجلىس	m ɛ d͡ʒ l i s
مەجنۇن	m ɛ d͡ʒ n u n
مەخمەل	m ɛ χ m ɛ l
مەخپىي	m ɛ χ p i j
مەخپىيەت	m ɛ χ p i j ɛ t
مەدرىسە	m ɛ d r i s ɛ
مەدىنە	m ɛ d i n ɛ
مەدەت	m ɛ d ɛ t
مەدەن	m ɛ d ɛ n
مەدەنىي	m ɛ d ɛ n i j
مەرت	m ɛ r t
مەرتىۋە	m ɛ r t i w ɛ
مەرسىيە	m ɛ r s i j ɛ
مەركىزىي	m ɛ r k i z i j
مەرمەر	m ɛ r m ɛ r
مەرىپەت	m ɛ r i p ɛ t
مەريەم	m ɛ r j ɛ m
مەرھۇم	m ɛ r h u m
مەرھەمەت	m ɛ r h ɛ m ɛ t
مەزكۇر	m ɛ z k u r
مەزلۇم	m ɛ z l u m
مەزمۇن	m ɛ z m u n
مەزمۇنەن	m ɛ z m u n ɛ n
مەزھەپ	m ɛ z h ɛ p
مەسئۇل	m ɛ s ʔ u l
مەسئۇلىيەت	m ɛ s ʔ u l i j ɛ t
مەسخىرە	m ɛ s χ i r ɛ
مەسلىھەت	m ɛ s l i h ɛ t
مەسنەۋىي	m ɛ s n ɛ w i j
مەسىلە	m ɛ s i l ɛ
مەسىھ	m ɛ s i h
مەسۇم	m ɛ s u m
مەسەل	m ɛ s ɛ l
مەسەلەن	m ɛ s ɛ l ɛ n
مەشغۇل	m ɛ ʃ ʁ u l
مەشغۇلات	m ɛ ʃ ʁ u l ɑ t
مەشھۇر	m ɛ ʃ h u r
مەشۇق	m ɛ ʃ u q
مەشۋەرەت	m ɛ ʃ w ɛ r ɛ t
مەغرۇر	m ɛ ʁ r u r
مەغلۇبىيەت	m ɛ ʁ l u b i j ɛ t
مەغلۇپ	m ɛ ʁ l u p
مەكتۇپ	m ɛ k t u p
مەكتەپ	m ɛ k t ɛ p
مەككە	m ɛ k k ɛ
مەمنۇن	m ɛ m n u n
مەمنۇنىيەت	m ɛ m n u n i j ɛ t
مەمۇر	m ɛ m u r
مەن	m ɛ n
مەنتىق	m ɛ n t i q
مەنتىقىي	m ɛ n t i q i j
مەنزىرە	m ɛ n z i r ɛ
مەنزىل	m ɛ n z i l
مەنسۇپ	m ɛ n s u p
مەنقۇلات	m ɛ n q u l ɑ t
مەنى	m ɛ n i
مەنىداش	m ɛ n i d ɑ ʃ
مەنپىي	m ɛ n p i j
مەنە	m ɛ n ɛ
مەيىل	m ɛ j i l
مەيۈس	m ɛ j y s
مەپتۇن	m ɛ p t u n
مەپكۇرە	m ɛ p k u r ɛ
مەھبۇب	m ɛ h b u p
مەھبۇس	m ɛ h b u s
مەھرۇم	m ɛ h r u m
مەھسۇل	m ɛ h s u l
مەھسۇلات	m ɛ h s u l ɑ t
مەھكىمە	m ɛ h k i m ɛ
مەھكۇم	m ɛ h k u m
مەھكەم	m ɛ h k ɛ m
مەھمۇد	m ɛ h m u t
مەھەل	m ɛ h ɛ l
مەھەللە	m ɛ h ɛ l l ɛ
مەھەممەت	m ɛ h ɛ m m ɛ t
مەۋجۇت	m ɛ w d͡ʒ u t
مەۋجۇدات	m ɛ w d͡ʒ u d ɑ t
مەۋسۇم	m ɛ w s u m
مەۋسۈم	m ɛ w s y m
مەۋلىد	m ɛ w l i t
مەۋھۇم	m ɛ w h u m
مەۋھۈم	m ɛ w h y m
نائىل	n ɑ ʔ i l
نائىلاج	n ɑ ʔ i l ɑ d͡ʒ
نائىنساپ	n ɑ ʔ i n s ɑ p
نائىپ	n ɑ ʔ i p
نائۇستا	n ɑ ʔ u s t ɑ
نائۈمىت	n ɑ ʔ y m i t
ناتسىست	n ɑ t s i s t
ناتوغرا	n ɑ t o ʁ r ɑ
ناتىق	n ɑ t i q
نادامەت	n ɑ d ɑ m ɛ t
نادان	n ɑ d ɑ n
نادىر	n ɑ d i r
ناز	n ɑ z
نازاكەت	n ɑ z ɑ k ɛ t
نازىم	n ɑ z i m
ناسىر	n ɑ s i r
نالايىق	n ɑ l ɑ j i q
نام	n ɑ m
ناماقۇل	n ɑ m ɑ q u l
نامايىش	n ɑ m ɑ j i ʃ
نامزات	n ɑ m z ɑ t
نامۇس	n ɑ m u s
نامەرت	n ɑ m ɛ r t
نامەلۇم	n ɑ m ɛ l u m
نان	n ɑ n
نانكور	n ɑ n k o r
نوبېلىي	n o b e l i j
نوغاي	n o ʁ ɑ j
نومۇر	n o m u r
نومۇس	n o m u s
نويابر	n o j ɑ b r
نوپۇز	n o p u z
نوپۇس	n o p u s
نىجاسەت	n i d͡ʒ ɑ s ɛ t
نىجىس	n i d͡ʒ i s
نىزام	n i z ɑ m
نىسبەت	n i s b ɛ t
نىشان	n i ʃ ɑ n
نىكا	n i k ɑ
نىلۇپەر	n i l u p ɛ r
نىوبىي	n i o b i j
نىيەت	n i j ɛ t
نىگار	n i ɡ ɑ r
نۆشۈدۈر	n ø ʃ y d y r
نۆل	n ø l
نۇتۇق	n u t u q
نۇر	n u r
نۇرانى	n u r ɑ n i
نۇسخە	n u s χ ɛ
نۇسرەت	n u s r ɛ t
نېرۋا	n e r w ɑ
نېسىپ	n e s i p
نېفىت	n e p i t
نېودىم	n e o d i m
نېون	n e o n
نېيترون	n e j t r o n
نەتىجە	n ɛ t i d͡ʒ ɛ
نەرە	n ɛ r ɛ
نەزەر	n ɛ z ɛ r
نەزەرىيە	n ɛ z ɛ r i j ɛ
نەسىر	n ɛ s i r
نەسىرىدىن	n ɛ s i r i d i n
نەسىل	n ɛ s i l
نەسىھەت	n ɛ s i h ɛ t
نەشتەر	n ɛ ʃ t ɛ r
نەغمە	n ɛ ʁ m ɛ
نەقىش	n ɛ q i ʃ
نەقىل	n ɛ q i l
نەمۇنە	n ɛ m u n ɛ
نەپس	n ɛ p s
نەپىس	n ɛ p i s
نەپەقە	n ɛ p ɛ q ɛ
نەۋ	n ɛ w
ياخشىمۇسىز	j ɑ χ ʃ i m u s i z
ياخشىمۇسىلەر	j ɑ χ ʃ i m u s i l ɛ r
ياد	j ɑ t
يارا	j ɑ r ɑ
يازماق	j ɑ z m ɑ q
ياستۇق	j ɑ s t u q
ياسىن	j ɑ s i n
ياشىماق	j ɑ ʃ i m ɑ q
ياغ	j ɑ ʁ
ياغاچ	j ɑ ʁ ɑ t͡ʃ
ياقا	j ɑ q ɑ
ياقماق	j ɑ q m ɑ q
ياقۇت	j ɑ q u t
ياكور	j ɑ k o r
يالاڭ	j ɑ l ɑ ŋ
يالاڭئاياق	j ɑ l ɑ ŋ ʔ ɑ j ɑ q
يالىڭاچ	j ɑ l i ŋ ɑ t͡ʃ
يالپۇز	j ɑ l p u z
يالۋۇرماق	j ɑ l w u r m ɑ q
يامغۇر	j ɑ m ʁ u r
يانغىن	j ɑ n ʁ i n
يانفون	j ɑ n p o n
يانماق	j ɑ n m ɑ q
يانۋار	j ɑ n w ɑ r
ياپونىيە	j ɑ p o n i j ɛ
ياڭاق	j ɑ ŋ ɑ q
ياڭيۇ	j ɑ ŋ j u
ياگاو	j ɑ ɡ ɑ o
ياۋروپا	j ɑ w r o p ɑ
ياۋۇز	j ɑ w u z
يوتقان	j o t q ɑ n
يود	j o t
يورۇقلۇق	j o r u q l u q
يوغان	j o ʁ ɑ n
يوق	j o q
يول	j o l
يولداش	j o l d ɑ ʃ
يولۋاس	j o l w ɑ s
يوپىتېر	j o p i t e r
يوپۇرماق	j o p u r m ɑ q
يىراقلىق	j i r ɑ q l i q
يىرتماق	j i r t m ɑ q
يىل	j i l
يىلان	j i l ɑ n
يىلىك	j i l i k
يىپ	j i p
يىپەك	j i p ɛ k
يىگىت	j i ɡ i t
يىگىرمە	j i ɡ i r m ɛ
يۇتماق	j u t m ɑ q
يۇرت	j u r t
يۇققا	j u q q ɑ
يۇقۇرى	j u q u r i
يۇلماق	j u l m ɑ q
يۇماق	j u m ɑ q
يۇمماق	j u m m ɑ q
يۇمۇق	j u m u q
يۇپقا	j u p q ɑ
يۇڭ	j u ŋ
يۇۋاش	j u w ɑ ʃ
يۈتمەك	j y t m ɛ k
يۈرەكلىك	j y r ɛ k l i k
يۈز	j y z
يۈسۈپ	j y s y p
يۈگەن	j y ɡ ɛ n
يېتىم	j e t i m
يېتەرسىز	j e t ɛ r s i z
يېتەرلىك	j e t ɛ r l i k
يېشىل	j e ʃ i l
يېقىلغۇ	j e q i l ʁ u
يېمەك	j e m ɛ k
يېنىك	j e n i k
يېپىشقاق	j e p i ʃ q ɑ q
يېڭىلىق	j e ŋ i l i q
يەئقۇب	j ɛ q u p
يەتتىنچى	j ɛ t t i n t͡ʃ i
يەتتە	j ɛ t t ɛ
يەتمىش	j ɛ t m i ʃ
يەر	j ɛ r
يەريۈزى	j ɛ r j y z i
يەكشەنبە	j ɛ k ʃ ɛ n b ɛ
يەل	j ɛ l
يەلكەن	j ɛ l k ɛ n
يەم	j ɛ m
يەڭگىل	j ɛ ŋ ɡ i l
يەڭگە	j ɛ ŋ ɡ ɛ
يەھۇدى	j ɛ h u d i
پاجىر	p ɑ d͡ʒ i r
پاراخوت	p ɑ r ɑ χ o t
پارازىت	p ɑ r ɑ z i t
پاراشوت	p ɑ r ɑ ʃ o t
پاراشوك	p ɑ r ɑ ʃ o k
پاراغەت	p ɑ r ɑ ʁ ɛ t
پاراكەندە	p ɑ r ɑ k ɛ n d ɛ
پاراگىراپ	p ɑ r ɑ ɡ i r ɑ p
پاراۋوز	p ɑ r ɑ w o z
پارلاق	p ɑ r l ɑ q
پارلامېنت	p ɑ r l ɑ m e n t
پارىژ	p ɑ r i ʒ
پارچىلىماق	p ɑ r t͡ʃ i l i m ɑ q
پارچە	p ɑ r t͡ʃ ɛ
پاساھەت	p ɑ s ɑ h ɛ t
پاسپورت	p ɑ s p o r t
پاك	p ɑ k
پاكىت	p ɑ k i t
پاكىز	p ɑ k i z
پالاكەت	p ɑ l ɑ k ɛ t
پالتا	p ɑ l t ɑ
پاللادىي	p ɑ l l ɑ d i j
پانۇس	p ɑ n u s
پاي	p ɑ j
پايتەخت	p ɑ j t ɛ χ t
پايدا	p ɑ j d ɑ
پروتاكتىنىي	p r o t ɑ k t i n i j
پرومېتىي	p r o m e t i j
پلۇتونىي	p l u t o n i j
پوئېما	p o ʔ e m ɑ
پورازېودىم	p o r ɑ z e o d i m
پورتپىل	p o r t p i l
پورشىن	p o r ʃ i n
پولات	p o l ɑ t
پولشا	p o l ʃ ɑ
پونتان	p o n t ɑ n
پونكىت	p o n k i t
پوپايكا	p o p ɑ j k ɑ
پىت	p i t
پىتنە	p i t n ɛ
پىدا	p i d ɑ
پىدائى	p i d ɑ ʔ i
پىشلاق	p i ʃ l ɑ q
پىنھان	p i n h ɑ n
پىيادە	p i j ɑ d ɛ
پۇت	p u t
پۇتبول	p u t b o l
پۇرسەت	p u r s ɛ t
پۇرچاق	p u r t͡ʃ ɑ q
پۇشايمان	p u ʃ ɑ j m ɑ n
پېئىل	p e ʔ i l
پېشانە	p e ʃ ɑ n ɛ
پەتىنگان	p ɛ t i n ɡ ɑ n
پەخرى	p ɛ χ r i
پەخىر	p ɛ χ i r
پەردە	p ɛ r d ɛ
پەرز	p ɛ r z
پەرق	p ɛ r q
پەرمان	p ɛ r m ɑ n
پەرىشان	p ɛ r i ʃ ɑ n
پەرىشتە	p ɛ r i ʃ t ɛ
پەرھىز	p ɛ r h i z
پەرۋا	p ɛ r w ɑ
پەرۋانە	p ɛ r w ɑ n ɛ
پەرەز	p ɛ r ɛ z
پەرەزىي	p ɛ r ɛ z i j
پەزىلەت	p ɛ z i l ɛ t
پەسىل	p ɛ s i l
پەسىھ	p ɛ s i h
پەقەت	p ɛ q ɛ t
پەلتو	p ɛ l t o
پەلسەپە	p ɛ l s ɛ p ɛ
پەلەك	p ɛ l ɛ k
پەمىدۇر	p ɛ m i d u r
پەن	p ɛ n
پەنجە	p ɛ n d͡ʒ ɛ
پەيجاو	p ɛ j d͡ʒ ɑ o
پەيشەنبە	p ɛ j ʃ ɛ n b ɛ
پەيغەمبەر	p ɛ j ʁ ɛ m b ɛ r
چارشەنبە	t͡ʃ ɑ r ʃ ɛ n b ɛ
چاشقان	t͡ʃ ɑ ʃ q ɑ n
چاشكا	t͡ʃ ɑ ʃ k ɑ
چاي	t͡ʃ ɑ j
چايان	t͡ʃ ɑ j ɑ n
چاچ	t͡ʃ ɑ t͡ʃ
چوشقا	t͡ʃ o ʃ q ɑ
چولاق	t͡ʃ o l ɑ q
چولپان	t͡ʃ o l p ɑ n
چوڭقۇر	t͡ʃ o ŋ q u r
چىش	t͡ʃ i ʃ
چىقماق	t͡ʃ i q m ɑ q
چىمەن	t͡ʃ i m ɛ n
چىۋىن	t͡ʃ i w i n
چۆمۈلە	t͡ʃ ø m y l ɛ
چۈشەنمەك	t͡ʃ y ʃ ɛ n m ɛ k
چېركاۋ	t͡ʃ e r k ɑ w
چېچەك	t͡ʃ e t͡ʃ ɛ k
چەكمەك	t͡ʃ ɛ k m ɛ k
ژارگون	ʒ ɑ r ɡ o n
ژانىر	ʒ ɑ n i r
ژېڭۋېي	ʒ e ŋ w e j
گاباردىن	ɡ ɑ b ɑ r d i n
گادولىنىي	ɡ ɑ d o l i n i j
گاز	ɡ ɑ z
گافنىي	ɡ ɑ p n i j
گاللىي	ɡ ɑ l l i j
گاڭبى	ɡ ɑ ŋ b i
گاڭپەن	ɡ ɑ ŋ p ɛ n
گاھ	ɡ ɑ h
گرۇزىيە	ɡ r u z i j ɛ
گرېتسىيە	ɡ r e t s i j ɛ
گوللاندىيە	ɡ o l l ɑ n d i j ɛ
گويا	ɡ o j ɑ
گىتار	ɡ i t ɑ r
گىرانات	ɡ i r ɑ n ɑ t
گىرانىت	ɡ i r ɑ n i t
گىرداپ	ɡ i r d ɑ p
گىرىپ	ɡ i r i p
گىياھ	ɡ i j ɑ h
گۆش	ɡ ø ʃ
گۆھەر	ɡ ø h ɛ r
گۇرۇھ	ɡ u r u h
گۇناھ	ɡ u n ɑ h
گۇناھكار	ɡ u n ɑ h k ɑ r
گۈرۈچ	ɡ y r y t͡ʃ
گۈشە	ɡ y ʃ ɛ
گۈل	ɡ y l
گۈلباغ	ɡ y l b ɑ ʁ
گۈلباھار	ɡ y l b ɑ h ɑ r
گۈللەر	ɡ y l l ɛ r
گۈلىستان	ɡ y l i s t ɑ n
گۈڭگۈرت	ɡ y ŋ ɡ y r t
گېرمانىي	ɡ e r m ɑ n i j
گېزىت	ɡ e z i t
گېكتار	ɡ e k t ɑ r
گېلىي	ɡ e l i j
گەدەن	ɡ ɛ d ɛ n
گەۋدە	ɡ ɛ w d ɛ
ھاجى	h ɑ d͡ʒ i
ھاجەتخانا	h ɑ d͡ʒ ɛ t χ ɑ n ɑ
ھادىسە	h ɑ d i s ɛ
ھارارەت	h ɑ r ɑ r ɛ t
ھازىر	h ɑ z i r
ھاقارەت	h ɑ q ɑ r ɛ t
ھاكىم	h ɑ k i m
ھاكىمىيەت	h ɑ k i m i j ɛ t
ھالاكەت	h ɑ l ɑ k ɛ t
ھالاكەتلىك	h ɑ l ɑ k ɛ t l i k
ھالاۋەت	h ɑ l ɑ w ɛ t
ھالقا	h ɑ l q ɑ
ھالقىلىق	h ɑ l q i l i q
ھالۋا	h ɑ l w ɑ
ھايا	h ɑ j ɑ
ھايات	h ɑ j ɑ t
ھىدايەت	h i d ɑ j ɛ t
ھىكايە	h i k ɑ j ɛ
ھۇجۇم	h u d͡ʒ u m
ھۇزۇر	h u z u r
ھۈجەيرە	h y d͡ʒ ɛ j r ɛ
ھۈسەيىن	h y s ɛ j i n
ھېس	h e s
ھېسسىي	h e s s i j
ھېسسىيات	h e s s i j ɑ t
ھېسىيات	h e s i j ɑ t
ھېقىق	h e q i q
ھېكايە	h e k ɑ j ɛ
ھېكىم	h e k i m
ھېيت	h e j t
ھەئە	h ɛ ʔ ɛ
ھەبەش	h ɛ b ɛ ʃ
ھەجۋىي	h ɛ d͡ʒ w i j
ھەجۋە	h ɛ d͡ʒ w ɛ
ھەدىس	h ɛ d i s
ھەدىيە	h ɛ d i j ɛ
ھەرپ	h ɛ r p
ھەسرەت	h ɛ s r ɛ t
ھەسەل	h ɛ s ɛ l
ھەسەن	h ɛ s ɛ n
ھەقىقەت	h ɛ q i q ɛ t
ھەمكار	h ɛ m k ɑ r
ھەپتە	h ɛ p t ɛ
ۋائىز	w ɑ ʔ i z
ۋابا	w ɑ b ɑ
ۋادى	w ɑ d i
ۋارىس	w ɑ r i s
ۋازارەت	w ɑ z ɑ r ɛ t
ۋاسىتە	w ɑ s i t ɛ
ۋاقىت	w ɑ q i t
ۋاگۇن	w ɑ ɡ u n
ۋاھە	w ɑ h ɛ
ۋىرۇس	w i r u s
ۋىلايەت	w i l ɑ j ɛ t
ۋۇجۇت	w u d͡ʒ u t
ۋېلسىپىت	w e l s i p i t
ۋېلىنېمەت	w e l i n e m ɛ t
ۋە	w ɛ
ۋەتەن	w ɛ t ɛ n
ۋەتەنداش	w ɛ t ɛ n d ɑ ʃ
ۋەدە	w ɛ d ɛ
ۋەز	w ɛ z
ۋەزىيەت	w ɛ z i j ɛ t
ۋەزىپە	w ɛ z i p ɛ
ۋەسىقە	w ɛ s i q ɛ
ۋەسىي	w ɛ s i j
ۋەسىيەت	w ɛ s i j ɛ t
ۋەسۋەسە	w ɛ s w ɛ s ɛ
ۋەكىل	w ɛ k i l
ۋەلسىپىت	w ɛ l s i p i t
ۋەلىئەھد	w ɛ l i ʔ ɛ h t
