aaarg	e ɪ e ɪ e ɪ ɑ ɹ d͡ʒ i
aaawesome	ɔ s ə m
aabh	e ɪ e ɪ b i e ɪ t͡ʃ
aacbc	e ɪ e ɪ s i b i s i
aar	ɑ ɹ
aarau	aː ɹ a u
aare	ɑ ɹ ə
abacate	æ b ə k ɑ t i
abacaxi	æ b ə k ə ʃ i
aback	ə b æ k
abacost	æ b ə k ɑ s t
abaisance	ə b e ɪ z ə n s
abalone	æ b ə l o ʊ n i
abandonee	ə b æ n d ə n i
abashedness	ə b æ ʃ ɪ d n ɪ s
abatement	ə b e ɪ t m ə n t
abating	ə b e ɪ t ɪ ŋ
abature	æ b ə t j ʊ ɹ
abaxial	æ b æ k s i ə l
abaza	ə b ɑ z ə
abbots	æ b ə t s
abderite	æ b d ə ɹ a ɪ t
abditive	æ b d ɪ t ɪ v
abdominous	æ b d ɑ m ə n ə s
abecedarius	e ɪ b i s i d æ ɹ i ə s
abembryonic	æ b ɛ m b ɹ i ɑ n ɪ k
abendmusik	ɑ b ə n t m u z i k
abenteric	æ b ɛ n t ɛ ɹ ɪ k
abertawe	æ b ɚ t a ʊ w i
abessive	æ b ɛ s ɪ v
abettal	ə b ɛ t l̩
abeyancy	ə b e ɪ ə n t s i
abhisheka	ə b ɪ ʃ e ɪ k ə
abhorred	æ b h ɔ ɹ d
abhorrer	æ b h ɔ ɹ ɚ
abhorrers	æ b h ɔ ɹ ɚ
abides	ə b a ɪ d s
abietate	æ b i ə t e ɪ t
abiogenetical	e ɪ b a i o ʊ d͡ʒ ɛ n ə t ə k ə l
abir	ə b ɪ ɹ
abjectedness	æ b d͡ʒ ɛ k t ə d n ə s
abjection	æ b d͡ʒ ɛ k ʃ n̩
abjectness	æ b d͡ʒ ɛ k t n ə s
abjugate	æ b d͡ʒ ə ɡ e ɪ t
abjunction	æ b d͡ʒ ʌ ŋ k ʃ ə n
abjunctive	æ b d͡ʒ ʌ ŋ k t ɪ v
abjurer	æ b d͡ʒ ʊ ɹ ɚ
ablactate	æ b l æ k t e ɪ t
ableist	e ɪ b ə l ɪ s t
ableness	e ɪ b l̩ n ə s
ablepharous	æ b l ɜ f ə ɹ ʌ s
ablephary	æ b l ɛ f ə ɹ i
ablings	e ɪ b l ɪ n z
abnormalism	æ b n ɔ ɹ m l̩ ɪ z m̩
abnormalness	æ b n ɔ ɹ m l̩ n ə s
aboiteaux	ɑ b w ɑ t o ʊ
abolition	æ b ə l ɪ ʃ n̩
abolitionary	æ b ə l ɪ ʃ ə n ɛ ɹ i
abolitionism	æ b ə l ɪ ʃ ə n ɪ z m̩
abolitionize	æ b ə l ɪ ʃ n̩ a ɪ z
abomasus	æ b o ʊ m e ɪ s ə s
abongo	ə b ɑ ŋ ɡ o ʊ
abonnements	æ b ɔ n m ɑ̃
aborad	æ b ɔ ɹ æ d
abortin	ə b ɔ ɹ t n̩
abortive	ə b ɔ ɹ t ɪ v
abortively	ə b ɔ ɹ t ɪ v l i
abound	ə b a ʊ n d
abovementioned	ə b ʌ v m ɛ n ʃ ə n d
abox	ə b ɑ k s
abrachia	ə b ɹ e ɪ k i ə
abrade	ə b ɹ e ɪ d
abrams	e ɪ b ɹ ə m z
abrase	ə b ɹ e ɪ z
abrasional	ə b ɹ e ɪ ʒ n̩ l̩
abraum	ɑ p ɹ a ʊ m
abrim	ə b ɹ ɪ m
abruzzi	ɑ b ɹ u t t s i
absalom	æ b s ə l ə m
abscise	æ b s a ɪ z
absinthism	æ b s ə n θ ɪ z m̩
absinthium	æ b s ɪ n θ i m̩
absonous	æ b s ə n ə s
abstinence	æ b s t ɪ n ə n s
abstracter	æ b s t ɹ k æ t ɚ
abstractum	æ b s t ɹ æ k t m̩
abstruse	æ b s t ɹ u s
abthane	ə b t e ɪ n
abubble	ə b ʌ b l̩
abuilding	ə b ɪ l d ɪ ŋ
aburst	ə b ɝ s t
abusion	ə b j u ʒ n̩
abustle	ə b ʌ s l̩
abutment	ə b ʌ t m n̩ t
abuts	ə b ʌ t s
abwab	ə b w ɑ b
abydene	æ b ɪ d i n
abye	ə b a ɪ
abysm	ə b ɪ z m̩
abyssopelagic	ə b ɪ s o ʊ p ə l æ d͡ʒ ɪ k
acacia	ə k e ɪ ʃ ə
academicals	æ k ə d ɛ m ɪ k l̩ z
acanthamoebiases	ə k æ n θ ə m i b a ɪ ə s i s
acanthocephaliasis	æ k æ n θ o ʊ s ɜ f ə l a ɪ ə s ɪ s
acanthocyte	ə k æ n θ o ʊ s a ɪ t
acanthoma	ə k æ n θ o ʊ m ə
acanthopterygian	æ k æ n θ ɑ p t ə ɹ ɪ d͡ʒ i n̩
acanthoses	æ k æ n θ o ʊ s i s
acaricide	ə k ɛ ɹ ə s i d
accede	æ k s i d
accent	æ k s ɛ n t
acceptably	æ k s ɛ p t ə b l i
accessibly	æ k s ɛ s ə b l i
accessorial	æ k s ə s ɔ ɹ i ə l
accismus	æ k s ɪ z m ə s
accite	ə k s a ɪ t
acclaimed	ə k l e ɪ m d
acclaims	ə k l e ɪ m z
accommodatingly	ə k ɔ m ə d e ɪ t ɪ ŋ l i
accommodative	ə k ɔ m ə d e ɪ t ɪ v
accommodator	ə k ɔ m ə d e ɪ t ɚ
accomplicity	æ k ɔ m p l ɪ s ɪ t i
accomplishment	ə k ɑ m p l ɪ ʃ m ə n t
accordancy	ə k ɔ ɹ d ə n s i
accorded	ə k ɔ ɹ d ɪ d
according	ə k ɔ ɹ d ɪ ŋ
accordion	ə k ɔ ɹ d i ə n
accountability	ə k a ʊ n t ə b ɪ l ə t i
accounts	ə k a ʊ n t s
accoutre	ə k u t ə
accumbent	ə k ʌ m b ə n t
accumulator	ə k j u m j ə l e ɪ t ɚ
accusatorial	ə k j u z ə t ɔ ɹ i ə l
accustomed	ə k ʌ s t ə m d
acerb	ə s ɜ ɹ b
acerbity	ə s ɝ b ɪ d i
acerglyn	e ɪ s ə ɹ ɡ l ɪ n
acervative	ə s ɝ v ə t ɪ v
acescence	ə s ɛ s ə n s
acetabular	æ s ɪ t æ b j ə l ɚ
acetabuliferous	æ s ɪ t æ b j u l ɪ f ə ɹ ʊ s
acetary	ə s i t ə ɹ i
acetize	æ s ə t a ɪ z
achaean	ə k i ə n
achievance	ə t͡ʃ i v ə n s
achievements	ə t͡ʃ i v m ə n t s
achilles	ə k ɪ l i z
achondroplasia	e ɪ k ɔ n d ɹ o ʊ p l e ɪ z i ə
achy	e ɪ k i
acidification	ə s ɪ d ɪ f ɪ k e ɪ ʃ ə n
acock	ə k ɔ k
aconite	æ k ə n a ɪ t
acquit	ə k w ɪ t
acrocyanosis	æ k ɹ o ʊ s a ɪ ə n o ʊ s ɪ s
acropoleis	æ k ɹ ɔ p ɔ l ɛ ɪ z
across	ə k ɹ ɔ s
acrostic	ə k ɹ ɔ s t ɪ k
acted	æ k t ɪ d
action	æ k ʃ ə n
actor	æ k t ɚ
acumination	ə k j u m ɪ n e ɪ ʃ ə n
acutely	ə k j u t l ɪ
acyl	æ s ɪ l
adam	æ d ə m
adaptable	ə d æ p t ə b ə l
adapter	ə d a p t ə
adds	æ d z
adelaide	æ d ə l e ɪ d
adermatoglyphia	e ɪ d ɝ m ə t ə ɡ l ɪ f i ə
adight	ə d a ɪ t
adjacent	ə d͡ʒ e ɪ s ə n t
adjusted	ə d͡ʒ ʌ s t ɪ d
adjuvant	æ d͡ʒ ə v ə n t
adle	e ɪ d ə l
administrative	ə d m ɪ n ə s t ɹ e ɪ ɾ ɪ v
admit	ə d m ɪ t
admits	ə d m ɪ t s
admitting	ə d m ɪ t ɪ ŋ
adobe	ə d o ʊ b i
adorable	ə d ɔ ɹ ə b ə l
adorkable	ʌ d ɔ ɹ k ə b l̩
adorn	ə d ɔ ɹ n
adown	ə d a ʊ n
adrip	ə d ɹ ɪ p
adulate	æ d͡ʒ ə l e ɪ t
adultery	ə d ʌ l t ə ɹ i
adventurous	æ d v ɛ n t͡ʃ ɚ ʌ s
advertise	æ d v ɚ t a ɪ z
aeolic	i ɑ l ɪ k
aeolipile	i o ʊ l ɪ p ʌ ɪ l
aero	ɛ ɹ o ʊ
aeroplanes	e ə ɹ ə p l e ɪ n z
aesop	i s ɔ p
aestivation	i s t ɪ v e ɪ ʃ ə n
aether	i θ ɚ
aetna	ɛ t n ə
affected	ə f ɛ k t ɪ d
affectioned	ə f ɛ k ʃ n̩ d
affections	ə f ɛ k ʃ ə n z
affine	ə f a ɪ n
affinity	ə f ɪ n ɪ t i
affirmative	ə f ɝ m ə t ɪ v
afk	e ɪ ɛ f k e ɪ
aflop	ə f l ɔ p
aflush	ə f l ʌ ʃ
afoul	ə f a ʊ l
africa	æ f ɹ ɪ k ə
afroed	æ f ɹ o ʊ d
aftercare	æ f t ɚ k ɛ ɹ
aftermath	æ f t ɚ m æ θ
afterward	æ f t ɚ w ɚ d
ag	æ ɡ
ageful	e ɪ d͡ʒ f ʊ l
agenda	ə d͡ʒ ɛ n d ə
agendum	ə d͡ʒ ɛ n d ə m
ager	e ɪ d͡ʒ ɚ
aggro	æ ɡ ɹ o ʊ
aghast	ə ɡ æ s t
aging	e ɪ d͡ʒ ɪ ŋ
agistment	e ɪ d͡ʒ ɪ s t m ə n t
agitprop	æ d͡ʒ ə t p ɹ ɑ p
agleam	ə ɡ l i m
aglitter	ə ɡ l ɪ t ə ɹ
aglow	ə ɡ l o ʊ
agnogenic	æ ɡ n ə d͡ʒ ɛ n ɪ k
agon	æ ɡ o ʊ n
agrees	ə ɡ ɹ i z
agribusiness	æ ɡ ɹ ɪ b ɪ z n ə s
agrimony	æ ɡ ɹ ɪ m o ʊ n i
agrippa	ə ɡ ɹ ɪ p ə
agrobusiness	æ ɡ ɹ o ʊ b ɪ z n ə s
agush	ə ɡ ʌ ʃ
ailment	e ɪ l m ə n t
aim	e ɪ m
aimless	e ɪ m l ə s
airplane	ɛ ɹ p l e ɪ̯ n
aisle	a ɪ̯ l
aisles	a ɪ l z
akimbo	ə k ɪ m b o ʊ
akkadian	ə k e ɪ d i ə n
akroposthion	æ k ɹ o ʊ p ɔ s θ ɪ ə n
alarmed	ə l ɑ ɹ m d
alb	æ l b
albanian	æ l b e ɪ n i ə n
albatross	æ l b ə t ɹ ɔ s
albedo	æ l b i d o ʊ
albuquerque	æ l b ə k ə ɹ k i
albuterol	æ l b j u t ə ɹ ɔ l
alchemistical	æ l k ə m ɪ s t ɪ k ə l
alcibiades	æ l s ə b a ɪ ə d i z
alcopop	æ l k o ʊ p ɔ p
aldehyde	æ l d i h a ɪ d
alecy	e ɪ l s i
aleister	æ l i s t ɚ
alejandro	æ l ə h ɑ n d ɹ o ʊ
alep	ə l ɛ p
alertness	ə l ɝ t n ə s
alexipharmic	ə l ɛ k s ɪ f ɑ ɹ m ɪ k
algedonic	æ l d͡ʒ ɪ d ɔ n ɪ k
algiers	æ l d͡ʒ ɪ ɹ z
algo	æ l ɡ o ʊ̯
algorithmic	æ l ɡ ə ɹ ɪ ð m ɪ k
alias	e ɪ l i ə s
alicorn	æ l ɪ k ɔ ɹ n
alidades	æ l ɪ d e ɪ d z
alight	ə l a ɪ t
alighten	ə l a ɪ t ə n
aligned	ə l a ɪ n d
alike	ə l a ɪ k
aliter	æ l ɪ t ɚ
alive	ə l a ɪ v
aliveness	ə l a ɪ v n ə s
alize	ə l i z
alkali	æ l k ə l a ɪ
allay	ə l e ɪ
allegate	æ l ɪ ɡ e ɪ t
allegiance	ə l i d͡ʒ ə n s
alleluiatic	æ l ɪ l u j æ t ɪ k
alleys	æ l i z
alleyway	æ l i w e ɪ
allies	æ l a ɪ z
allocate	æ l ə k e ɪ t
allometry	æ l ə m ɛ t ɹ ɪ
allude	ə l u d
alluring	ɚ l u ɚ ɹ ɪ ŋ
allylic	ə l ɪ l ɪ k
almighty	ɔ l m a ɪ t i
almucantar	æ l m ə k æ n t ɚ
aloin	æ l o ʊ ɪ n
aloos	æ l u z
alosetron	ə l o ʊ s ə t ɹ ɑ n
aloud	ə l a ʊ d
alphanumerically	æ l f ə n j u m ɛ ɹ ɪ k l i
alprostadil	æ l p ɹ ɑ s t ə d ɪ l
alquifou	æ l k ɪ f u
also	ɔ l s o ʊ
altogether	ɔ l t u ɡ ɛ ð ɚ
alumnus	ə l ʌ m n ə s
amahs	ɑ m ə z
amalgam	ə m æ l ɡ ə m
amalgamate	ə m æ l ɡ ə m e ɪ t
amanda	ə m æ n d ə
amandine	ə m a n d ɪ n
amanuensis	ə m æ n j u ɛ n s ɪ s
amarant	æ m ə ɹ æ n t
amaranth	æ m ə ɹ æ n θ
amaro	ə m ɑ ɹ o ʊ
amati	ɑ m ɑ t i
ambagious	æ m b e ɪ d͡ʒ ə s
ambeer	æ m b ɪ ɹ
amberjack	æ m b ɚ d͡ʒ æ k
ambitious	æ m b ɪ ʃ ə s
ambivalent	æ m b ɪ v ə l ə n t
ambles	æ m b ə l z
amee	e ɪ m i
ameliorate	ə m i l i ə ɹ e ɪ t
amend	ə m ɛ n d
ament	e ɪ m ə n t
amerce	ə m ɝ s
americanised	æ m ɛ ɹ ɪ k ə n a ɪ z d
amersham	æ m ə ɹ ʃ ə m
amethopterin	æ m ə θ ɑ p t ə ɹ ɪ n
amfilochia	æ m f ɪ l o ʊ k i ə
amfilohia	æ m f ɪ l o ʊ h a ɪ ə
amfilokhia	æ m f ɪ l o ʊ k a ɪ ə
amiability	e ɪ m i ʌ b ɪ l ə t i
amicable	æ m i k ə b ə l
amma	æ m ə
ammer	æ m ɚ
ammo	æ m o ʊ
amoebic	ə m i b ɪ k
amorphic	ə m ɔ ɹ f ɪ k
amphibolous	æ m f ɪ b ə l ə s
amply	æ m p l i
amprenavir	æ m p ɹ ɛ n ə v ɪ ɹ
amputate	æ m p j ʊ t e ɪ t
amwf	e ɪ ɛ m d ʌ b ə l j u ɛ f
anachronism	ə n æ k ɹ ə n ɪ z ə m
anaclitic	æ n ə k l ɪ t ɪ k
anadromes	æ n ə d ɹ o ʊ m z
anaerobic	æ n ə ɹ o ʊ b i k
anagram	æ n ə ɡ ɹ æ m
anagrammer	æ n ə ɡ r æ m ə ɹ
anaheim	æ n ə h a ɪ m
anahuac	æ n ə w æ k
analogous	ə n æ l ə ɡ ə s
analysises	ə n æ l ɪ s ɪ s ɪ z
analytically	æ n ə l ɪ t ɪ k ə l l i
analytics	æ n ə l ɪ t ɪ k s
ananke	ə n æ ŋ k i
anarchy	æ n ɑ ɹ k i
anastomose	ə n æ s t ə m o ʊ z
anathema	ə n æ θ ə m ə
anchovy	æ n t͡ʃ o ʊ v i
ancilla	æ n s ɪ l ə
anderson	æ n d ɚ s ə n
andover	æ n d o ʊ v ə ɹ
andrew	æ n d ɹ u
andrews	æ n d ɹ u z
androgenone	æ n d r ɔ d͡ʒ ɪ n o ʊ n i
androgony	æ n d ɹ ɔ ɡ ə n i
andromache	æ n d ɹ ɔ m ə k i
andy	æ n d i
angary	æ ŋ ɡ ə ɹ i
angelina	æ n d͡ʒ ə l i n ə
angels	e ɪ n d͡ʒ ə l z
angie	æ n d͡ʒ i
anglerfish	æ ŋ ɡ l ɚ f ɪ ʃ
anglican	æ ŋ ɡ l ɪ k ə n
anglophilic	æ ŋ ɡ l ə f ɪ l ɪ k
anguilla	æ ŋ ɡ w ɪ l ə
anguillan	æ ŋ ɡ w ɪ l ə n
angular	æ ŋ ɡ j u l ɚ
anigh	ə n a i
anilingus	e ɪ n ɪ l ɪ ŋ ɡ ə s
animalcule	æ n ɪ m æ l k j u l
animatedly	æ n ɪ m e ɪ t ɪ d l i
animation	æ n ə m e ɪ ʃ ə n
anlaut	a n l a ʊ t
anlauts	a n l a ʊ t s
annapolis	ə n æ p ə l i s
annoyant	ə n ɔ ɪ ə n t
annual	æ n j u ə l
annuity	ə n j u ɪ t i
annular	æ n j ə l ɚ
anode	æ n o ʊ d
anodyne	æ n ə d a ɪ n
anomaloscope	ə n ɑ m ə l o ʊ s k o ʊ p
anomie	æ n ə m i
anonymously	ə n ɔ n ə m ə s l i
anophyte	æ n ə f a ɪ t
anorexia	æ n ə ɹ ɛ k s i ə
anoxia	æ n ɔ k s i ə
answered	æ n s ɜ d
antagonism	æ n t æ ɡ ə n ɪ z ə m
antagonist	æ n t æ ɡ ə n ɪ s t
antagonistic	æ n t æ ɡ ə n ɪ s t ɪ k
antecedent	a n t ɪ s i d ə n t
anthesis	æ n θ i s ɪ s
anthology	æ n θ ɑ l ə d͡ʒ i
anthropological	æ n θ ɹ ə p ə l ɑ d͡ʒ i k ə l
anthropometry	æ n θ ɹ ə p ɔ m ɪ t ɹ ɪ
antianginal	æ n t a ɪ æ n d͡ʒ a ɪ n ə l
antifebrine	æ n t ɪ f i b ɹ ɪ n
antigua	æ n t i ɡ w ə
antilibanus	æ n t ə l ɪ b ə n ə s
antimacassar	æ n t ɪ m ə k æ s ɚ
antimony	æ n t ɪ m o ʊ n i
antipathy	æ n t ɪ p ə θ i
antique	æ n t i k
antirrion	æ n t ɪ ɹ i ɔ n
antithalian	æ n t ɪ θ e ɪ l i ə n
anxiolytic	æ ŋ k s i ə l ɪ t ɪ k
anymore	ɛ n i m ɔ ɹ
anywho	ɛ n i h u
aorist	e ɪ ə ɹ ɪ s t
apamea	æ p ə m i ə
apart	ə p ɑ ɹ t
apartment	ə p ɑ ɹ t m ə n t
apennine	æ p ə n a ɪ n
aphesis	æ f ə s ɪ s
aphetism	a f ə t ɪ z ə m
aphoristic	æ f ə ɹ ɪ s t ɪ k
apocope	ə p ɔ k ə p i
apodioxis	æ p o ʊ d a ɪ ɔ k s ɪ s
apograph	æ p ə ɡ ɹ ɑ f
apologise	ə p ɔ l ə d͡ʒ a ɪ z
apology	ə p ɔ l ə d͡ʒ i
apophasis	ə p ɔ f ə s ɪ s
aposematism	æ p o ʊ s ɪ m æ t ɪ z ə m
apostolic	æ p ə s t ɑ l ɪ k
apostrophe	ə p ɑ s t ɹ ə f i
apotheosis	ə p ɑ θ i o ʊ s ɪ s
apotropaic	æ p ə t ɹ ə p e ɪ ɪ k
appall	ə p ɔ l
apparatchik	æ p ə ɹ æ t͡ʃ ɪ k
apparitor	ə p æ ɹ i t ə ɹ
appears	ə p ɪ ɹ z
appease	ə p i z
appellative	ə p ɛ l ə t ɪ v
apperception	æ p ɚ s ɛ p ʃ ə n
appetite	æ p ə t a ɪ t
applause	ə p l ɔ z
apple	æ p ə l
appraisings	ə p ɹ e ɪ z ɪ ŋ z
appreciation	ə p ɹ i ʃ i e ɪ ʃ ə n
apprise	ə p ɹ a ɪ̯ z
approaching	ə p ɹ o ʊ t͡ʃ ɪ ŋ
appui	ə p w i
appulse	æ p ʌ l s
apraxia	ə p ɹ æ k s ɪ ə
apricate	æ p ɹ i k e ɪ t
aprium	e ɪ p ɹ i ə m
aptotic	æ p t ɔ t ɪ k
aquabib	æ k w ə b ɪ b
aquafauna	æ k w ə f ɔ n ə
aquiver	ə k w ɪ v ə ɹ
arabesque	æ ɹ ə b ɛ s k
arabetic	æ ɹ ə b ɛ t ɪ k
arabia	ə ɹ e ɪ b i ə
arable	æ ɹ ə b l̩
aragon	æ ɹ ə ɡ ɑ n
ararat	æ ɹ ə ɹ æ t
aratus	ə ɹ e ɪ t ə s
arbela	ɑ ɹ b i l ə
arbitrageur	ɑ ɹ b ɪ t ɹ ɑ ʒ ɝ ɹ
arboriculture	ɑ ɹ b ɔ ɹ i k ʌ l t͡ʃ ɚ
arbuscle	ɑ b ʌ s ə l
archaeastronomy	ɑ ɹ k i ə s t ɹ ɔ n ə m i
archi	ɑ ɹ t͡ʃ i
arctogaeal	ɑ ɹ k t ə d͡ʒ i ə
arcweld	ɑ ɹ k w ɛ l d
areek	ə ɹ i k
arethusa	æ ɹ i θ j u z ə
argentina	ɑ ɹ d͡ʒ ə n t i n ə
arginyl	ɑ ɹ d͡ʒ ə n ɪ l
arguing	ɑ ɹ ɡ j u ɪ ŋ
ariadne	æ ɹ i æ d n i
aristocrat	ə ɹ ɪ s t ə k ɹ æ t
aristolochic	ə ɹ ɪ s t ə l o ʊ k ɪ k
arlo	ɑ ɹ l o ʊ
armageddon	ɑ ɹ m ə ɡ ɛ d n̩
armatole	ɑ ɹ m ə t o ʊ l
armed	ɑ ɹ m d
armenian	ɑ ɹ m i n i ə n
armies	ɑ ɹ m i z
armoire	ɑ ɹ m w ɑ ɹ
armor	ɑ ɹ m ɚ
aroar	ə ɹ ɔ ɹ
arow	ə ɹ o ʊ
arrange	ə ɹ e ɪ n d͡ʒ
arrayed	ə ɹ e ɪ d
arrest	ə ɹ ɛ s t
arrival	ə ɹ a ɪ v ə l
arrivisme	æ ɹ ɪ v ɪ z ə m
arriviste	æ ɹ ɪ v i s t
arrows	ɛ ɹ o ʊ z
art	ɑ ɹ t
artemii	ɑ ɹ t e ɪ m i
artemisia	ɑ t ɪ m ɪ z ɪ ə
artesian	ɑ ɹ t i ʒ ə n
arthritis	ɑ ɹ θ ɹ a ɪ t ɪ s
artless	ɑ ɹ t l ɪ s
asail	ə s e ɪ l
asexual	e ɪ s ɛ k ʃ u ə l
ashame	ə ʃ e ɪ m
ashwick	æ ʃ w ɪ k
asiatic	e ɪ̯ ʒ i æ t ɪ k
asker	æ s k ɚ
asmara	æ s m ɑ ɹ ə
asmrtist	e ɪ ɛ s ɛ m ɑ ɹ t ɪ s t
asocial	e ɪ s o ʊ ʃ ə l
asp	æ s p
aspergillum	æ s p ə ɹ d͡ʒ ɪ l ə m
asplode	ə s p l o ʊ d
asprawl	ə s p ɹ ɔ l
assart	ə s ɑ ɹ t
assclown	æ s k l a ʊ n
assemble	ə s ɛ m b l̩
asserted	ə s ɝ t ɪ d
assertory	ə s ɜ ɹ t ə ɹ i
assessor	ə s ɛ s ɚ
asshat	æ s h æ t
assiduous	ə s ɪ d͡ʒ u ə s
assish	æ s ɪ ʃ
assonance	æ s ə n ə n s
assort	ə s ɔ ɹ t
assyria	ə s ɪ ɹ i ə
assyrogenous	æ s ɪ ɹ ɑ d͡ʒ ɪ n ə s
astare	ə s t ɛ ɹ
asterix	æ s t ə ɹ ɪ k s
asteroids	æ s t ə ɹ o ɪ d z
asterostromelloid	æ s t ə ɹ o ʊ s t ɹ o ʊ m ə l ɔ ɪ d
asthenospermic	æ s θ ə n o s p ɝ m ɪ k
asthmatic	æ z m æ t ɪ k
astonied	ə s t ɑ n i d
astonish	ə s t ɑ n ɪ ʃ
astraddle	ə s t ɹ æ d ə l
astrid	æ s t ɹ ɪ d
astroarchitecture	æ s t ɹ ə ɑ ɹ k ə t ɛ k t͡ʃ ɚ
astrobleme	æ s t ɹ o ʊ b l i m
astrobotany	æ s t ɹ ə b ɔ t ə n ɪ
astrolabe	æ s t ɹ ə l e ɪ b
astrolinguistics	æ s t ɹ ə l ɪ ŋ ɡ w ɪ s t ɪ k s
astromancy	æ s t ɹ ɵ m æ n s i
asweat	ə s w ɛ t
aswirl	ə s w ɜ ɹ l
aswoon	ə s w u n
atabal	æ t ə b ɑ l
athena	ə θ i n ə
athenians	ə θ i n i ə n z
atiptoe	ə t ɪ p t o ʊ
atlantis	ə t l æ n t ə s
atmosphere	æ t m ə s f ɪ ɹ
atonal	e ɪ t o ʊ n ə l
atrabiliary	æ t ɹ ə b ɪ l ɪ ə ɹ i
atrabilious	æ t ɹ ə b ɪ l i ə s
atrabiliously	æ t ɹ ə b ɪ l i ə s l i
atramentaceous	æ t ɹ ə m ɛ n t e ɪ ʃ ə s
atray	ə t ɹ e ɪ
atrium	e ɪ t ɹ i ə m
atrocious	ə t ɹ o ʊ ʃ ə s
attaching	ə t æ t͡ʃ ɪ ŋ
attaint	ə t e ɪ n t
attainted	ə t e ɪ n t ə d
attame	ə t e ɪ m
attap	a t a p
attempt	ə t ɛ m p t
attention	ə t ɛ n ʃ ə n
attire	ə t a ɪ ə ɹ
attractant	ə t ɹ æ k t ə n t
attributable	ə t ɹ ɪ b j u t ə b ə l
atumble	ə t ʌ m b ə l
aubergine	o ʊ b ɚ ʒ i n
aubrey	ɔ b ɹ i
audacious	ɔ d e ɪ ʃ ə s
audaciously	ɔ d e ɪ ʃ ə s l i
audacity	ɔ d æ s ɪ t i
audiation	ɔ d i e ɪ ʃ ə n
audience	ɔ d i ə n s
auding	ɑ d ɪ ŋ
audio	ɔ d i o ʊ
augean	ɔ d͡ʒ i ə n
augustan	ɔ ɡ ʌ s t ə n
aura	ɔ ɹ ə
aurally	ɔ ɹ ə l i
auratic	ɔ ɹ æ t ɪ k
auricular	ɔ ɹ ɪ k j ə l ɚ
auriferous	ɔ ɹ ɪ f ə ɹ ə s
aurum	ɔ ɹ ə m
austenesque	ɔ s t ə n ɛ s k
austerity	ɔ s t ɛ ɹ ɪ t i
australianize	ɔ s t ɹ e ɪ l j ə n a ɪ z
autarchy	ɔ t ɑ ɹ k i
author	ɔ θ ɚ
autology	ɔ t ɔ l ə d͡ʒ ɪ
autolytic	ɔ t ə l ɪ t ɪ k
autosome	ɔ ɾ ə s o ʊ m
auxetophone	ɔ k s ə t ə f o ʊ n
auxlanger	ɔ k s l æ ŋ ɚ
avatar	æ v ə t ɑ ɹ
avenge	ə v ɛ n d͡ʒ
aventine	æ v ə n t a ɪ n
aventurine	ə v ɛ n t͡ʃ ə ɹ ɪ n
averroes	ə v ɛ ɹ o ʊ i z
aviate	e ɪ v i e ɪ t
avicenna	æ v ɪ s ɛ n ə
avocet	æ v ə s ɛ t
avoided	ə v ɔ ɪ d ɪ d
avoiding	ə v ɔ ɪ d ɪ ŋ
avoidings	ə v ɔ ɪ d ɪ ŋ z
aweather	ə w ɛ ð ə ɹ
awner	ɔ n ə ɹ
awook	ə w ʊ k
axe	æ k s
axel	æ k s ə l
axing	æ k s ɪ ŋ
axles	æ k s ə l z
axophyte	æ k s ə f a ɪ t
axunge	a k s ə n j
azeri	ə z ɛ ɹ i
azidothymidine	ə z ɪ d o ʊ θ a ɪ m ɪ d i n
azimuth	æ z ɪ m ə θ
azotemia	æ z o ʊ t i m i ə
azoth	æ z ɔ θ
azoxystrobin	ə z ɔ k s i s t ɹ o ʊ b ɪ n
baathist	b ɑ θ ɪ s t
babbies	b æ b i z
babble	b æ b l̩
babied	b e ɪ b i d
babydom	b e ɪ b i d ə m
babymoon	b e ɪ b i m u n
babysit	b e ɪ b i s ɪ t
bacchanal	b æ k ə n ə l
baccy	b æ k i
backfire	b æ k f a ɪ ə ɹ
backhand	b æ k h æ n d
backlash	b æ k l æ ʃ
backpedal	b æ k p ɛ d ə ɫ
backronym	b æ k ɹ ə n ɪ m
backseaters	b æ k s i t ɚ z
backslang	b æ k s l æ ŋ
backstage	b æ k s t e ɪ d͡ʒ
backstory	b æ k s t ɔ ɹ i
baconian	b ə k o ʊ n ɪ ə n
bacterioscopy	b æ k t ɪ ə ɹ ɪ ɔ s k ə p i
bacteriotoxin	b æ k t ɪ ə ɹ ɪ o ʊ t ɔ k s ɪ n
baculoviral	b æ k j ʊ l ə v a ɪ ɹ ə l
bacup	b e ɪ k ʌ p
badger	b æ d͡ʒ ɚ
badinage	b ɑ d ɪ n ɑ ʒ
badinerie	b æ d ɪ n ɹ i
badlands	b æ d l æ n d z
badly	b æ d l i
bagger	b æ ɡ ɚ
baggie	b æ ɡ i
bagley	b æ ɡ l i
baignoire	b ɛ n w ɑ ɹ
baiji	b a ɪ d͡ʒ i
baijiu	b a ɪ d͡ʒ u
bailey	b e ɪ l i
bailiff	b e ɪ l ɪ f
bailings	b e ɪ l ɪ ŋ z
bailiwick	b e ɪ l ɪ w ɪ k
bails	b e ɪ l z
bakes	b e ɪ k s
baking	b e ɪ k ɪ ŋ ɡ
baksheesh	b æ k ʃ i ʃ
baku	b ɑ k u
balalaika	b æ l ə l a ɪ k ə
balanced	b æ l ə n s t
balanitis	b æ l ə n a ɪ t ɪ s
balas	b a l ə s
balconic	b æ l k ə n ɪ k
balcony	b æ l k ə n i
bale	b e ɪ̯ l
ballast	b æ l ə s t
ballcock	b ɔ l k ɔ k
ballindine	b æ l ɪ n d a ɪ n
ballistic	b ə l ɪ s t ɪ k
ballooned	b ə l u n d
ballooner	b ə l u n ə ɹ
balloons	b ə l u n z
balls	b ɔ l z
bally	b æ l i
baloney	b ə l o ʊ n i
balsamy	b ɑ l s ə m i
baltimore	b ɔ l t ɪ m ɔ ɹ
bama	b æ m ə
bamboo	b æ m b u
bambooey	b æ m b u i
bandersnatch	b æ n d ə ɹ s n æ t͡ʃ
bandicoot	b æ n d i k u t
banes	b e ɪ n z
bangarang	b æ ŋ ə ɹ æ ŋ
bangel	b e ɪ n d͡ʒ ə l
banger	b æ ŋ ɡ ə ɹ
bangiophyte	b æ n d͡ʒ ɪ ɔ f a ɪ t
bangle	b æ ŋ ɡ ə l
bangor	b æ ŋ ɡ ə ɹ
baning	b e ɪ n ɪ ŋ
banishing	b æ n ɪ ʃ ɪ ŋ
banjax	b æ n d͡ʒ æ k s
banjo	b æ n d͡ʒ o ʊ
banjouke	b æ n d͡ʒ o ʊ j u k
banquette	b æ ŋ k ɛ t
baptism	b æ p t ɪ z ə m
baptize	b æ p t a ɪ z
barbarian	b ɑ ɹ b ɛ ɹ i ə n
barbican	b ɑ ɹ b ɪ k ə n
bardolatrous	b ɑ ɹ d ɔ l ə t ɹ ə s
bares	b ɛ ɹ z
barfly	b ɑ ɹ f l a ɪ
bargain	b ɑ ɹ ɡ ə n
baristo	b a ɹ i s t o
baritsu	b ɑ ɹ ɪ t s u
barn	b ɑ ɹ n
barrator	b æ ɹ ə t ə ɹ
barratry	b æ ɹ ə t ɹ i
barythymia	b æ ɹ ɪ θ a ɪ m ɪ ə
baryton	b æ ɹ ɪ t ɔ n
bascule	b æ s k j u l
bashar	b ə ʃ ɑ r
basher	b æ ʃ ɚ
bashir	b ə ʃ ɪ ɹ
basing	b e ɪ s ɪ ŋ
basket	b æ s k ɪ t
basophil	b e ɪ s ə f ɪ l
bassein	b ə s e ɪ n
bassoons	b ə s u n z
basted	b e ɪ s t ɪ d
bastes	b e ɪ s t s
basting	b e ɪ s t ɪ ŋ
bateleur	b æ t ə l ɜ
bathampton	b ɑ θ æ m p t ə n
batlet	b æ t l ə t
bats	b æ t s
batter	b æ t ə ɹ
batty	b æ t i
batverse	b æ t v ɝ s
baubon	b ɔ b ə n
bauhaus	b a ʊ h a ʊ s
baumkuchen	b a ʊ m k u x ə n
bawd	b ɔ d
baylisascariasis	b e ɪ l ɪ s æ s k ə ɹ a ɪ ə s ɪ s
bays	b e ɪ z
bazinga	b ə z i ŋ ɡ ə
bbl	b i b i ɛ l
bdelygmia	d ɛ l ɪ ɡ m i ə
beaconed	b i k ə n d
beacons	b i k ə n z
beaded	b i d ɪ d
beadings	b i d ɪ ŋ z
beads	b i d z
beady	b i d i
beam	b i m
beamer	b i m ɚ
beams	b i m z
bean	b i n
beanbag	b i n b æ ɡ
beans	b i n z
bears	b ɛ ɹ z
beast	b i s t
beastie	b i s t i
beasties	b i s t i z
beaten	b i t ə n
beater	b i t ɚ
beath	b i ð
beating	b i t ɪ ŋ
beatings	b i t ɪ ŋ z
beatnik	b i t n ɪ k
beaus	b o ʊ z
beautify	b j u t ɪ f a ɪ
became	b ɪ k e ɪ m
bedale	b i d e ɪ l
bedazzle	b ɪ d æ z l̩
bedded	b ɛ d ɪ d
bedless	b ɛ d l ə s
bedmas	b ɛ d m æ s
bedquilt	b ɛ d k w ɪ l t
bedtime	b ɛ d t a ɪ m
bedye	b ɪ d a ɪ
beech	b i t͡ʃ
beechnut	b i t͡ʃ n ʌ t
beefsteak	b i f s t e ɪ k
beej	b i d͡ʒ
beeper	b i p ɚ
beeping	b i p ɪ ŋ
beeps	b i p s
beethovenian	b e ɪ t o ʊ v i n i ə n
beetroot	b i t ɹ u t
beets	b i t s
befallen	b ɪ f ɔ l ə n
befitting	b ɪ f ɪ t ɪ ŋ
befriender	b ɪ f ɹ ɛ n d ɚ
beg	b ɛ ɡ
begged	b ɛ ɡ d
beggings	b ɛ ɡ ɪ ŋ z
begun	b ɪ ɡ ʌ n
beheadal	b ə h ɛ d ə l
beholden	b i h o ʊ l d ə n
beijing	b e ɪ d͡ʒ ɪ ŋ
belgrade	b ɛ l ɡ ɹ e ɪ d
beliven	b ə l ɪ v ə n
bell	b ɛ l
belled	b ɛ l d
bellied	b ɛ l i d
bells	b ɛ l z
bellwether	b ɛ l w ɛ ð ɚ
belonephobia	b ɛ l o ʊ n ɛ f o ʊ b i ə
below	b ə l o ʊ
beltings	b ɛ l t ɪ ŋ z
belvedere	b ɛ l v ə d ɪ ɹ
belvoir	b i v ɚ
bemean	b ɪ m i n
bemire	b ə m a ɪ ə ɹ
bender	b ɛ n d ɚ
bene	b i n
beneath	b ɪ n i θ
benedict	b ɛ n ə d ɪ k t
benghazi	b ɛ n ɡ ɑ z i
benign	b ɪ n a ɪ n
benny	b ɛ n i
benzathine	b ɛ n z ə θ i n
benzopyrazine	b ɛ n z o ʊ p a ɪ ɹ ə z i n
benzylpenicillin	b ɛ n z ə l p ɛ n ɪ s ɪ l ɪ n
berate	b ɪ ɹ e ɪ t
berceuse	b ɛ ɹ s u z
bereaved	b ɪ r i v d
berg	b ɝ ɡ
berliner	b ɚ l ɪ n ɚ
bert	b ɝ t
berytian	b ə ɹ ɪ ʃ ə n
besalted	b ɪ s ɑ l t ɪ d
besieged	b ə s i d͡ʒ d
besmirchment	b i s m ɝ t͡ʃ m ə n t
bess	b ɛ s
betake	b ɪ t e ɪ k
betaxolol	b ə t æ k s ə l ɔ l
betty	b ɛ t i
bevel	b ɛ v ə l
bever	b i v ɚ
bewray	b ɪ ɹ e ɪ
bexarotene	b ɛ k s æ ɹ ə t i n
beyblade	b e ɪ b l e ɪ d
bheer	b ɪ ə ɹ
bhopal	b o ʊ p ɑ l
biceps	b a ɪ s ɛ p s
bieber	b i b ɚ
biffin	b ɪ f ɪ n
bigamous	b ɪ ɡ ə m ə s
biggies	b ɪ ɡ i z
biggy	b ɪ ɡ i
bigly	b ɪ ɡ l i
bigotry	b ɪ ɡ ə t ɹ i
bike	b a ɪ k
bilge	b ɪ l d͡ʒ
bilirubin	b ɪ l ɪ ɹ u b ɪ n
billi	b ɪ l i
billings	b ɪ l ɪ ŋ z
bimatoprost	b ɪ m æ t ə p ɹ ɑ s t
bimetallic	b a ɪ m ɪ t æ l ɪ k
bind	b a ɪ n d
binder	b a ɪ n d ɚ
binding	b a ɪ n d ɪ ŋ
bine	b a ɪ n
bines	b a ɪ n z
bing	b ɪ ŋ
binghi	b ɪ ŋ a ɪ
binner	b ɪ n ɚ
binning	b ɪ n ɪ ŋ
binomial	b a ɪ n o ʊ m i ə l
binturong	b ɪ n t ə ɹ ɔ ŋ
biogenesis	b a i o ʊ d͡ʒ ɛ n ə s ɪ s
biological	b a ɪ ə l ɑ d͡ʒ ɪ k ə l
biology	b a ɪ ɑ l ə d͡ʒ i
biomedical	b a ɪ o ʊ m e d ɪ k l
biotic	b a ɪ ɑ t ɪ k
biotite	b a ɪ ə t a ɪ t
biparous	b ɪ p ə ɹ ə s
bippy	b ɪ p i
birdbrain	b ɚ d b ɹ e ɪ n
birdlime	b ɚ d l a ɪ m
birthplace	b ɝ θ p l e ɪ s
biscotti	b ɪ s k ɑ t i
biscuit	b ɪ s k ɪ t
bisect	b a ɪ s ɛ k t
bisector	b a ɪ s ɛ k t ɚ
bishop	b ɪ ʃ ə p
bismarck	b ɪ z m ɑ ɹ k
bispecificity	b a ɪ s p ɛ s ɪ f ɪ s ɪ t i
bisque	b ɪ s k
bitey	b a ɪ t i
bitty	b ɪ t i
bivious	b i v i ə s
blabs	b l æ b z
blackball	b l æ k b ɔ l
blacked	b l æ k t
blacken	b l æ k ə n
blackface	b l æ k f e ɪ s
blackies	b l æ k i z
blackness	b l æ k n ə s
blackout	b l æ k a ʊ t
blackouts	b l æ k a ʊ t s
blacksmith	b l æ k s m ɪ θ
blackthorn	b l æ k θ ɔ ɹ n
blading	b l e ɪ d ɪ ŋ
blah	b l ɑ
blame	b l e ɪ m
blamed	b l e ɪ m d
blaming	b l e ɪ m ɪ ŋ
blank	b l æ ŋ k
blankie	b l æ ŋ k i
blasian	b l e ɪ ʒ ə n
blate	b l e ɪ t
bleaching	b l i t͡ʃ ɪ ŋ
bleak	b l i k
bleat	b l i t
blee	b l i
bleeds	b l i d z
blend	b l ɛ n d
blended	b l ɛ n d ɪ d
blender	b l ɛ n d ɚ
blendings	b l ɛ n d ɪ ŋ z
blessings	b l ɛ s ɪ ŋ z
blewits	b l u ɪ t s
blightings	b l a ɪ t ɪ ŋ z
blighty	b l a ɪ t i
blimey	b l a ɪ m i
blimps	b l ɪ m p s
blister	b l ɪ s t ɚ
blizzard	b l ɪ z ɚ d
blob	b l ɑ b
bloc	b l ɑ k
bloke	b l o ʊ k
blokes	b l o ʊ k s
blond	b l ɑ n d
blonds	b l ɑ n d z
bloodwood	b l ʌ d w ʊ d
bloom	b l u m
blotch	b l ɑ t͡ʃ
blowhard	b l o ʊ h ɑ ɹ d
blueprint	b l u p ɹ ɪ n t
blueshift	b l u ʃ ɪ f t
bluestem	b l u s t ɛ m
blunderbusses	b l ʌ n d ə ɹ b ʌ s ɪ z
blurry	b l ɜ ɹ i
blushy	b l ʌ ʃ i
blyth	b l a ɪ ð
boa	b o ʊ ə
boast	b o ʊ s t
boaster	b o ʊ s t ɚ
boating	b o ʊ t ɪ ŋ
bodega	b o ʊ d e ɪ ɡ ə
bodily	b ɑ d ɪ l i
bodyguard	b ɑ d i ɡ ɑ ɹ d
bohunk	b o ʊ h ʌ ŋ k
boilermaker	b ɔ ɪ l ə ɹ m e ɪ k ə ɹ
bok	b ɔ k
boko	b o ʊ k o ʊ
bold	b o ʊ l d
boldacious	b o ʊ l d e ɪ ʃ ə s
bolete	b o ʊ l i t
bolshevism	b ɑ l ʃ ə v ɪ z ə m
bomb	b ɑ m
bomber	b ɑ m ə ɹ
bombing	b ɔ m ɪ ŋ
bonapartism	b o ʊ n ə p ɑ ɹ t ɪ z ə m
bonjour	b ɑ n ʒ ʊ ɹ
booking	b ʊ k ɪ ŋ
booklegging	b ʊ k l ɛ ɡ ɪ ŋ
bookmark	b ʊ k m ɑ ɹ k
bookshelf	b ʊ k ʃ ɛ l f
booleans	b u l i ə n s
boombox	b u m b ɑ k s
booming	b u m ɪ ŋ
boomings	b u m ɪ ŋ z
boon	b u n
booster	b u s t ɚ
booze	b u z
borage	b ɔ ɹ ɪ d͡ʒ
borborigmus	b ɔ b ə ɹ ɪ ɡ m ə s
bore	b ɔ ɹ
borg	b ɔ ɹ ɡ
borrowed	b ɑ ɹ o ʊ d
bosom	b ʊ z ə m
boston	b ɔ s t ə n
bote	b o ʊ t
both	b o ʊ θ
botryoidal	b ɔ t ɹ i ɔ ɪ d ə l
bottles	b ɑ t l̩ z
boudin	b u d æ̃
bough	b a ʊ
bought	b ɔ t
bougie	b u ʒ i
bouillabaisse	b u j ə b e ɪ s
bounced	b a ʊ n s t
bouncer	b a ʊ n s ə ˞
bounciest	b a ʊ n s i ɪ s t
bound	b a ʊ n d
bounded	b a ʊ n d ɪ d
bounties	b a ʊ n t i z
boutye	b a ʊ t j ə
bowery	b a ʊ ə ɹ i
bowiesque	b o ʊ i ɛ s k
bowing	b o ʊ ɪ ŋ
bowlo	b o ʊ l o ʊ
bowls	b o ʊ l z
bowmanship	b o ʊ m ə n ʃ ɪ p
bowtie	b o ʊ t a ɪ
boy	b ɔ ɪ
boyhood	b ɔ ɪ h ʊ d
boyish	b ɔ ɪ ɪ ʃ
braai	b ɹ a ɪ
brace	b ɹ e ɪ s
bracken	b ɹ æ k ə n
braden	b ɹ e ɪ d ə n
brag	b ɹ æ ɡ
bragfest	b ɹ æ ɡ f ɛ s t
braggadocious	b ɹ æ ɡ ə d o ʊ ʃ ə s
bragged	b ɹ æ ɡ d
braiding	b ɹ e ɪ d ɪ ŋ
braies	b ɹ e ɪ
brail	b ɹ e ɪ l
braille	b ɹ e ɪ l
brainstorm	b ɹ e ɪ n s t ɔ ɹ m
braised	b ɹ e ɪ z d
braize	b ɹ e ɪ z
brakes	b ɹ e ɪ k s
bramble	b ɹ æ m b ə l
brand	b ɹ æ n d
brandywine	b ɹ æ n d i w a ɪ n
brangle	b ɹ æ ŋ ɡ ə l
brank	b ɹ æ ŋ k
branks	b ɹ æ ŋ k s
brassie	b ɹ æ s i
brassiere	b ɹ ə z ɪ ɹ
bravings	b ɹ e ɪ v ɪ ŋ z
brawl	b ɹ ɔ l
bray	b ɹ e ɪ
brays	b ɹ e ɪ z
braze	b ɹ e ɪ z
brazil	b ɹ ə z ɪ l
bread	b ɹ ɛ d
breakable	b ɹ e ɪ k ə b l
breakie	b ɹ ɛ k i
breaks	b ɹ e ɪ k s
breast	b ɹ ɛ s t
breasticle	b ɹ ɛ s t ɪ k l
breath	b ɹ ɛ θ
breathing	b ɹ i ð ɪ ŋ
bred	b ɹ ɛ d
breeched	b ɹ i t͡ʃ t
breed	b ɹ i d
breeding	b ɹ i d ɪ ŋ
breeks	b ɹ i k s
breitschwanz	b ɹ a ɪ t͡ʃ v ɑ n t s
bremelanotide	b r ɛ m ə l æ n ə t a ɪ d
brennschluss	b ʀ e n ʃ l ʊ s
brethren	b ɹ ɛ ð ɹ ə n
breton	b ɹ ɛ t ə n
brewster	b ɹ u s t ɚ
bribery	b ɹ a ɪ b ə ɹ i
bribing	b ɹ a ɪ b ɪ ŋ
bricking	b ɹ ɪ k ɪ ŋ
brided	b ɹ a ɪ d ɪ d
bridged	b ɹ ɪ d͡ʒ d
bridgehead	b ɹ ɪ d͡ʒ h ɛ d
brief	b ɹ i f
briefed	b ɹ i f t
briefers	b ɹ i f ɚ z
briefs	b ɹ i f s
brighten	b ɹ a ɪ t ə n
brightest	b ɹ a ɪ t ɪ s t
brightness	b ɹ a ɪ t n ə s
briny	b ɹ a ɪ n i
brio	b ɹ i o ʊ
brisk	b ɹ ɪ s k
brisked	b ɹ ɪ s k t
brisking	b ɹ ɪ s k ɪ ŋ
britches	b ɹ ɪ t͡ʃ ɪ z
brittany	b ɹ ɪ t ə n i
brivet	b ɹ ɪ v ɪ t
broad	b ɹ ɔ d
brock	b ɹ ɑ k
brockle	b ɹ ɑ kᵊ l
broil	b ɹ ɔ ɪ l
broken	b ɹ o ʊ k ə n
bronx	b ɹ ɑ ŋ k s
brony	b ɹ o ʊ n i
brood	b ɹ u d
brooklyn	b ɹ ʊ k l ə n
brooks	b ɹ ʊ k s
broseph	b ɹ o ʊ s ə f
brotus	b ɹ o ʊ t ə s
brow	b ɹ a ʊ
brownian	b ɹ a ʊ n i ə n
brownish	b ɹ a ʊ n ɪ ʃ
browse	b ɹ a ʊ z
browsings	b ɹ a ʊ z ɪ ŋ z
bruce	b ɹ u s
bruk	b ɹ ʊ k
brumal	b ɹ u m ə l
brumby	b ɹ ʌ m b i
brunei	b ɹ u n a ɪ
brushing	b ɹ ʌ ʃ ɪ ŋ
brutes	b ɹ u t s
brutify	b ɹ u t ɪ f a ɪ
btu	b i t i j u
bubble	b ʌ b ə l
buccolingual	b ʌ k o ʊ l ɪ ŋ ɡ w ə l
bucking	b ʌ k ɪ ŋ
buckle	b ʌ k ə l
buckler	b ʌ k l ɚ
bucko	b ʌ k o ʊ
bucks	b ʌ k s
budgerigar	b ʌ d͡ʒ ə ɹ i ɡ ɑ ɹ
budgies	b ʌ d͡ʒ i z
buffer	b ʌ f ɚ
buffoonic	b ə f u n ɪ k
buggery	b ʌ ɡ ə ɹ i
build	b ɪ l d
building	b ɪ l d ɪ ŋ
bukshi	b ʌ k ʃ i
bulb	b ʌ l b
bulbiform	b ʌ l b ɪ f ɔ m
bull	b ʊ l
bulldoze	b ʊ l d o ʊ z
bulldust	b ʊ l d ʌ s t
bulled	b ʊ l d
bullied	b ʊ l i d
bullies	b ʊ l i z
bullion	b ʊ l j ə n
bum	b ʌ m
bunbury	b ʌ n b ə r ɪ
bund	b ʊ n d
bundt	b ʌ n t
bungi	b ʌ n ɡ i
bungle	b ʌ ŋ ɡ ə l
bunkum	b ʌ ŋ k ə m
buns	b ʌ n z
buoyant	b ɔ ɪ ə n t
burble	b ɜ ɹ b ə l
burdock	b ɝ d ɑ k
burgomaster	b ɜ ɹ ɡ ə m æ s t ə ɹ
burgrave	b ɜ ɹ ɡ ɹ e ɪ v
burgundian	b ɜ ɹ ɡ ʌ n d ɪ ə n
burma	b ɝ m ə
burmese	b ɝ m i z
burned	b ɜ ɹ n d
burns	b ɝ n z
burnt	b ɜ ɹ n t
burocracy	b j ʊ ɹ ɑ k ɹ ə s i
bus	b ʌ s
bused	b ʌ s t
bush	b ʊ ʃ
bushel	b ʊ ʃ ə l
busking	b ʌ s k ɪ ŋ
busky	b ʌ s k i
busted	b ʌ s t ə d
busty	b ʌ s t i
butanedinitrile	b j u t e ɪ n d a ɪ n a ɪ t ɹ a ɪ l
butt	b ʌ t
butted	b ʌ t ɪ d
butterfat	b ʌ t ɚ f æ t
butterfingers	b ʌ t ɚ f ɪ ŋ ɡ ɚ z
butterfish	b ʌ t ə ɹ f ɪ ʃ
butters	b ʌ t ɚ z
butting	b ʌ t ɪ ŋ
buttock	b ʌ t ə k
butts	b ʌ t s
buzzing	b ʌ z ɪ ŋ
buzzle	b ʌ z ə l
byhove	b ɪ h o ʊ v
byte	b a ɪ t
byzantium	b ɪ z æ n t i ə m
caatinga	k ɑ t ɪ ŋ ɡ ə
cabbing	k æ b ɪ ŋ
caber	k e ɪ b ɚ
cabot	k æ b ə t
cabs	k æ b z
cachinnate	k æ k ɪ n e ɪ t
cacodaemon	k æ k ə d i m ə n
cacoethic	k a k o ʊ i θ i k
cacoethically	k a k o ʊ i θ ɪ k ə l i
caddo	k æ d o ʊ
cadger	k æ d͡ʒ ə ɹ
caducous	k ə d j u k ə s
caelum	s i l ə m
caesura	s ɪ ʒ ʊ ɹ ə
cafestol	k ə f ɛ s t ɔ l
cahoots	k ə h u t s
cain	k e ɪ n
caipirinha	k a ɪ p ɪ ɹ i n j ə
caipiroska	k a ɪ p ɪ ɹ ɔ s k ə
cairn	k ɛ ɹ n
cajetan	k æ d͡ʒ ə t ə n
cakes	k e ɪ k s
calabash	k æ l ə b æ ʃ
calais	k æ l e ɪ
calamanco	k æ l ə m æ ŋ k o ʊ
calamander	k æ l ə m æ n d ɚ
calas	k ə l ɑ
calc	k æ l k
calced	k æ l s t
calcitonin	k æ l s ɪ t o ʊ n ɪ n
calcutta	k æ l k ʌ t ə
caleb	k e ɪ l ə b
caledon	k æ l ə d ə n
calends	k æ l ɪ n d z
cali	k æ l i
caliper	k æ l ɪ p ɚ
callahan	k æ l ə h ə n
calligraphy	k ə l ɪ ɡ ɹ ə f i
callus	k æ l ə s
calve	k æ v
calvin	k æ l v ɪ n
calvity	k æ l v ɪ t i
calvous	k æ l v ə s
cambuslang	k æ m b ə s l æ ŋ
camel	k æ m ə l
camelot	k æ m ə l ɔ t
camels	k æ m ə l z
cameo	k æ m i o ʊ
cameron	k æ m ə ɹ ə n
camo	k æ m o ʊ
camouflage	k æ m ə f l ɑ ʒ
camps	k æ m p s
campus	k æ m p ə s
canaanite	k e ɪ n ə n a ɪ t
canagliflozin	k æ n ə ɡ l ə f l o ʊ z ɪ n
canarese	k æ n ə ɹ i z
cancellation	k æ n s ə l e ɪ ʃ ə n
candlemas	k æ n d ə l m ə s
caned	k e ɪ n d
cankle	k æ ŋ k ə l
cannoli	k ə n o ʊ l i
canoe	k ə n u
canoeing	k ə n u ɪ ŋ
canoes	k ə n u z
cant	k æ n t
cantabrigian	k æ n t ə b ɹ ɪ d͡ʒ ɪ ə n
canter	k æ n t ə ɹ
cantrail	k æ n t ɹ e ɪ l
capability	k e ɪ p ə b ɪ l ə t i
capacitate	k ə p æ s ɪ t e ɪ t
capecitabine	k æ p ə s a ɪ t ə b i n
capellini	k æ p ə l i n i
caper	k e ɪ p ɚ
capitol	k æ p ɪ t ə l
caplan	k æ p l ə n
capon	k e ɪ p ə n
capped	k æ p t
cappie	k æ p i
capricorn	k æ p ɹ ɪ k ɔ ɹ n
capricornus	k æ p ɹ ɪ k ɔ ɹ n ə s
capsaicin	k æ p s e ɪ ə s ə n
caracara	k æ ɹ ə k ɑ ɹ ə
caraway	k æ ɹ ə w e ɪ
carb	k ɑ ɹ b
carbenoxolone	k ɑ ɹ b ɪ n ɑ k s ə l o ʊ n
carbonari	k ɑ ɹ b ə n ɑ ɹ i
carcanet	k ɑ ɹ k ə n ɛ t
carcass	k ɑ ɹ k ə s
cardboard	k ɑ ɹ d b ɔ ɹ d
cardioverter	k ɑ ɹ d i o ʊ v ɜ ɹ t ə ɹ
caress	k ə ɹ ɛ s
caresses	k ə ɹ ɛ s ɪ z
carey	k ɛ ɹ i
carinthian	k ə r ɪ n θ i ə n
cariole	k æ ɹ i o ʊ l
carlisle	k ɑ ɹ l a ɪ l
carmel	k ɑ ɹ m l̩
carminative	k ɑ ɹ m ɪ n ə t ɪ v
carnaval	k ɑ ɹ n ə v ɑ l
carneous	k ɑ ɹ n i ə s
carol	k æ ɹ ə l
caron	k æ ɹ ə n
carpus	k ɑ ɹ p ə s
carrell	k ə ɹ ɛ l
carthage	k ɑ ɹ θ ɪ d͡ʒ
carton	k ɑ ɹ t n̩
cartoon	k ɑ ɹ t u n
carts	k ɑ ɹ t s
casa	k ɑ s ə
cascabel	k æ s k ə b ɛ l
case	k e ɪ s
caspofungin	k æ s p o ʊ f ʌ n d͡ʒ ɪ n
cassata	k ə s ɑ t ə
castanet	k æ s t ə n ɛ t
caster	k æ s t ə r
castilian	k ə s t ɪ l j ə n
casting	k æ s t ɪ ŋ
castlegregory	k æ s ə l ɡ ɹ ɛ ɡ ə ɹ i
castless	k æ s t l ə s
castro	k æ s t ɹ o ʊ
casuist	k æ z j u ɪ s t
catalpa	k ə t æ l p ə
catalytic	k æ t ə l ɪ t ɪ k
catalyze	k æ t ə l a ɪ z
catamenia	k æ t ə m i n ɪ ə
catamite	k æ t ə m a ɪ t
catamount	k æ t ə m a ʊ n t
cataplexy	k æ t ə p l ɛ k s i
catastrophe	k ə t æ s t ɹ ə f i
catchment	k æ t͡ʃ m ə n t
catechize	k æ t ɪ k a ɪ z
catenary	k æ t ə n ɛ ɹ i
catering	k e ɪ t ə ɹ ɪ ŋ
caterpillar	k æ t ɚ p ɪ l ɚ
catharsis	k ə θ ɑ ɹ s ɪ s
cathouse	k a t h a ʊ s
cathy	k æ θ i
caucasus	k ɔ k ə s ə s
causes	k ɔ z ɪ z
cavalry	k æ v ə l ɹ i
cavan	k æ v n̩
caveach	k ə v i t͡ʃ
caveat	k æ v i ɑ t
cazh	k æ ʒ
cease	s i s
cecocentral	s i k ə s ɛ n t ɹ ə l
cedes	s i d z
cee	s i
cefozopran	s ə f ɑ z ə p ɹ æ n
cel	s ɛ l
cellist	t͡ʃ ɛ l ɪ s t
celluloid	s ɛ l j ə l ɔ ɪ d
celta	s ɛ l t ə
centered	s ɛ n t ə ɹ d
centumvir	s ɛ n t ʌ m v ə ɹ
ceramist	s ə ɹ a m ɪ s t
ceratium	s ɪ ɹ e ɪ ʃ ɪ ə m
cerberus	s ɝ b ə ɹ ə s
cerebration	s ɛ ɹ ɪ b ɹ e ɪ ʃ ə n
cerebrotonic	s ɛ ɹ ɪ b ɹ o ʊ t ɔ n ɪ k
ceremonies	s ɛ ɹ ɪ m o ʊ n i z
ceremony	s ɛ ɹ ə m o ʊ n i
certitude	s ɝ t ə t j u d
cerulean	s ə ɹ u l i ə n
cervical	s ɝ v i k l̩
cervix	s ɝ v ɪ k s
cesspool	s ɛ s p u l
cetacean	s ɪ t e ɪ ʃ ə n
cevapi	t͡ʃ ɛ v ɑ p i
ceviche	s ə v i t͡ʃ e ɪ
chabadnik	χ ə b ɑ d n ɪ k
chabazite	k æ b ə z a ɪ t
chackle	t͡ʃ æ k ə l
chaconne	ʃ a k ɔ n
chaffer	t͡ʃ æ f ɚ
chain	t͡ʃ e ɪ n
chained	t͡ʃ e ɪ n d
chairness	t͡ʃ ɛ ɹ n ə s
chairs	t͡ʃ ɛ ɹ z
chajnantor	ʃ a n a n t ɔ ɹ
chalet	ʃ æ l e ɪ
chalkboard	t͡ʃ ɔ k b ɔ ɹ d
chamfer	t͡ʃ æ m f ɚ
chamorro	t͡ʃ ə m ɔ ɹ o ʊ
champagne	ʃ æ m p e ɪ n
champers	ʃ æ m p ə ɹ z
champion	t͡ʃ æ m p i ə n
chanakya	t͡ʃ ɑ n ə k j ə
chancellery	t͡ʃ æ n t s l ə ɹ i
changeling	t͡ʃ e ɪ n d͡ʒ l ɪ ŋ
changeset	t͡ʃ e ɪ n d͡ʒ s ɛ t
channels	t͡ʃ æ n ə l z
chanson	ʃ ɑ̃ s ɔ̃
chanticleer	t͡ʃ æ n t ə k l ɪ ɹ
chantment	t͡ʃ æ n t m ə n t
chapfallen	t͡ʃ æ p f ɔ l ə n
charged	t͡ʃ ɑ d͡ʒ d
charities	t͡ʃ ɛ ɹ ə t i z
charlottetown	ʃ ɑ ɹ l ɪ t a ʊ n
charmer	t͡ʃ ɑ ɹ m ɚ
charms	t͡ʃ ɑ ɹ m z
chasings	t͡ʃ e ɪ s ɪ ŋ z
chasma	k æ z m ə
chastity	t͡ʃ æ s t ɪ t i
chasuble	t͡ʃ æ z j ʊ b ə l
chattel	t͡ʃ æ t ə l
chattings	t͡ʃ æ t ɪ ŋ z
chauvinism	ʃ o ʊ v ɪ n ɪ z m̩
cheatings	t͡ʃ i t ɪ ŋ z
checked	t͡ʃ ɛ k t
checkings	t͡ʃ ɛ k ɪ ŋ z
cheddaring	t͡ʃ ɛ d ə ɹ ɪ ŋ
cheeked	t͡ʃ i k t
cheeped	t͡ʃ i p t
cheered	t͡ʃ ɪ ɹ d
cheerfulness	t͡ʃ ɪ ɹ f ə l n ə s
cheering	t͡ʃ ɪ ɹ ɪ ŋ
cheerios	t͡ʃ ɪ ɹ i o ʊ z
chefs	ʃ ɛ f s
chelate	k i l e ɪ t
chels	t͡ʃ ɛ l s
chem	k ɛ m
chemist	k ɛ m ɪ s t
chemistry	k ɛ m ɪ s t ɹ i
chen	t͡ʃ ɛ n
chenoweth	t͡ʃ ɪ n o ʊ ɪ θ
cheque	t͡ʃ ɛ k
cheques	t͡ʃ ɛ k s
cherty	t͡ʃ ɜ ɹ t i
chevrolet	ʃ ɛ v ɹ ə l e ɪ
chewed	t͡ʃ u d
cheyenne	ʃ a ɪ æ n
chianina	k i ə n i n ə
chiasmus	k a ɪ æ z m ə s
chiauss	t͡ʃ ə u s
chickenhawk	t͡ʃ ɪ k ɪ n h ɔ k
chickies	t͡ʃ ɪ k i z
chickpea	t͡ʃ ɪ k p i
chicory	t͡ʃ ɪ k ə ɹ i
chiding	t͡ʃ a ɪ d ɪ ŋ
chiffon	ʃ ɪ f ɑ n
chilblain	t͡ʃ ɪ l b l e ɪ n
chiliarchy	k ɪ l ɪ ɑ ɹ k i
chiliastic	k ɪ l i æ s t ɪ k
chillun	t͡ʃ ɪ l ə n
chinoiserie	ʃ i n w ɑ z ə ɹ i
chins	t͡ʃ ɪ n z
chios	k i ɑ s
chip	t͡ʃ ɪ p
chirpy	t͡ʃ ɜ ɹ p i
chisel	t͡ʃ ɪ z ə l
chitinous	k a ɪ t ɪ n ə s
chivvy	t͡ʃ ɪ v i
chloride	k l ɔ ɹ a ɪ d
chloroprocaine	k l ɔ ɹ o ʊ p ɹ o ʊ k e ɪ n
choenix	k i n ɪ k s
choi	t͡ʃʰ ɔ ɪ
choked	t͡ʃ o ʊ k t
choleraic	k ɔ l ə ɹ e ɪ ɪ k
chomo	t͡ʃ o ʊ m o ʊ
choose	t͡ʃ u z
chopped	t͡ʃ ɑ p t
chops	t͡ʃ ɑ p s
chopstix	t͡ʃ ɑ p s t ɪ k s
chord	k ɔ ɹ d
chordate	k ɔ ɹ d e ɪ t
choregus	k ə ɹ i ɡ ə s
chose	t͡ʃ o ʊ z
chosen	t͡ʃ o ʊ z ə n
choupique	ʃ u p i k
choush	t͡ʃ a ʊ ʃ
chowse	t͡ʃ a ʊ s
chresard	k ɹ i s ɑ ɹ d
chrism	k ɹ ɪ z ə m
christ	k ɹ a ɪ s t
christine	k ɹ ɪ s t i n
christman	k ɹ ɪ s t m ə n
chron	k ɹ ɔ n
chronolatry	k ɻ ə n ɑ l ə t ɻ i
chronoscope	k ɹ ɑ n ə s k o ʊ p
chrysostom	k ɹ ɪ s ə s t ə m
chu	t͡ʃ u
chubster	t͡ʃ ʌ b s t ɚ
chuck	t͡ʃ ʌ k
chuckey	t͡ʃ ʌ k i
chuckle	t͡ʃ ʌ k ə l
chucky	t͡ʃ ʌ k i
chumpy	t͡ʃ ʌ m p i
churlish	t͡ʃ ɝ l ɪ ʃ
cia	s i a ɪ e ɪ
ciabatta	t͡ʃ ə b ɑ t a
cialis	s i æ l ɪ s
ciao	t͡ʃ a ʊ
cicatrise	s ɪ k ə t ɹ a ɪ z
cichlid	s ɪ k l ɪ d
cicisbeo	t͡ʃ i t͡ʃ ə z b e ɪ o ʊ
cider	s a ɪ̯ d ɚ
ciera	s i ɛ ɹ ə
cilungu	t͡ʃ i l u ŋ ɡ u
cimbrian	s ɪ m b ɹ i ə n
cimetidine	s a ɪ m ɛ t ɪ d i n
cinderella	s ɪ n d ə ɹ ɛ l ə
circassian	s ə ɹ k æ ʃ ə n
circle	s ɜ ɹ k ə l
circumfix	s ɚ k ə m f ɪ k s
circumfuse	s ɜ ɹ k ə m f j ʊ z
circumstellar	s ɜ k ə m s t ɛ l ə
circumvention	s ɜ ɹ k ə m v ɛ n ʃ ə n
cirrostratus	s ɪ ɹ ə s t ɹ e ɪ t ə s
cisapride	s ɪ s ə p ɹ a ɪ d
cit	s ɪ t
citation	s a ɪ t e ɪ ʃ ə n
citing	s a ɪ t ɪ ŋ
citizens	s ɪ t ɪ z ə n z
citric	s ɪ t ɹ ɪ k
civic	s ɪ v ɪ k
civilized	s ɪ v ɪ l a ɪ z d
civitates	s ɪ v ɪ t e ɪ t s
cladribine	k l æ d ɹ ɪ b i n
claim	k l e ɪ m
clamped	k l æ m p t
clamping	k l æ m p ɪ ŋ
clancy	k l æ n s i
clank	k l æ ŋ k
clapping	k l æ p ɪ ŋ
clarifier	k l ɛ ɹ ə f a ɪ ə ɹ
clart	k l ɑ t
classic	k l æ s ɪ k
clatter	k l æ t ɚ
clavicytherium	k l æ v ə s a ɪ θ ɪ ə ɹ i ə m
clayed	k l e ɪ d
cleanliness	k l ɛ n l i n ə s
cleansing	k l ɛ n z ɪ ŋ
clearing	k l ɪ ɹ ɪ ŋ
clearly	k l ɪ ɹ l i
cleave	k l i v
cleek	k l i k
clematis	k l ɛ m ə t ɪ s
clench	k l ɛ n t͡ʃ
clevedon	k l i v d ə n
clicker	k l ɪ k ɚ
cliffs	k l ɪ f s
clifton	k l ɪ f t ə n
climatic	k l a ɪ m æ t ɪ k
cling	k l ɪ ŋ
clinical	k l ɪ n ɪ k ə l
clint	k l ɪ n t
cliodynamics	k l a ɪ o ʊ d a ɪ n æ m ɪ k s
clockpost	k l ɔ k p o ʊ s t
clockwork	k l ɑ k w ɝ k
clomb	k l o ʊ m
clone	k l o ʊ n
clonus	k l o ʊ n ə s
clopidogrel	k l o ʊ p ɪ d ə ɡ ɹ ɛ l
clorazepate	k l ɔ ɹ æ z ə p e ɪ t
clorgiline	k l ɔ ɹ d͡ʒ ɪ l i n
closeup	k l o ʊ s ʌ p
closing	k l o ʊ z ɪ ŋ
clost	k l o ʊ s t
clothesline	k l o ʊ ð z l a ɪ n
clothing	k l o ʊ ð ɪ ŋ
clotter	k l ɔ t ə ɹ
cloud	k l a ʊ d
clouding	k l a ʊ d ɪ ŋ
clouds	k l a ʊ d z
clowder	k l a ʊ̯ d ɚ
clowning	k l a ʊ n ɪ ŋ
clubbings	k l ʌ b ɪ ŋ z
clubs	k l ʌ b z
cluck	k l ʌ k
clucking	k l ʌ k ɪ ŋ
clumb	k l ʌ m
clump	k l ʌ m p
clumps	k l ʌ m p s
clypei	k l ɪ p ɪ a ɪ
cnemis	n i m ɪ s
coach	k o ʊ t͡ʃ
coachability	k o ʊ t͡ʃ ə b ɪ l ɪ t i
coalesce	k o ʊ ə l ɛ s
coals	k o ʊ l z
coarsen	k ɔ ɹ s ə n
coastal	k o ʊ s t ə l
coati	k o ʊ ɑ t i
coating	k o ʊ t ɪ ŋ
cobswan	k ɔ b s w ɔ n
coca	k o ʊ k ə
cockchafer	k ɔ k t͡ʃ e ɪ f ə ɹ
cocktail	k ɔ k t e ɪ l
cocoa	k o ʊ k o ʊ
coda	k o ʊ d ə
codon	k o ʊ d ɔ n
coelom	s i l ə m
coeus	s i ə z
coffee	k ɔ f i
cogent	k o͡ʊ d͡ʒ n̩ t
coggery	k ɔ ɡ ə ɹ i
cohort	k o ʊ̯ h ɔ ɹ t
coign	k ɔ ɪ n
colander	k ɑ l ə n d ə ɹ
coleford	k o ʊ l f ə ɹ d
coles	k o ʊ l z
colic	k ɔ l ɪ k
coll	k ɔ l
collaborate	k ə l a b ə ɹ e ɪ t
collagenous	k ə l æ d͡ʒ i n ə s
collateral	k ə l æ t ə ɹ ə l
collection	k ə l ɛ k ʃ ə n
collet	k ɑ l ɪ t
colloquialize	k ə l o ʊ k w i ə l a ɪ z
colposcope	k ɔ l p ə s k o ʊ p
colugo	k ə l u ɡ o ʊ
columbia	k ə l ʌ m b i ə
coma	k o ʊ m ə
combative	k ə m b æ t ɪ v
combined	k ə m b a ɪ n d
comedo	k ə m i d o ʊ
comedy	k ɑ m ə d i
comfiture	k ʌ m f ɪ t j ʊ ə
comfortative	k ʌ m f ɚ t e ɪ t ɪ v
comfortless	k ʌ m f ɚ t l ə s
commence	k ə m ɛ n s
commented	k ɑ m ɛ n t ɪ d
commissar	k ɑ m ə s ɑ r
commissioners	k ə m ɪ ʃ ə n ɚ z
common	k ɑ m ə n
communicant	k ə m j u n ɪ k ə n t
communicate	k ə m j u n ɪ k e ɪ t
communicated	k ə m j u n ɪ k e ɪ t ɪ d
community	k ə m j u n ə t i
companies	k ʌ m p ə n i z
compelled	k ə m p ɛ l d
compels	k ə m p ɛ l z
compense	k ə m p ɛ n s
compersion	k ə m p ɝ ʒ ə n
compete	k ə m p i t
competed	k ə m p i t ɪ d
competitiveness	k ə m p ɛ t ɪ t ɪ v n ə s
compilation	k ɑ m p ɪ l e ɪ ʃ ə n
complacent	k ə m p l e ɪ s ə n t
complain	k ə m p l e ɪ n
complaint	k ə m p l e ɪ n t
complement	k ɑ m p l ə m ə n t
completes	k ə m p l i t s
complicated	k ɑ m p l ɪ k e ɪ t ɪ d
complied	k ə m p l a ɪ d
complies	k ə m p l a ɪ z
compliment	k ɑ m p l ə m ə n t
complimentary	k ɑ m p l ɪ̈ m ɛ n t ə ɹ i
component	k ʌ m p o ʊ n ə n t
compunction	k ə m p ʌ ŋ k ʃ ə n
computerette	k ə m p j u t ɚ ɹ ɛ t
concatenate	k ə n k æ t ə n e ɪ t
conceded	k ə n s i d ɪ d
conceives	k ə n s i v z
conceivings	k ə n s i v ɪ ŋ z
concierge	k ɑ n s i ɛ ɹ ʒ
conciliatory	k ə n s ɪ l i ə t ɔ ɹ i
conclusion	k ə n k l u ʒ ə n
concourse	k ɔ ŋ k ɔ ɹ s
conculture	k ɑ n k ʌ l t͡ʃ ə
condemned	k ə n d ɛ m d
condition	k ə n d ɪ ʃ ə n
condo	k ɑ n d o ʊ
conducted	k ə n d ʌ k t ɪ d
conducting	k ə n d ʌ k t ɪ ŋ
confabulate	k ə n f æ b j ʊ l e ɪ t
confederacy	k ə n f ɛ d ə ɹ ə s i
confidable	k ə n f a ɪ d ə b ə l
confident	k ɑ n f ɪ d ə n t
confidently	k ɑ n f ɪ d ə n t l i
confiding	k ə n f a ɪ d ɪ ŋ
confined	k ə n f a ɪ n d
confirmed	k ə n f ɝ m d
conflagrant	k ɔ n f l e ɪ ɡ ɹ ə n t
conformance	k ə n f ɔ m ə n s
confronted	k ə n f ɹ ʌ n t ɪ d
congelifraction	k ə n d͡ʒ ɛ l ɪ f ɹ æ k ʃ ə n
congo	k ɑ ŋ ɡ o ʊ
congregationalist	k ɑ ŋ ɡ ɹ ə ɡ e ɪ ʃ ə n ə l ɪ s t
conjecture	k ə n d͡ʒ ɛ k t͡ʃ ɚ
conjunction	k ə n d͡ʒ ʌ ŋ k ʃ ə n
conjunctions	k ə n d͡ʒ ʌ ŋ k ʃ ə n s
conjure	k ɑ n d͡ʒ ə ɹ
conker	k ɔ ŋ k ə
connel	k ɔ n ə l
connemara	k ɑ n ə m ɑ ɹ ə
connive	k ə n a ɪ v
conquered	k ɑ ŋ k ɚ d
conscious	k ɑ n ʃ ə s
conscript	k ɔ n s k ɹ ɪ p t
consecution	k ɔ n s ɪ k j u ʃ ə n
conservatory	k ə n s ɝ v ə t ɔ ɹ i
considerably	k ə n s ɪ d ə ɹ ə b l i
considerate	k ə n s ɪ d ə ɹ ə t
consist	k ə n s ɪ s t
consisting	k ə n s ɪ s t ɪ ŋ
conspersion	k ə n s p ɜ ɹ ʒ ə n
conspirator	k ə n s p ɪ ɹ ə t ɚ
conspiratorial	k ə n s p ɪ ɹ ə t ɔ ɹ ɪ ə l
construal	k ə n s t ɹ u ə l
constructive	k ə n s t ɹ ʌ k t ɪ v
contain	k ə n t e ɪ n
contains	k ə n t e ɪ n z
contaminate	k ə n t æ m ɪ n e ɪ t
contemper	k ə n t ɛ m p ə ɹ
contempt	k ə n t ɛ m p t
contemptive	k ə n t ɛ m p t ɪ v
contemptuous	k ə n t ɛ m p t͡ʃ u ə s
contemptuously	k ə n t ɛ m p t͡ʃ u ə s l i
contender	k ə n t ɛ n d ɚ
contentlessness	k ɑ n t ɛ n t l ɪ s n ɪ s
contentment	k ə n t ɛ n t m ə n t
context	k ɑ n t ɛ k s t
contignation	k ɔ n t ɪ ɡ n e ɪ ʃ ə n
contingency	k ə n t ɪ n d͡ʒ ə n s i
continue	k ə n t ɪ n j u
continued	k ə n t ɪ n j u d
continues	k ə n t ɪ n j u z
continuing	k ə n t ɪ n j u ɪ ŋ
contrabass	k ɑ n t ɹ ə b e ɪ s
contradistinction	k ɔ n t ɹ ə d ɪ s t ɪ ŋ k ʃ n̩
contrary	k ɑ n t ɹ ɛ ɹ i
contretemps	k ɑ n t ɹ ə t ɑ̃
contribution	k ɑ n t ɹ ɪ b j u ʃ ə n
contrived	k ə n t ɹ a ɪ v d
control	k ə n t͡ʃ ɹ o ʊ l
controls	k ə n t͡ʃ ɹ o ʊ l s
convenable	k ə n v i n ə b ə l
convenience	k ə n v i n j ə n s
converb	k ɑ n v ɝ b
converge	k ə n v ɜ d͡ʒ
convex	k ɑ n v ɛ k s
conveyancing	k ə n v e ɪ ə n s ɪ ŋ
conveying	k ə n v e ɪ ɪ ŋ
conveys	k ə n v e ɪ z
convicted	k ə n v ɪ k t ɪ d
conway	k ɔ n w e ɪ
conwy	k ɔ n w i
cooed	k u d
cookery	k ʊ k ə ɹ i
cooking	k ʊ k ɪ ŋ
cool	k u l
coolie	k u l i
cooling	k u l ɪ ŋ
coolth	k u l θ
cooning	k u n ɪ ŋ
coons	k u n z
cooper	k u p ə ɹ
copal	k o ʊ p ə l
copist	k ɔ p ɪ s t
coprecipitation	k o ʊ p ɹ ɪ s ɪ p ɪ t e ɪ ʃ ə n
copse	k ɔ p s
copt	k ɑ p t
copter	k ɑ p t ɚ
copula	k ɑ p j ə l ə
copulative	k ɔ p j ʊ l ə t ɪ v
copyvio	k ɑ p i v a ɪ o ʊ
coral	k ɔ ɹ ə l
corbyn	k ɔ ɹ b ɪ n
cord	k ɔ ɹ d
cordate	k ɔ ɹ d e ɪ t
cordelia	k ɔ ɹ d i l i ə
corf	k ɔ ɹ f
corkage	k ɔ ɹ k ɪ d͡ʒ
cornetto	k ɔ ɹ n ɛ t o ʊ
corpora	k ɔ ɹ p ə ɹ ə
corporation	k ɔ ɹ p ə ɹ e ɪ ʃ ə n
corpulency	k ɔ ɹ p j ʊ l ə n s i
corradiate	k o ʊ ɹ e ɪ d i e ɪ t
corroboree	k ə ɹ ɔ b ə ɹ i
corruptful	k ə ɹ ʌ p t f ə l
corsican	k ɔ ɹ s ə k ə n
cortisone	k ɔ ɹ t ɪ s o ʊ n
coruscant	k ə ɹ ʌ s k ə n t
cory	k ɔ ɹ i
cosmogony	k ɔ z m ɔ ɡ ə n i
cosmopolite	k ɑ z m ɑ p ə l a ɪ t
cossack	k ɑ s æ k
costamere	k ɑ s t ə m ɪ ɹ
costive	k ɑ s t ɪ v
cot	k ɑ t
cothurn	k ɔ θ ə ɹ n
cotton	k ɑ t n̩
coucher	k a ʊ t͡ʃ ə ɹ
couldna	k ʊ d n ə
coulisse	k u l i s
couloir	k u l w ɑ ɹ
counsel	k a ʊ n s ə l
count	k a ʊ n t
countability	k a ʊ n t ə b ɪ l ɪ t i
counteractor	k a ʊ n t ɚ æ k t ɚ
counterplot	k a ʊ n t ɚ p l ɑ t
countless	k a ʊ n t l ə s
countrywide	k ʌ n t ɹ i w a ɪ d
couple	k ʌ p ə l
courageous	k ə ɹ e ɪ d͡ʒ ə s
courtiers	k ɔ ɹ t i ɚ z
courtney	k ɔ ɹ t n i
courtship	k ɔ ɹ t͡ʃ ɪ p
couture	k u t ʊ ɚ
covalent	k o ʊ v e ɪ l ə n t
cove	k o ʊ v
covering	k ʌ v ə ɹ ɪ ŋ
covetous	k ʌ v ə t ə s
cowan	k a ʊ ə n
cowered	k a ʊ ɚ d
cowl	k a ʊ l
cowpony	k a ʊ p o ʊ n i
cpap	s i p æ p
crabbed	k ɹ æ b d
crabby	k ɹ æ b i
crack	k ɹ æ k
cracked	k ɹ æ k t
cracking	k ɹ æ k ɪ ŋ
craft	k ɹ æ f t
cranefly	k ɹ e ɪ n f l a ɪ
craning	k ɹ e ɪ n ɪ ŋ
crank	k ɹ æ ŋ k
crankle	k ɹ æ ŋ k ə l
crappy	k ɹ æ p i
crashings	k ɹ æ ʃ ɪ ŋ z
crasis	k ɹ e ɪ s ɪ s
cratedigger	k ɹ e ɪ t d ɪ ɡ ə ɹ
crater	k ɹ e ɪ t ɚ
craved	k ɹ e ɪ v d
crawl	k ɹ ɔ l
crawling	k ɹ ɔ l ɪ ŋ
craze	k ɹ e ɪ z
crazings	k ɹ e ɪ z ɪ ŋ z
creak	k ɹ i k
creaking	k ɹ i k ɪ ŋ
creaming	k ɹ i m ɪ ŋ
creator	k ɹ i e ɪ t ɚ
credential	k ɹ ɪ d ɛ n ʃ ə l
credible	k ɹ ɛ d ə b l̩
credit	k ɹ ɛ d ɪ t
credulity	k ɹ ɪ d j u l ɪ t i
cree	k ɹ i
creepshot	k ɹ i p ʃ ɔ t
creighton	k ɹ e ɪ t ə n
crenate	k ɹ i n e ɪ t
crenated	k ɹ ɪ n e ɪ t ɪ d
cresset	k ɹ ɛ s ɪ t
cretic	k ɹ i t ɪ k
crevasse	k ɹ ə v æ s
crewmember	k ɹ u m ɛ m b ɚ
cribbage	k ɹ ɪ b ɪ d͡ʒ
crifanac	k ɹ ɪ f æ n æ k
crimean	k ɹ a ɪ m i ə n
crinal	k ɹ ʌ ɪ n ə l
crined	k ɹ ʌ ɪ n d
cringe	k ɹ ɪ n d͡ʒ
cringed	k ɹ ɪ n d͡ʒ d
crises	k ɹ a ɪ s i z
crisp	k ɹ ɪ s p
crispy	k ɹ ɪ s p i
croak	k ɹ o ʊ k
croc	k ɹ ɔ k
crock	k ɹ ɔ k
croesus	k ɹ i s ə s
croft	k ɹ ɔ f t
crogglement	k ɹ ɔ ɡ ə l m ə n t
cronyism	k ɹ o ʊ n i ɪ z ə m
crooks	k ɹ ʊ k s
croon	k ɹ u n
crooned	k ɹ u n d
crooning	k ɹ u n ɪ ŋ
croquette	k ɹ o ʊ k ɛ t
crossed	k ɹ ɔ s t
crossing	k ɹ ɔ s ɪ ŋ
crowbar	k ɹ o ʊ b ɑ ɹ
crowd	k ɹ a ʊ d
crowds	k ɹ a ʊ d z
crowings	k ɹ o ʊ ɪ ŋ z
crownings	k ɹ a ʊ n ɪ ŋ z
crownment	k ɹ a ʊ n m ə n t
crowns	k ɹ a ʊ n z
cruces	k ɹ u s i z
crucifixion	k r u s ə f ɪ k ʃ n̩
crude	k ɹ u d
cruel	k ɹ u ə l
cruet	k ɹ u ɪ t
cruft	k ɹ ʌ f t
crumb	k ɹ ʌ m
crunchings	k ɹ ʌ n t͡ʃ ɪ ŋ z
crustaceous	k ɹ ʌ s t e ɪ ʃ ə s
crustings	k ɹ ʌ s t ɪ ŋ z
crustose	k ɹ ʊ s t o ʊ s
cruz	k ɹ u z
crypsis	k ɹ ɪ p s ɪ s
cryptodepression	k ɹ i p t o ʊ d ə p ɹ ɛ ʃ ə n
cryptolect	k ɹ ɪ p t ə l ɛ k t
cryptology	k ɹ ɪ p t ɑ l ə d͡ʒ i
cryptovirus	k ɹ ɪ p t o ʊ v a ɪ ɹ ə s
cryptozoological	k ɹ ɪ p t o ʊ z o ʊ ə l ɔ d͡ʒ ɪ k ə l
crystalline	k ɹ ɪ s t ə l a ɪ n
crystallize	k ɹ ɪ s t ə l a ɪ z
css	s i ɛ s ɛ s
cuban	k j u b ə n
cubbed	k ʌ b d
cubes	k j u b z
cubist	k j u b ɪ s t
cubit	k j u b ɪ t
cudden	k ʌ d ə n
cudgel	k ʌ d͡ʒ ə l
cue	k j u
cues	k j u z
cuff	k ʌ f
cuffee	k ʌ f i
cuju	t s u d͡ʒ u
cully	k ʌ l i
culpability	k ʌ l p ə b ɪ l ə t i
cultivate	k ʌ l t ɪ v e ɪ t
culty	k ʌ l t i
cummerbund	k ʌ m ɚ b ʌ n d
cunty	k ʌ n t i
cup	k ʌ p
curcumin	k ɜ ɹ k j ə m ɪ n
curdle	k ɝ d ə l
curium	k j ʊ ə ɹ i ə m
curmudgeon	k ɚ m ʌ d͡ʒ ə n
curriers	k ʌ ɹ ɪ ə z
cusps	k ʌ s p s
customize	k ʌ s t ə m a ɪ̯ z
custrel	k ʌ s t ɹ ə l
cutaneous	k j u t e ɪ n i ə s
cute	k j u t
cutlery	k ʌ t l ə ɹ i
cutpurse	k ʌ t p ɝ s
cutting	k ʌ t ɪ ŋ
cuttlebone	k ʌ t ə l b o ʊ n
cyanide	s a ɪ ə n a ɪ d
cyber	s a ɪ b ə ɹ
cybernat	s a ɪ b ɚ n æ t
cyc	s a ɪ k
cyclades	s a ɪ k l e ɪ d z
cycle	s a ɪ k ə l
cyclops	s a ɪ k l ɑ p s
cylix	s a ɪ l ɪ k s
cymatic	s a ɪ m æ t ɪ k
cymbalist	s ɪ m b ə l ɪ s t
cynganeddion	k ə ŋ ə n ɛ ð j ə n
cypherpunk	s ʌ ɪ f ə p ʌ ŋ k
cypriot	s ɪ p ɹ i ə t
cytarabine	s a ɪ t æ ɹ ə b i n
cytisine	s ɪ t ə s i n
cytolytic	s a ɪ t ə l ɪ t ɪ k
cytonuclear	s a ɪ t o n u k l i ɚ
cytophosphane	s a ɪ t o ʊ f ɔ s f e ɪ n
cytoplasm	s a ɪ t o ʊ p l æ z ə m
czechia	t͡ʃ ɛ k i ə
czexit	t͡ʃ ɛ k s ɪ t
dabbing	d æ b ɪ ŋ
dabs	d æ b z
daces	d e ɪ s ɪ z
dacia	d e ɪ ʃ ə
dade	d e ɪ d
daesh	d ɑ ɛ ʃ
daffodil	d æ f ə d ɪ l
daft	d æ f t
daftness	d æ f t n ə s
dafuq	d ə f ʌ k
daimyo	d a ɪ m j o ʊ
dalfopristin	d æ l f o ʊ p ɹ ɪ s t ɪ n
dalliance	d æ l i ə n s
dalry	d æ l ɹ a ɪ
dam	d æ m
damaged	d æ m ɪ d͡ʒ d
damaging	d æ m ɪ d͡ʒ ɪ ŋ
dammed	d æ m d
damnable	d æ m n ə b ə l
damsel	d æ m z ə l
damsels	d æ m z ə l z
dan	d æ n
danae	d æ n e ɪ i
dandy	d æ n d i
dangerouser	d e ɪ n d͡ʒ ə ɹ ə s ə ɹ
dardic	d ɑ ɹ d ɪ k
darkly	d ɑ ɹ k l i
darth	d ɑ ɹ θ
dastard	d æ s t ɚ d
dat	d æ t
daubery	d ɔ b ə ɹ i
davao	d ɑ v a ʊ
david	d e ɪ v ɪ d
davis	d e ɪ v ɪ s
dawson	d ɔ s ə n
daybed	d e ɪ b ɛ d
daybook	d e ɪ b ʊ k
daydreamer	d e ɪ d ɹ i m ɚ
daylights	d e ɪ l a ɪ t s
daysack	d e ɪ s æ k
daytime	d e ɪ t a ɪ m
daywork	d e ɪ w ɝ k
dead	d ɛ d
deadlock	d ɛ d l ɑ k
deadly	d ɛ d l i
deadmin	d i æ d m ɪ n
dealing	d i l ɪ ŋ
dear	d ɪ ɹ
dearness	d ɪ ə ɹ n ə s
deaths	d ɛ θ s
debasement	d ɪ b e ɪ s m ə n t
debridement	d e ɪ b ɹ i d m ɑ̃
debunks	d ɪ b ʌ ŋ k s
decadent	d ɛ k ə d ə n t
decede	d ɪ s i d
decedent	d ɪ s i d ə n t
deceiver	d ɪ s i v ɚ
deceivingly	d ɪ s i v ɪ ŋ l i
december	d ɪ s ɛ m b ə ɹ
deck	d ɛ k
decks	d ɛ k s
decock	d i k ɔ k
decompose	d i k ə m p o ʊ z
decor	d ɪ k ɔ ɹ
decrial	d ɪ k ɹ a ɪ ə l
decussate	d ɪ k ʌ s e ɪ t
deed	d i d
deem	d i m
deemed	d i m d
defamation	d ɛ f ə m e ɪ ʃ ə n
defectible	d ɪ f ɛ k t ɪ b ə l
defiatory	d ə f a ɪ ə t ɔ ɹ i
defile	d ɪ f a ɪ l
deflection	d ə f l ɛ k ʃ ə n
degen	d e ɪ ɡ ə n
degloving	d i ɡ l ʌ v ɪ ŋ
deglutition	d i ɡ l u t ɪ ʃ ə n
degree	d ɪ ɡ ɹ i
dehiscence	d ɪ h ɪ s ə n s
deianira	d i ə n a ɪ ɹ ə
deicer	d i a ɪ s ɚ
deictic	d a ɪ k t ɪ k
deirdre	d ɪ ɹ d ɹ ə
delayed	d ə l e ɪ d
delead	d i l ɛ d
deletion	d ɪ l i ʃ ə n
delictuous	d ə l ɪ k t͡ʃ u ə s
deliquate	d ɛ l ɪ k w e ɪ t
deluded	d ɪ l u d ɪ d
delvings	d ɛ l v ɪ ŋ z
deme	d i m
demeanor	d ɪ m i n ɚ
dementia	d ɪ m ɛ n ʃ ə
demise	d ɪ m a ɪ z
demisexuality	d ɛ m i s ɛ k ʃ u æ l i t i
demission	d ə m ɪ ʃ ə n
demiurgic	d ɛ m i ɝ d͡ʒ ɪ k
democracy	d ɪ m ɑ k ɹ ə s i
denisovan	d i n i s ə v ə n
denize	d ɪ n a ɪ z
denotate	d ɛ n o ʊ t e ɪ t
denouement	d e ɪ n u m ɑ̃
densely	d ɛ n s l i
density	d ɛ n s ə t i
dent	d ɛ n t
dental	d ɛ n t l̩
dentiparous	d ɛ n t ɪ p ə ɹ ə s
dentiroster	d ɛ n t ə ɹ ɑ s t ə ɹ
deontic	d i ɔ n t ɪ k
departed	d ɪ p ɑ ɹ t ɪ d
department	d ə p ɑ ɹ t m ə n t
dephasing	d i f e ɪ z ɪ ŋ
depict	d ɪ p ɪ k t
depletion	d ɪ p l i ʃ ə n
deplore	d ɪ p l ɔ ɹ
depolarize	d i p o ʊ l ə ɹ a ɪ z
depolymerize	d i p ɔ l ɪ m ə ɹ a ɪ z
depository	d ɪ p ɑ z ɪ t ɔ ɹ i
depths	d ɛ p θ s
derange	d ɪ ɹ e ɪ n d͡ʒ
deray	d ɪ ɹ e ɪ
derelict	d ɛ ɹ ə l ɪ k t
dereliction	d ɛ ɹ ɪ l ɪ k ʃ ə n
dermatoplastic	d ɝ m æ t ə p l æ s t ɪ k
dermis	d ɝ m ɪ s
dernier	d ɚ n j e ɪ
derwent	d ɜ ɹ w ə n t
descanso	d ɛ s k ɑ n s o ʊ
descendants	d ɪ s ɛ n d ə n t s
descended	d ɪ s ɛ n d ɪ d
desiccation	d ɛ s ɪ k e ɪ ʃ ə n
desideratum	d ə s ɪ d ə ɹ ɑ t ə m
desktops	d ɛ s k t ɔ p s
desogestrel	d ɛ s ə d͡ʒ ɛ s t ɹ ə l
desoxycorticosterone	d ɛ z ɑ k s ɪ k ɔ ɹ t ɪ k ɑ s t ə ɹ o ʊ n
despairer	d ɪ s p ɛ ɹ ɚ
despairing	d ɪ s p ɛ ɹ ɪ ŋ
despoil	d ɪ s p ɔ ɪ l
despond	d ɪ s p ɔ n d
despotic	d ɛ s p ɑ t ɪ k
dessiatina	d ɛ s j ə t i n ə
destitutions	d ɛ s t ɪ t u ʃ ə n z
destroying	d ɪ s t ɹ ɔ ɪ j ɪ ŋ
detachment	d ɪ t æ t͡ʃ m ə n t
detained	d i t e j n d
deter	d ɪ t ɜ ɹ
detrect	d ɪ t ɹ ɛ k t
detritus	d ɪ t ɹ a ɪ t ə s
deturb	d ɪ t ɜ ɹ b
developer	d ɪ v ɛ l ə p ɚ
devlin	d ɛ v l ɪ n
dewan	d ə w ɑ n
dewar	d u ə ɹ
dexter	d ɛ k s t ɚ
dexterity	d ɛ k s t ɛ ɹ ɪ t i
dexterous	d ɛ k s t ɹ ə s
dextrin	d ɛ k s t ɹ ɪ n
dhimma	ð ɪ m m a
diachronic	d a ɪ ə k ɹ ɑ n ɪ k
diachrony	d a ɪ æ k ɹ ə n i
diagenesis	d a ɪ ə d͡ʒ ɛ n ə s ɪ s
diagnose	d a ɪ ə ɡ n o ʊ s
dialects	d a ɪ ə l ɛ k t s
dialer	d a ɪ ə l ɚ
dialog	d a ɪ ə l ɑ ɡ
diamine	d a ɪ ə m i n
diana	d a ɪ æ n ə
diapir	d a ɪ ə p ɪ ə ɹ
diasporal	d a ɪ æ s p ə ɹ ə l
diazepam	d a ɪ æ z ə p æ m
diazoxide	d a ɪ ə z ɑ k s a ɪ d
dicacious	d a ɪ k e ɪ ʃ ə s
dice	d a ɪ s
dichotomous	d a ɪ k ɑ t ə m ə s
dicing	d a ɪ s ɪ ŋ
dicings	d a ɪ s ɪ ŋ z
dick	d ɪ k
dickies	d ɪ k i z
dictation	d ɪ k t e ɪ ʃ ə n
dictatorship	d ɪ k t e ɪ t ə ɹ ʃ ɪ p
dideoxycytidine	d a ɪ d i ɑ k s ɪ s ɪ t ɪ d i n
didst	d ɪ d s t
die	d a ɪ
diedre	d ɪ ə d r i
diencephalon	d a ɪ ə n s ɛ f ə l ɔ n
diener	d i n ə ɹ
diet	d a ɪ ə t
difenoxin	d a ɪ f ə n ɑ k s ɪ n
diff	d ɪ f
difficult	d ɪ f ɪ k ə l t
digamma	d a ɪ ɡ æ m ə
digger	d ɪ ɡ ɚ
digital	d ɪ d͡ʒ ɪ t ə ɫ
digne	d a ɪ n
dihydropteroate	d a ɪ h a ɪ d ɹ ɔ p t ɛ ɹ o ʊ e ɪ t
dilettante	d ɪ l ɪ t ɑ n t
dilf	d ɪ l f
dilithium	d a ɪ l ɪ θ ɪ ə m
dill	d ɪ ɫ
dillydally	d ɪ l i d æ l i
diluent	d ɪ l j u ə n t
dime	d a ɪ m
dimication	d ɪ m ɪ k e ɪ ʃ ə n
diming	d a ɪ m ɪ ŋ
dimmer	d ɪ m ə ɹ
dimmest	d ɪ m ɪ s t
dimp	d ɪ m p
dina	d i n ə
dine	d a ɪ n
dingus	d ɪ ŋ ɡ ə s
dink	d ɪ ŋ k
dinna	d ɪ n ə
dioxin	d a ɪ ɑ k s ə n
diphenhydramine	d a ɪ f ɛ n h a ɪ d ɹ ə m i n
diphthongal	d ɪ f θ ɔ ŋ ɡ ə l
dipping	d ɪ p ɪ ŋ
dipshidiot	d ɪ p ʃ ɪ d i ə t
dirempted	d ɪ ɹ ɛ m p t ɪ d
dirigent	d ɪ ɹ ɪ d͡ʒ ə n t
dirigible	d ɪ ɹ ə d͡ʒ ə b ə l
disadvantage	d ɪ s ə d v æ n t ɪ d͡ʒ
disbud	d ɪ s b ʌ d
disburden	d ɪ s b ɜ ɹ d ə n
discard	d ɪ s k ɑ ɹ d
discede	d ɪ s i d
discept	d ɪ s ɛ p t
discerned	d ɪ s ɝ n d
discernible	d ɪ s ɝ n ɪ b l̩
disco	d ɪ s k o ʊ
discoast	d ɪ s k o ʊ s t
discography	d ɪ s k ɑ ɡ ɹ ə f i
discombobulate	d ɪ s k ə m b ɔ b j ə l e ɪ t
disconsolate	d ɪ s k ɑ n s ə l ɪ t
discophilia	d ɪ s k o ʊ f ɪ l j ə
discourage	d ɪ s k ɝ ɪ d͡ʒ
discovering	d ɪ s k ʌ v ə ɹ ɪ ŋ
discursion	d ɪ s k ɝ ʒ ə n
disdain	d ɪ s d e ɪ n
disengage	d ɪ s ɪ ŋ ɡ e ɪ d͡ʒ
disgruntlement	d ɪ s ɡ ɹ ʌ n t ə l m ɪ n t
dishearten	d ɪ s h ɑ ɹ t ə n
disingenuous	d ɪ s ɪ n d͡ʒ ɛ n j u ə s
disingenuously	d ɪ s ɪ n d͡ʒ ɛ n j u ə s l i
disinhibit	d ɪ s ɪ n h ɪ b ɪ t
disintricate	d ɪ s ɪ n t ɹ ɪ k e ɪ t
disinvite	d ɪ s ɪ n v a ɪ t
disjoint	d ɪ s d͡ʒ ɔ ɪ n t
dislike	d ɪ s l a ɪ k
dismay	d ɪ s m e ɪ
dismissed	d ɪ s m ɪ s t
disordered	d ɪ s ɔ ɹ d ɚ d
disorient	d ɪ s ɔ ɹ i ə n t
dispeed	d ɪ s p i d
displace	d ɪ s p l e ɪ s
dispunct	d ɪ s p ʌ ŋ k t
dispute	d ɪ s p j u t
disquisition	d ɪ s k w ə z ɪ ʃ ə n
disrecommend	d ɪ s ɹ ɛ k ə m ɛ n d
disruptive	d ɪ s ɹ ʌ p t ɪ v
dissension	d ɪ s ɛ n ʃ ə n
dissensus	d ɪ s ɛ n s ə s
dissertate	d ɪ s ɚ t e ɪ t
dissever	d ɪ s ɛ v ɚ
dissimilate	d ɪ s ɪ m ɪ l e ɪ t
dissuade	d ɪ s w e ɪ d
distancing	d ɪ s t ə n s ɪ ŋ
distaste	d ɪ s t e ɪ s t
distension	d ɪ s t ɛ n ʃ ə n
distitle	d ɪ s t a ɪ t ə l
distress	d ɪ s t ɹ ɛ s
distribution	d ɪ s t ɹ ə b j u ʃ ə n
disulfiram	d a ɪ s ʌ l f ə ɹ æ m
disunify	d ɪ s j u n ɪ̈ f a ɪ
dit	d ɪ t
ditch	d ɪ t͡ʃ
ditching	d ɪ t͡ʃ ɪ ŋ
dived	d a ɪ̯ v d
diver	d a ɪ̯ v ə ɹ
divertive	d a ɪ v ɜ ɹ t ɪ v
divey	d a ɪ v i
dividual	d ɪ v ɪ d͡ʒ u ə l
diving	d a ɪ v ɪ ŋ
divot	d ɪ v ə t
divulgate	d ɪ v ʌ l ɡ e ɪ t
dizzy	d ɪ z i
djamba	d͡ʒ ɑ m b ə
djinn	d͡ʒ ɪ n
dockize	d ɔ k ɑ ɪ z
docks	d ɔ k s
doctrine	d ɑ k t ɹ ɪ n
dodecahedron	d o ʊ d ɛ k ə h i d ɹ ə n
dodman	d ɑ d m ə n
does	d o ʊ z
doit	d ɔ ɪ t
dolan	d o ʊ l ə n
dolcetto	d o ʊ l t͡ʃ ɛ t o ʊ
dolichophallic	d ɔ l ɪ k o ʊ f æ l ɪ k
dolphinarium	d ɑ l f ɪ n ɛ ɹ i ə m
domestic	d ə m ɛ s t ɪ k
dominant	d ɑ m ə n ə n t
domino	d ɑ m ɪ n o ʊ
dominoes	d ɑ m ɪ n o ʊ z
dominus	d ɔ m ɪ n ə s
domy	d o ʊ m i
donaghadee	d ɔ n ə h ə d i
donations	d o ʊ n e ɪ ʃ ə n z
donbas	d ɔ n b æ s
doof	d u f
doolittle	d u l ɪ t ə l
dooming	d u m ɪ ŋ
doon	d u n
doorframe	d ɔ ɹ f ɹ e ɪ m
dop	d ɔ p
dorcas	d ɔ ɹ k ə s
dortoir	d ɔ ɹ t w ɑ
dortour	d ɔ ɹ t ʊ ə ɹ
dose	d o ʊ s
dosh	d ɔ ʃ
dota	d o ʊ t̬ ə
dothan	d o ʊ θ ə n
dotty	d ɔ t i
doublet	d ʌ b l ə t
doubly	d ʌ b l i
doucet	d u s ɪ t
doug	d ʌ ɡ
dought	d a ʊ t
doves	d ʌ v z
dowd	d a ʊ d
downer	d a ʊ n ɚ
downward	d a ʊ n w ɚ d
dowry	d a ʊ ɹ i
doxepin	d ɑ k s ə p ɪ n
drab	d ɹ æ b
dragged	d ɹ æ ɡ d
dragonfly	d ɹ æ ɡ ə n f l a ɪ
drags	d ɹ æ ɡ z
draids	d ɹ e ɪ d z
dram	d ɹ æ m
drama	d ɹ ɑ m ə
drapery	d ɹ e ɪ p ə ɹ i
drapey	d ɹ e ɪ p i
drawbar	d ɹ ɔ b ɑ ɹ
drawers	d ɹ ɔ ɹ z
drawly	d ɹ ɔ l i
dreaded	d ɹ ɛ d ɪ d
dreadful	d ɹ ɛ d f ʊ l
dreadfully	d ɹ ɛ d f ʊ l i
dreadnought	d ɹ ɛ d n ɔ t
dreamchildren	d ɹ i m t͡ʃ ɪ l d ɹ ə n
dreamer	d ɹ i m ɚ
dreamtime	d ɹ i m t a ɪ m
drearing	d ɹ ɪ ə ɹ ɪ ŋ
dreck	d ɹ ɛ k
dredge	d ɹ ɛ d͡ʒ
dreidel	d ɹ e ɪ d l̩
drenched	d ɹ ɛ n t͡ʃ t
dressed	d ɹ ɛ s t
drey	d ɹ e ɪ
dried	d ɹ a ɪ d
driftingness	d ɹ ɪ f t ɪ ŋ n ə s
droneship	d ɹ o ʊ n ʃ ɪ p
dronings	d ɹ o ʊ n ɪ ŋ z
drool	d ɹ u l
dropmeal	d ɹ ɔ p m i l
drops	d ɹ ɑ p s
droves	d ɹ o ʊ v z
drown	d ɹ a ʊ n
drowning	d ɹ a ʊ n ɪ ŋ
drowses	d ɹ a ʊ z ɪ z
drowsing	d ɹ a ʊ z ɪ ŋ
droylsden	d ɹ ɔ ɪ l z d ə n
drub	d ɹ ʌ b
drudgery	d ɹ ʌ d͡ʒ ə ɹ i
druk	d r ʌ k
drum	d ɹ ʌ m
drummed	d ɹ ʌ m d
drumming	d ɹ ʌ m ɪ ŋ
drygulch	d ɹ a ɪ ɡ ʌ l t͡ʃ
dryth	d ɹ a ɪ θ
dsi	d i ɛ s a ɪ
dubai	d u b a ɪ
dubes	d u b z
dubstep	d ʌ b s t ɛ p
dubya	d ʌ b j ə
duckburg	d ʌ k b ɝ ɡ
ducked	d ʌ k t
duckface	d ʌ k f e ɪ s
ducking	d ʌ k ɪ ŋ
duct	d ʌ k t
dudder	d ʌ d ə ɹ
dude	d u d
dudess	d j u d ɛ s
dudgeon	d ʌ d͡ʒ ə n
dudinka	d u d ɪ n k ə
duds	d ʌ d z
duffy	d ʌ f i
dulse	d ʌ l s
duluth	d ə l u θ
duly	d u l i
dumbfound	d ʌ m f a ʊ n d
dumbledore	d ʌ m b ə l d ɔ ɹ
dumpings	d ʌ m p ɪ ŋ z
dumpling	d ʌ m p l ɪ ŋ
dumpy	d ʌ m p i
dunam	d ʊ n ə m
duncan	d ʌ ŋ k ə n
dune	d u n
dungaree	d ʌ ŋ ɡ ə ɹ i
dungarees	d ʌ ŋ ɡ ə ɹ i z
dungy	d ʌ ŋ i
dunn	d ʌ n
dunny	d ʌ n i
dustee	d ʌ s t i
duster	d ʌ s t ɚ
dutchman	d ʌ t͡ʃ m ə n
duty	d u t i
dweomercraft	d w i m ə ɹː k ɹ æ f t
dying	d a ɪ ɪ ŋ
dyke	d a ɪ k
dynast	d a ɪ n æ s t
dynastic	d a ɪ n æ s t ɪ k
dyscrasia	d ɪ s k ɹ e ɪ z ɪ ə
dyslectic	d ɪ s l ɛ k t ɪ k
dyspraxia	d ɪ s p ɹ æ k s i ə
dyssomnia	d ɪ s s ɔ m n ɪ ə
dystocia	d ɪ s t o ʊ ʃ ə
dystopian	d ɪ s t o ʊ p i ə n
dystrophy	d ɪ s t ɹ ə f i
dyun	dʲ ʊ n
ea	i ə
earing	ɪ ə ɹ ɪ ŋ
ears	ɪ ɹ z
earthen	ə ɹ θ ə n
earthling	ɝ θ l ɪ ŋ
earwig	ɪ ə ɹ w ɪ ɡ
ease	i z
easter	i s t ɚ
eastward	i s t w ɚ d
eat	i t
ebenezer	ɛ b ə n i z ɚ
ebonics	i b ɑ n ɪ k s
ebonite	ɛ b ə n a ɪ t
ecbole	ɛ k b ə l i
echinococcus	ɪ k a ɪ n ə k ɑ k ə s
ecosystem	i k o ʊ s ɪ s t ə m
ecphrastic	ɛ k f ɹ æ s t ɪ k
ecstatic	ɛ k s t æ t ɪ k
ecumenopoleis	ɛ k j u m ɛ n ɔ p ɔ l ɛ ɪ z
edge	ɛ d͡ʒ
edgewise	ɛ d͡ʒ w e ɪ z
edging	ɛ d͡ʒ ɪ ŋ
edgrow	ɛ d ɡ ɹ o ʊ
edict	i d ɪ k t
edified	ɛ d ɪ f a ɪ d
editors	ɛ d ɪ t ɚ z
edom	i d ə m
edro	i d ɹ o ʊ
educator	ɛ d͡ʒ ə k e ɪ t ɚ
educe	ɪ d u s
eek	i k
eep	i p
ees	i z
eff	ɛ f
effected	ɪ f ɛ k t ɪ d
efficacious	ɛ f ɪ k e ɪ ʃ ə s
effierced	ə f ɪ ə ɹ s t
efflagitate	ə f l æ d͡ʒ ɪ t e ɪ t
effloresce	ɛ f l ə ɹ ɛ s
effluvium	ɪ f l u v i ə m
effort	ɛ f ɚ t
effusive	ɪ f j u s ɪ v
efren	ɛ f ɹ ɛ n
egestion	i d͡ʒ ɛ s t͡ʃ ə n
eggar	ɛ ɡ ɚ
eggcorn	ɛ ɡ k ɔ ɹ n
eggless	ɛ ɡ l ə s
eidetic	a ɪ d ɛ t ɪ k
eiffel	a ɪ f l̩
einstein	a ɪ n s t a ɪ n
eish	e ɪ ʃ
eisteddfods	æ ɪ s t ɛ ð f ə d s
elam	i l ə m
elate	ɪ l e ɪ t
elater	ɛ l ə t ɚ
elazar	ɛ l ə z ɑ ɹ
eld	ɛ l d
elderberry	ɛ l d ə ɹ b ɛ ɹ i
eldest	ɛ l d ɪ s t
elector	ə l ɛ k t ɚ
electrolyte	i l ɛ k t ɹ ɵ l a ɪ t
electrovore	ɪ l ɛ k t ɹ ə v ɔ ɹ
electrum	ɪ l ɛ k t ɹ ə m
elench	ɪ l ɛ ŋ k
elephantiasis	ɛ l ɪ f ə n t a ɪ ə s ɪ s
eleventy	ɪ l ɛ v ə n t i
eli	i l a ɪ
elide	ɪ l a ɪ d
eliminate	ɪ l ɪ m ə n e ɪ t
elixir	ɪ l ɪ k s ə ɹ
elk	ɛ l k
ellipses	ɪ l ɪ p s i z
ellipsis	ɪ l ɪ p s ɪ s
elmer	ɛ l m ɚ
elocution	ɛ l ə k j u ʃ ə n
elongate	ɪ l ɔ ŋ ɡ e ɪ t
elsewhere	ɛ l s w ɛ ɹ
elven	ɛ l v ə n
elver	ɛ l v ə ɹ
elytron	ɛ l ɪ t ɹ ɔ n
emancipation	i m æ n s i p e ɪ ʃ n
embargo	ɪ m b ɑ ɹ ɡ o ʊ
embarrass	ɪ m b æ ɹ ə s
embarrassing	ɪ m b æ ɹ ə s ɪ ŋ
embassy	ɛ m b ə s i
embellish	ɪ m b ɛ l ɪ ʃ
ember	ɛ m b ɚ
embetter	ɪ m b ɛ t ə ɹ
emblematical	ɛ m b l ə m æ t ɪ k ə l
embonpoint	ɑ̃ b ɔ̃ p w ɛ̃
embow	ɪ m b o ʊ
embroidery	ɪ m b ɹ ɔ ɪ d ə ɹ i
embryectomy	ɛ m b ɹ i ɛ k t ə m i
ememe	ɛ m i m
emerited	ɪ m ɛ ɹ ɪ t ɪ d
emery	ɛ m ə ɹ i
emicant	ɛ m ɪ k ə n t
eminency	ɛ m ɪ n ə n s i
emmet	ɛ m ɪ t
emporium	ɛ m p ɔ ɹ i ə m
empty	ɛ m p t i
emule	ɪ m j u l
en	ɛ n
enactor	ɪ n æ k t ɚ
enalapril	ɪ n æ l ə p ɹ ɪ l
enamored	ɪ n æ m ə ɹ d
enaunter	ɪ n ɔ n t ə ɹ
enceladus	ɛ n s ɛ l ə d ə s
enchilada	ɛ n t͡ʃ ɪ l ɑ d ə
encierro	ɛ n s i ɛ ɹ o ʊ
enclose	ɪ n k l o ʊ z
encoding	ɪ n k o ʊ d ɪ ŋ
encolure	ɑ ŋ k ə l ʊ ə ɹ
encomion	ɛ ŋ k o ʊ m i ə n
encyclopedia	ɪ n s a ɪ k l ə p i d i ə
encyclopediae	ɪ n s a ɪ k l ə p i d i a ɪ
endeavouring	ɪ n d ɛ v ə ɹ ɪ ŋ
endo	ɛ n d o ʊ
endometrioma	e n d ə m i t ɹ i o ʊ m ə
endothelin	ɛ n d o ʊ θ i l ɪ n
endure	ɪ n d j ʊ ɹ
endymion	ɛ n d ɪ m i ə n
enfilade	ɛ n f ə l e ɪ d
enforce	ɪ n f ɔ ɹ s
engineering	ɛ n d͡ʒ ɪ n ɪ ə ɹ ɪ ŋ
engineers	ɛ n d͡ʒ ɪ n ɪ ɹ z
enginery	ɛ n d͡ʒ ɪ n ɹ i
enginous	ɛ n d͡ʒ ɪ n ə s
engraved	ɪ n ɡ ɹ e ɪ v d
engrossment	ɛ n ɡ ɹ o ʊ s m ə n t
enigmatist	ɛ n ɪ ɡ m æ t ɪ s t
enjoyment	ɛ n d͡ʒ ɔ ɪ m ə n t
enlarge	ɪ n l ɑ ɹ d͡ʒ
enquire	ɪ ŋ k w a ɪ ɹ
ensanguine	ɛ n s æ ŋ ɡ w ə n
enside	ɛ n s a ɪ d
ensile	ɛ n s a ɪ ə l
ent	ɛ n t
entailment	ɛ n t e ɪ l m ə n t
entente	ɑ n t ɑ n t
enterocoelic	ɛ n t ə ɹ o ʊ s i l ɪ k
enters	ɛ n t ɚ z
enthusiasm	ɪ n θ j u z ɪ æ z ə m
enthusiast	ɪ n θ ʉ u̯ z i ə s t
enthymeme	ɛ n θ ɪ m i m
entomophily	ɛ n t ə m ɔ f ə l i
entropy	ɛ n t ɹ ə p i
entrust	ɪ n t ɹ ʌ s t
entscheidungsproblem	ɛ n t͡ʃ ʌ ɪ d ʊ ŋ s p ɹ ɔ b l ə m
entwine	ɪ̈ n t w a ɪ n
enumclaw	i n ʌ m k l ɔ
enveloped	ɪ n v ɛ l ə p t
envenom	ɪ n v ɛ n ə m
enyo	i n a ɪ o ʊ
eoan	i o ʊ ə n
eobiont	i o ʊ b a ɪ ɑ n t
eonian	i o ʊ n ɪ ə n
epenthetic	ɛ p ə n θ ɛ t ɪ k
epicede	ɛ p ɪ s i d
epicene	ɛ p ə s i n
epicness	ɛ p ɪ k n ə s
epididymal	ɛ p ə d ɪ d ə m ə l
epididymides	ɛ p i d ɪ d ɪ m i d i z
epigenome	ɛ p ɪ d͡ʒ i n o ʊ m
epinephrine	ɛ p ɪ n ɛ f ɹ ɪ n
epiphanes	ɛ p ɪ f ə n i z
epiphenomenal	ɛ p ɪ f ɪ n ɔ m ɪ n ə l
epiphloeum	ɛ p ɪ f l i ə m
epiphyllospermous	ɛ p ɪ f ɪ l ə s p ɜ ɹ m ə s
epiphyte	ɛ p ɪ f ɑ ɪ t
epirubicin	ɛ p ɪ ɹ u b ɪ s n̩
episcopalian	ə p ɪ s k ə p e ɪ l i n̩
epispadias	ɛ p ɪ s p e ɪ d i ə s
epizoodic	ɛ p ɪ z u d ɪ k
eponychium	ɛ p ə n ɪ k i ə m
equable	ɛ k w ə b ə l
equals	i k w ə l z
equilibrate	i k w ɪ l ɪ b ɹ e ɪ t
equivocal	ɪ k w ɪ v ə k ə l
equivoque	ɛ k w ɪ v o ʊ k
eradicate	ɪ ɹ æ d ɪ k e ɪ t
erase	ɪ ɹ e ɪ s
erg	ɝ ɡ
erhu	ɜ h u
erlking	ɜ l k ɪ ŋ
erotica	ɪ ɹ ɔ t ɪ k ə
errhine	ɛ ɹ a ɪ n
errol	ɛ ɹ ə l
ertl	ɜ ɹ t ə l
erudition	ɛ ɹ ʊ d ɪ ʃ ə n
erythromelalgia	ɪ ɹ ɪ θ ɹ ə m ɛ l æ l d͡ʒ ɪ ə
esca	ɛ s k ə
escapade	ɛ s k ə p e ɪ d
eschar	ɛ s k ɑ ɹ
esoterica	ɛ s ɵ t ɛ ɹ ɪ k ə
ess	ɛ s
essent	ɛ s ə n t
essentiate	ɪ s ɛ n ʃ i e ɪ t
establish	ɪ s t æ b l ɪ ʃ
establishing	ɪ s t æ b l ɪ ʃ ɪ ŋ
estivate	ɛ s t ɪ v e ɪ t
estray	ə s t ɹ e ɪ
estriol	ɛ s t ɹ a ɪ ɔ l
estrone	ɛ s t ɹ o ʊ n
esurient	ɪ s ʊ ɹ i ə n t
etendue	e ɪ t ɑ n d u
eterne	ɪ t ɜ ɹ n
ethambutol	ɛ θ æ m b j ə t ɔ l
ethea	i θ ɪ ə
ether	i θ ɚ
ethernet	i θ ə ɹ n ɛ t
ethicist	ɛ θ ɪ s ɪ s t
ethiopian	i θ i o ʊ p i ə n
ethnic	ɛ θ n ɪ k
ethnicon	e θ n ɪ k ɔ n
ethos	i θ o ʊ s
ethosuximide	ɛ θ o ʊ s ʌ k s ɪ m a ɪ d
ethotoin	ɛ θ ə t o ʊ ɪ n
etiological	i t ɪ ə l ɔ d͡ʒ ɪ k ə l
etnean	ɛ t n i ə n
etobicoke	ɛ t o ʊ b ɪ k o ʊ
etravirine	ɛ t ɹ ə v ɪ ɹ i n
etretinate	ɪ t ɹ ɛ t n̩ e ɪ t
etynodiol	ɛ t ɪ n o ʊ d a ɪ ɔ l
eu	i j u
euboea	j u b i ə
eucatastrophe	j u k ə t æ s t ɹ ə f i
eudemonia	j u d ɪ m o ʊ n ɪ ə
eugh	j u
eula	i j u ɛ l e ɪ
eunatremic	j u n ə t ɹ i m ɪ k
eureka	j u ɹ i k ə
europium	j ʊ ə ɹ o ʊ p i ə m
euterpe	j u t ɝ p i
euthanasia	j u θ ə n e ɪ ʒ ə
evacuation	ɪ v æ k j u e ɪ ʃ ə n
evaluate	ɪ̈ v a l j ə w e ɪ t
everywhere	ɛ v ɹ i w ɛ ɹ
evoke	ɪ v o ʊ k
evolocumab	ɛ v ə l ɑ k j ə m æ b
evolutions	ɛ v ə l u ʃ ə n z
exaction	ɪ ɡ z æ k ʃ ə n
exactly	ɪ ɡ z æ k t l i
examen	ɪ ɡ z e ɪ m ə n
excave	ɛ k s k e ɪ v
excellence	ɛ k s ə l ə n s
exception	ə k s ɛ p ʃ ə n
excluded	ɪ k s k l u d ɪ d
excoriation	ɛ k s k ɔ ɹ i e ɪ ʃ ə n
exculpate	ɛ k s k ə l p e ɪ t
excursus	ɪ k s k ɜ s ə s
executant	ɪ ɡ z ɛ k j ʊ t ə n t
exemplary	ɛ ɡ z ɛ m p l ə ɹ i
exfat	ɛ k s f æ t
exhilarate	ɪ ɡ z ɪ l ə ɹ e ɪ t
exility	ɛ k s ɪ l ɪ t i
eximiously	ɛ ɡ z ɪ m ɪ ə s l i
existed	ɪ ɡ z ɪ s t ɪ d
exocytic	ɛ k s o ʊ s a ɪ t ɪ k
exome	ɛ k s o ʊ m
exon	ɛ k s ɑ n
exonerate	ɪ ɡ z ɑ n ə ɹ e ɪ t
expected	ɪ k s p ɛ k t ɪ d
expectorate	ɪ k s p ɛ k t ə ɹ e ɪ t
expediency	ɛ k s p i d ɪ ə n s i
expedition	ɛ k s p ə d ɪ ʃ ə n
experience	ɪ k s p ɪ ɹ i ə n s
explanation	ɛ k s p l ə n e ɪ ʃ ə n
explicable	ɪ k s p l ɪ k ə b ə l
explicit	ɪ k s p l ɪ s ɪ t
exporting	ɪ k s p ɔ ɹ t ɪ ŋ
expressions	ɪ k s p ɹ ɛ ʃ ə n z
exstrophy	ɛ k s t ɹ ə f i
extend	ɛ k s t ɛ n d
extending	ɛ k s t ɛ n d ɪ ŋ
extensive	ɛ k s t ɛ n s ɪ v
extinction	ɪ k s t ɪ ŋ k ʃ ə n
extra	ɛ k s t ɹ ə
extravagance	ɪ k s t ɹ æ v ə ɡ ə n s
extravasation	ɪ k s t ɹ æ v ə s e ɪ ʃ ə n
extremadura	ɛ k s t ɹ ə m ə d ʊ ə ɹ ə
extremities	ɪ k s t ɹ ɛ m ə t i z
extremity	ɪ k s t ɹ ɛ m ə t i
eyeglass	a ɪ ɡ l æ s
fab	f æ b
fabella	f ə b ɛ l ə
fabric	f æ b ɹ ɪ k
fabulist	f æ b j ə l ɪ s t
facer	f e ɪ s ə r
facet	f æ s ɪ t
factious	f æ k ʃ ə s
factor	f æ k t ɚ
facture	f æ k t͡ʃ ə ɹ
faddish	f æ d ɪ ʃ
fade	f e ɪ d
fadedly	f e ɪ d ɪ d l i
faena	f a e n ə
faggotry	f æ ɡ ə t ɹ i
failance	f e ɪ l ə n s
failed	f e ɪ l d
fain	f e ɪ n
fainaigue	f ə n e ɪ ɡ
faineance	f e ɪ n i ə n s
faint	f e ɪ n t
faintest	f e ɪ n t ə s t
fairest	f ɛ ɹ ɪ s t
fairing	f ɛ ɹ ɪ ŋ
faithful	f e ɪ θ f ə l
fajita	f ə h i t ə
faked	f e ɪ k t
faking	f e ɪ k ɪ ŋ
fall	f ɔ l
falling	f ɔ l ɪ ŋ
fallow	f æ l o ʊ
famble	f æ m b ə l
famciclovir	f æ m s a ɪ k l o ʊ v ɪ ɹ
famine	f æ m ɪ n
fan	f æ n
faned	f æ n ɛ d
fanmag	f æ n m æ ɡ
fannish	f æ n ɪ ʃ
fanspeak	f æ n s p i k
fansub	f æ n s ʌ b
fantastic	f æ n t æ s t ɪ k
farce	f ɑ ɹ s
fareham	f ɛ ɹ ə m
farming	f ɑ ɹ m ɪ ŋ
farms	f ɑ ɹ m z
farnworth	f ɑ ɹ n w ə ɹ θ
fasciitis	f æ ʃ i a ɪ t ɪ s
fascinated	f æ s ɪ n e ɪ t ɪ d
fascinating	f æ s ɪ n e ɪ t ɪ ŋ
fascism	f æ ʃ ɪ z ə m
fashion	f æ ʃ ə n
fatal	f e ɪ t ə l
fate	f e ɪ t
fatherhood	f ɑ ð ɚ h ʊ d
fathom	f æ ð ə m
fatso	f æ t s o ʊ
fattish	f æ t ɪ ʃ
faucet	f ɔ s ɪ t
fauci	f a ʊ t͡ʃ i
fauna	f ɔ n ə
fauxtato	f o ʊ t e ɪ t o ʊ
favela	f ə v ɛ l ə
fbi	ɛ f b i a ɪ
feal	f i l
fears	f ɪ ɹ z
feat	f i t
feather	f ɛ ð ɚ
featly	f i t l i
feces	f i s i z
feed	f i d
feedback	f i d b æ k
feeler	f i l ə ɹ
fees	f i z
feint	f e ɪ̯ n t
feist	f a ɪ s t
felch	f ɛ l t͡ʃ
felicitous	f ə l ɪ s ɪ t ə s
fellows	f ɛ l o ʊ z
felt	f ɛ l t
felty	f ɛ l t i
femaleness	f i m e ɪ l n ɪ s
fembot	f ɛ m b ɔ t
femicide	f ɛ m ɪ s a ɪ d
femifascist	f ɛ m ɪ f æ ʃ ɪ s t
feminazi	f ɛ m ɪ n ɑ t s i
femra	f ɛ m ɑ ɹ e ɪ
fenbendazole	f ɛ n b ɛ n d ə z o ʊ l
fence	f ɛ n s
fencer	f ɛ n s ə ɹ
fenowed	f ɛ n o ʊ d
ferine	f ɪ ə ɹ a ɪ n
fermanagh	f ə ɹ m æ n ə
ferocious	f ə ɹ o ʊ ʃ ə s
ferocity	f ə ɹ ɑ s ɪ t i
fertilizer	f ɜ ɹ t ə l a ɪ z ə ɹ
fervent	f ɝ v ə n t
feta	f ɛ t ə
fetal	f i t l̩
fettle	f ɛ t ə l
fetus	f i t ə s
feudalist	f j u d ə l ɪ s t
feverish	f i v ɚ ɪ ʃ
fibrillogenic	f ɪ b ɹ ɪ l o ʊ d͡ʒ ɛ n ɪ k
fiction	f ɪ k ʃ ə n
fictious	f ɪ k ʃ ə s
fictitious	f ɪ k t ɪ ʃ ə s
fidel	f ɪ d e l
fie	f a ɪ
fieldfare	f i l d f ɛ
fiendishly	f i n d ɪ ʃ l i
fiercely	f ɪ ɹ s l i
fiesta	f i ɛ s t ə
fig	f ɪ ɡ
filibuster	f ɪ l ə b ʌ s t ɚ
fill	f ɪ l
fills	f ɪ l z
filly	f ɪ l i
films	f ɪ l m z
fimble	f ɪ m b ə l
finals	f a ɪ n ə l z
findrinny	f ɪ n d ɹ ɪ n i
finest	f a ɪ n ɪ s t
finew	f ɪ n j u
fingers	f ɪ ŋ ɡ ɚ z
finical	f ɪ n ɪ k ə l
fining	f a ɪ n ɪ ŋ
finishings	f ɪ n ɪ ʃ ɪ ŋ z
finn	f ɪ n
finna	f ɪ n n ə
finsta	f ɪ n s t ə
fiqh	f i k
fir	f ɝ
firangi	f ɪ ɹ ʌ ŋ ɡ i
fire	f a ɪ ɚ
fireball	f a ɪ ə ɹ b ɔ l
firelight	f a ɪ ɚ l a ɪ t
fireplug	f a ɪ ə p l ʌ ɡ
firhill	f ɪ ɹ h ɪ l
firmly	f ɝ m l i
firn	f ɪ ɹ n
fishbait	f ɪ ʃ b e ɪ t
fished	f ɪ ʃ t
fisherman	f ɪ ʃ ɚ m ə n
fishhead	f ɪ ʃ h ɛ d
fissiparous	f ɪ s ɪ p ə ɹ ə s
fistfight	f ɪ s t f a ɪ t
fit	f ɪ t
fitted	f ɪ t ə d
fitzgerald	f ɪ t s d͡ʒ ɛ ɹ ə l d
fitzpatrick	f ɪ t s p æ t ɹ ɪ k
five	f a ɪ v
fixture	f ɪ k s t͡ʃ ɚ
fizz	f ɪ z
fizzing	f ɪ z ɪ ŋ
fizzle	f ɪ z ə l
fjeld	f j ɛ l d
flab	f l æ b
flabbergasted	f l æ b ɚ ɡ æ s t ə d
flabellum	f l ə b ɛ l ə m
flaccider	f l æ s ɪ d ɚ
flagged	f l æ ɡ d
flags	f l æ ɡ z
flagstone	f l æ ɡ s t o ʊ n
flaked	f l e ɪ k t
flaking	f l e ɪ k ɪ ŋ
flakings	f l e ɪ k ɪ ŋ z
flamelet	f l e ɪ m l ə t
flames	f l e ɪ m z
flamings	f l e ɪ m ɪ ŋ z
flanders	f l æ n d ɚ z
flapjack	f l æ p d͡ʒ æ k
flapper	f l æ p ɚ
flare	f l ɛ ɚ̯
flatpick	f l æ t p ɪ k
flattering	f l æ t ə ɹ ɪ ŋ
flatting	f l æ t ɪ ŋ
flaubertian	f l o ʊ b ɝ t i ə n
flea	f l i
fleabane	f l i b e ɪ n
fleamy	f l i m i
flecked	f l ɛ k t
fledged	f l ɛ d͡ʒ d
flees	f l i z
flew	f l u
flexuous	f l ɛ k ʃ ə w ə s
flic	f l ɪ k
flicked	f l ɪ k t
flight	f l a ɪ t
flights	f l a ɪ t s
flimsy	f l ɪ m z i
flipper	f l ɪ p ɚ
flipperling	f l ɪ p ɚ l ɪ ŋ
flirtatious	f l ɚ t e ɪ ʃ ə s
flitwick	f l ɪ t ɪ k
fliver	f l ɪ v ɚ
flivver	f l ɪ v ɚ
float	f l o ʊ t
floated	f l o ʊ t ɪ d
floods	f l ʌ d z
flooey	f l u i
floral	f l ɔ ɹ ə l
florist	f l ɔ ɹ ɪ s t
flote	f l o ʊ t
flotilla	f l o ʊ t ɪ l ə
flounce	f l a ʊ n s
flouncy	f l a ʊ n s i
flouted	f l a ʊ t ɪ d
flouting	f l a ʊ t ɪ ŋ
flowerpot	f l a ʊ ɚ p ɑ t
flowers	f l a ʊ ɚ z
flowtop	f l o ʊ t ɑ p
floyd	f l ɔ ɪ d
flucytosine	f l u s a ɪ t ə s i n
flues	f l u z
fluminous	f l u m ɪ n ə s
flung	f l ʌ ŋ
fluorescence	f l ʊ ɹ ɛ s ə n s
fluorophilic	f l ɔ ɹ ə f ɪ l ɪ k
flus	f l u z
flushing	f l ʌ ʃ ɪ ŋ
fluster	f l ʌ s t ə
flyblown	f l a ɪ b l o ʊ n
flye	f l a ɪ
foetus	f i t ə s
foiling	f ɔ ɪ l ɪ ŋ
foison	f ɔ ɪ z ə n
fold	f o ʊ l d
foley	f o ʊ l i
folk	f o ʊ k
followed	f ɑ l o ʊ d
follows	f ɑ l o ʊ z
fomentation	f o ʊ m ə n t e ɪ ʃ ə n
fomivirsen	f o ʊ m ɪ v ɪ ɹ s ə n
fondue	f ɑ n d u
foodful	f u d f ə l
fool	f u l
fooled	f u l d
foolery	f u l ə ɹ i
foolishly	f u l ɪ ʃ l i
foolproof	f u l p ɹ u f
football	f ʊ t b ɔ l
footprint	f ʊ t p ɹ ɪ n t
footsies	f ʊ t s i z
footy	f ʊ t i
forage	f ɔ ɹ ɪ d͡ʒ
foramina	f ə ɹ æ m ɪ n ə
forbid	f ɚ b ɪ d
forbidden	f ɝ b ɪ d ə n
forcibly	f ɔ s ə b l i
forcing	f ɔ ɹ s ɪ ŋ
ford	f ɔ ɹ d
fordham	f ɔ ɹ d h ə m
fordyce	f ɔ ɹ d a ɪ s
forecast	f ɔ ɹ k æ s t
foreigner	f ɔ ɹ ɪ n ɚ
foreigners	f ɔ ɹ ɪ n ɚ z
foreignness	f ɔ ɹ ə n n ə s
forensics	f ə ɹ ɛ n z ɪ k s
foresaw	f ɔ ɹ s ɔ
foresay	f ɔ ɹ s e ɪ
foresee	f ɔ ɹ s i
foretell	f ɔ ɹ t ɛ l
forevermore	f ɔ ɹ ɛ v ɚ m ɔ ɹ
forfeit	f ɔ ɹ f ɪ t
forgery	f ɔ ɹ d͡ʒ ə ɹ ɪ
formalist	f ɔ ɹ m l̩ ɪ s t
formats	f ɔ ɹ m æ t s
formatting	f ɔ ɹ m æ t i ŋ
former	f ɔ ɹ m ɚ
formestane	f ɔ ɹ m ɛ s t e ɪ n
forming	f ɔ ɹ m ɪ ŋ
formless	f ɔ m l ə s
forsake	f ɔ ɹ s e ɪ k
forsook	f ɔ ɹ s ʊ k
forspeak	f ɔ ɹ s p i k
forthcoming	f ɔ ɹ θ k ʌ m ɪ ŋ
fortunately	f ɔ ɹ t͡ʃ ə n ɪ t l i
foscarnet	f ɑ s k ɑ ɹ n ɪ t
fosse	f ɔ s
fossor	f ɔ s ə ɹ
foul	f a ʊ l
foulard	f u l ɑ ɹ d
foulings	f a ʊ l ɪ ŋ z
found	f a ʊ n d
foundations	f a ʊ n d e ɪ ʃ ə n z
founded	f a ʊ n d ɪ d
foundry	f a ʊ n d ɹ i
fourteenth	f ɔ ɹ t i n θ
fowl	f a ʊ l
fowlings	f a ʊ l ɪ ŋ z
fowls	f a ʊ l z
fract	f ɹ æ k t
fragging	f ɹ æ ɡ ɪ ŋ
framework	f ɹ e ɪ m w ɝ k
franc	f ɹ æ ŋ k
francium	f ɹ æ n s i ə m
frangible	f ɹ æ n d͡ʒ ə b ə l
frank	f ɹ æ ŋ k
frankness	f ɹ æ ŋ k n ɛ s
frappe	f ɹ æ p
frau	f ɹ a ʊ
fraud	f ɹ ɔ d
frays	f ɹ e ɪ z
freaks	f ɹ i k s
freash	f ɹ ɛ ʃ
freck	f ɹ ɛ k
freckle	f ɹ ɛ k ə l
fred	f ɹ ɛ d
free	f ɹ i
freebie	f ɹ i b i
freebooter	f ɹ i b u t ə ɹ
freedive	f r i d a ɪ v
freedomite	f ɹ i d ə m a ɪ t
freelance	f ɹ i l æ n s
frees	f ɹ i z
freester	f ɹ i s t ɚ
freight	f ɹ e ɪ t
freighted	f ɹ e ɪ t ɪ d
freighting	f ɹ e ɪ t ɪ ŋ
fremd	f ɹ ɛ m d
frenchified	f ɹ ɛ n t͡ʃ ɪ f a ɪ d
frenchify	f ɹ ɛ n t͡ʃ ɪ f a ɪ
frenulum	f r ɛ n j ə l ə m
frenzy	f ɹ ɛ n z i
fresco	f ɹ ɛ s k o ʊ
freshes	f ɹ ɛ ʃ ɪ z
fret	f ɹ ɛ t
frets	f ɹ ɛ t s
fretted	f ɹ ɛ t ɪ d
freud	f ɹ ɔ ɪ d
freudian	f ɹ ɔ ɪ d i ə n
fribble	f ɹ ɪ b ə l
fried	f ɹ a ɪ d
frigorific	f ɹ ɪ ɡ ə ɹ ɪ f ɪ k
frilled	f ɹ ɪ l d
frindle	f ɹ ɪ n d ə l
frisbee	f ɹ ɪ z b i
friskings	f ɹ ɪ s k ɪ ŋ z
frith	f ɹ ɪ θ
frittata	f ɹ i t ɑ t ə
fritter	f ɹ ɪ t ɚ
fritz	f ɹ ɪ t s
frizzle	f ɹ ɪ z ə l
froe	f ɹ o ʊ
frontispiece	f ɹ ʌ n t ɪ s p i s
frontlet	f ɹ ʌ n t l ə t
frosh	f ɹ ɔ ʃ
froth	f ɹ ɔ θ
frown	f ɹ a ʊ n
frownless	f ɹ a ʊ n l ə s
frowny	f ɹ a ʊ n i
froze	f ɹ o ʊ z
fruiterer	f ɹ u t ə ɹ ə
frump	f ɹ ʌ m p
frustrate	f ɹ ʌ s t ɹ e ɪ t
fry	f ɹ a ɪ
frying	f ɹ a ɪ ɪ ŋ
fubar	f u b ɑ ɹ
fuchsia	f j u ʃ ə
fuddle	f ʌ d ə l
fugu	f u ɡ u
fujimycin	f u d͡ʒ ɪ m a ɪ s ɪ n
fullness	f ʊ l n ə s
fulvid	f ʌ l v ɪ d
fumble	f ʌ m b ə l
funalicious	f ʌ n ə l ɪ ʃ ə s
funambulist	f j u n æ m b j ʊ l ɪ s t
functions	f ʌ ŋ k ʃ ə n z
funded	f ʌ n d ɪ d
funeral	f j u n ə ɹ ə l
funerary	f j u n ə ɹ i
fungal	f ʌ ŋ ɡ ə l
funnier	f ʌ n i ɚ
funny	f ʌ n i
furcate	f ɝ k e ɪ t
furiously	f j ʊ ə̯ ɹ i ə̯ s l i
furshlugginer	f ə ʃ l ʌ ɡ ɪ n ə
further	f ɜ ɹ ð ə ɹ
furtherance	f ɜ ɹ ð ə ɹ ə n s
fury	f j ʊ ɹ i
fussbutton	f ʌ s b ʌ t n̩
fuster	f ʌ s t ɚ
fustilarian	f ʌ s t ɪ l æ ɹ ɪ ə n
futureness	f j u t͡ʃ ɚ n ə s
fuze	f j u z
fuzed	f j u z d
fuzz	f ʌ z
fuzzy	f ʌ z i
fyrom	f ɪ ɹ ə m
gab	ɡ æ b
gabby	ɡ æ b i
gabe	ɡ e ɪ b
gabfest	ɡ æ b f ɛ s t
gad	ɡ æ d
gadget	ɡ æ d͡ʒ ɪ t
gaffsail	ɡ æ f s e ɪ l
gagauz	ɡ æ ɡ ɑ u z
gaggings	ɡ æ ɡ ɪ ŋ z
gaillardia	ɡ e ɪ l ɑ ɹ d ɪ ə
galanga	ɡ ə l æ ŋ ɡ ə
galena	ɡ ə l i n ə
gallicchio	ɡ ə l i k i o ʊ
gallize	ɡ æ l a ɪ z
galyak	ɡ æ l j æ k
gambo	ɡ æ m b o ʊ
gameplay	ɡ e ɪ m p l e ɪ
gandhi	ɡ a n d i
ganglia	ɡ æ ŋ ɡ l i ə
ganglion	ɡ æ ŋ ɡ l i ə n
ganguro	ɡ ɑ n ɡ u ɹ o ʊ
gaokao	ɡ a ʊ k a ʊ
gaol	d͡ʒ e ɪ l
gap	ɡ æ p
gapless	ɡ æ p l ə s
gapping	ɡ æ p ɪ ŋ
garden	ɡ ɑ ɹ d ə n
gargoyle	ɡ ɑ ɹ ɡ ɔ ɪ l
garrett	ɡ ɛ ɹ ɪ t
garter	ɡ ɑ ɹ t ɚ
gasbag	ɡ æ s b æ ɡ
gascon	ɡ æ s k ə n
gasohol	ɡ æ s ə h ɑ l
gasometer	ɡ æ s ɑ m ɪ t ɚ
gast	ɡ æ s t
gastricity	ɡ æ s t ɹ ɪ s ɪ t i
gastrosophy	ɡ æ s t ɹ ɔ s ə f ɪ
gat	ɡ æ t
gather	ɡ æ ð ɚ
gau	ɡ a ʊ
gaucherie	ɡ o ʊ ʃ ə ɹ i
gaudery	ɡ ɔ d ə ɹ i
gauge	ɡ e ɪ d͡ʒ
gaunt	ɡ ɔ n t
gav	ɡ æ v
gavin	ɡ æ v ɪ n
gawf	ɡ ɔ f
gawky	ɡ ɔ k i
gaylord	ɡ e ɪ l ɔ ɹ d
gazed	ɡ e ɪ z d
gazette	ɡ ə z ɛ t
gdp	d͡ʒ i d i p i
gecko	ɡ ɛ k o ʊ
geek	ɡ i k
geekspeak	ɡ i k s p i k
geese	ɡ i s
geisha	ɡ e ɪ ʃ ə
gelastic	d͡ʒ ə l æ s t ɪ k
gelateria	d͡ʒ ə l æ t ə ɹ i ə
gelati	d͡ʒ ə l ɑ t i
gelatinate	d͡ʒ ə l æ t ɪ n e ɪ t
gelato	d͡ʒ ə l ɑ t o ʊ
gelcap	d͡ʒ ɛ l k æ p
gemma	d͡ʒ ɛ m ə
gemstone	d͡ʒ ɛ m s t o ʊ n
gendarmerie	ʒ ɑ n d ɑ ɹ m ə ɹ i
gender	d͡ʒ ɛ n d ɚ
generosity	d͡ʒ ɛ n ə ɹ ɑ s ə t i
generous	d͡ʒ ɛ n ə ɹ ə s
genet	d͡ʒ ɛ n ɪ t
genetical	d͡ʒ ə n ɛ t ɪ k ə l
genghisid	d͡ʒ ɛ ŋ ɡ ɪ s ɪ d
genian	d͡ʒ ə n a ɪ ə n
genistein	d͡ʒ ə n ɪ s t i ɪ n
genitalia	d͡ʒ ɛ n ɪ t e ɪ l i ə
genizot	ɡ ɪ n i z o ʊ t
genocidaire	d͡ʒ ɛ n ə s i d ɛ ɹ
genocide	d͡ʒ ɛ n ə s a ɪ d
gentamicin	d͡ʒ ɛ n t ə m a ɪ s ɪ n
gentle	d͡ʒ ɛ n t l̩
genus	d͡ʒ i n ə s
geodetics	d͡ʒ i o ʊ d ɛ t ɪ k s
geography	d͡ʒ i ɑ ɡ ɹ ə f i
geologic	d͡ʒ i ə l ɑ d͡ʒ ɪ k
georgetown	d͡ʒ ɔ ɹ d͡ʒ t a ʊ n
geospace	d͡ʒ i o ʊ s p e ɪ s
ger	ɡ ɛ ɹ
germ	d͡ʒ ɝ m
germen	d͡ʒ ɝ m ə n
gershengorn	ɡ ɜ ɹ ʃ ə n ɡ ɔ ɹ n
gershon	ɡ ɝ ʃ ɑ n
gerygone	d͡ʒ ə ɹ ɪ ɡ ə n i
gesso	d͡ʒ ɛ s o ʊ
gestant	d͡ʒ ɛ s t ə n t
gesticulate	d͡ʒ ɛ s t ɪ k j ə l e ɪ t
getting	ɡ ɛ t ɪ ŋ
geum	d͡ʒ i ə m
gewgaw	ɡ u ɡ ɔ
gharry	ɡ æ ɹ i
ghosts	ɡ o ʊ s t s
giaour	d͡ʒ a ʊ ə
gibbon	ɡ ɪ b ə n
gibnut	ɡ ɪ b n ʌ t
gild	ɡ ɪ l d
gilded	ɡ ɪ l d ɪ d
giles	d͡ʒ a ɪ l z
gimmicks	ɡ ɪ m ɪ k s
gingerism	d͡ʒ ɪ n d͡ʒ ɚ ɪ z m̩
giraffe	d͡ʒ ə ɹ æ f
girandole	d͡ʒ ɪ ɹ ə n d o ʊ l
girldick	ɡ ɝ l d ɪ k
girlfriend	ɡ ɝ l f ɹ ɛ n d
gizmo	ɡ ɪ z m o ʊ
gladden	ɡ l æ d ə n
gladial	ɡ l e ɪ d ɪ ə l
gladstone	ɡ l æ d s t ə n
glair	ɡ l ɛ ɹ
glammed	ɡ l æ m d
gland	ɡ l æ n d
glassless	ɡ l æ s l ə s
glaur	ɡ l a ʊ ə
gleaming	ɡ l i m ɪ ŋ
gleaning	ɡ l i n ɪ ŋ
gleanings	ɡ l i n ɪ ŋ z
gleason	ɡ l i s ə n
gleet	ɡ l i t
glens	ɡ l ɛ n z
gleyed	ɡ l e ɪ d
glider	ɡ l a ɪ d ɚ
glitazar	ɡ l ɪ t ə z ɑ ɹ
glitten	ɡ l ɪ t n̩
glome	ɡ l o ʊ m
gloomy	ɡ l u m i
gloria	ɡ l ɔ ɹ i ə
gluck	ɡ l ʌ k
glut	ɡ l ʌ t
glutamatergic	ɡ l u t ə m ə t ɝ d͡ʒ ɪ k
glutathione	ɡ l u t ə θ a ɪ o ʊ n
glutose	ɡ l u t o ʊ s
gluttony	ɡ l ʌ t ə n i
glyburide	ɡ l a ɪ b j ə ɹ a ɪ d
gmat	d͡ʒ i m æ t
gnash	n æ ʃ
gnashings	n æ ʃ ɪ ŋ z
gnaw	n ɔ
gnosis	n o ʊ s ɪ s
gnosticism	n ɑ s t ə s ɪ z ə m
go	ɡ o ʊ
goal	ɡ o ʊ l
goathouse	ɡ o ʊ t
gobble	ɡ ɑ b l̩
godalming	ɡ ɔ d ə l m ɪ ŋ
godfrey	ɡ ɑ d f ɹ i
godly	ɡ ɑ d l i
gods	ɡ ɑ d z
gogo	ɡ o ʊ ɡ o ʊ
goldenrod	ɡ o ʊ l d ə n ɹ ɑ d
goldilocks	ɡ o ʊ l d i l ɔ k s
goldurn	ɡ ɔ l d ɜ ɹ n
goliath	ɡ ə l a ɪ ə θ
gonial	ɡ o ʊ n i ə l
gonococcus	ɡ ɔ n ə k ɔ k ə s
goodwill	ɡ ʊ d w ɪ l
goodwin	ɡ ʊ d w ɪ n
gooed	ɡ u d
gooey	ɡ u i
goof	ɡ u f
goolies	ɡ u l i z
goombah	ɡ u m b ɑ
gooseberry	ɡ u s b ɛ ɹ i
gopnik	ɡ o p n ɪ k
gord	ɡ ɔ ɹ d
gordita	ɡ ɔ ɹ d i t ə
gorilla	ɡ ə ɹ ɪ l ə
gork	ɡ ɔ ɹ k
gorse	ɡ ɔ ɹ s
gosha	ɡ o ʊ ʃ ə
gosling	ɡ ɑ z l ɪ ŋ
gossip	ɡ ɑ s ɪ p
gossiping	ɡ ɑ s ɪ p ɪ ŋ
goth	ɡ ɑ θ
gothamite	ɡ ɔ θ ə m a ɪ t
gothic	ɡ ɑ θ ɪ k
goulash	ɡ u l ɑ ʃ
gound	ɡ a ʊ n d
gout	ɡ a ʊ t
governail	ɡ ʌ v ə ɹ n ə l
governess	ɡ ʌ v ɚ n ə s
government	ɡ ʌ v ɚ n m ə n t
governorate	ɡ ʌ v ə ɹ n ə ɹ ə t
gowl	ɡ a ʊ l
gowned	ɡ a ʊ n d
gpt	d͡ʒ i p i t i
grab	ɡ ɹ æ b
grabbings	ɡ ɹ æ b ɪ ŋ z
graceless	ɡ ɹ e ɪ s l ə s
gracias	ɡ ɹ ɑ s i ə s
gracie	ɡ ɹ e ɪ s i
grader	ɡ ɹ e ɪ d ɚ
grady	ɡ ɹ e ɪ d i
graff	ɡ ɹ æ f
graffiti	ɡ ɹ ə f i t i
grain	ɡ ɹ e ɪ n
grammar	ɡ ɹ æ m ɚ
grampian	ɡ ɹ æ m p i ə n
gramscian	ɡ ɹ æ m ʃ ə n
granary	ɡ ɹ æ n ə ɹ i
grand	ɡ ɹ æ n d
grandisonant	ɡ ɹ æ n d ɪ s ə n ə n t
grandmother	ɡ ɹ æ n d m ʌ ð ɚ
granger	ɡ ɹ e ɪ n d͡ʒ ə ɹ
granita	ɡ ɹ ə n i t ə
granite	ɡ ɹ æ n ɪ t
granola	ɡ ɹ ə n o ʊ l ə
grapefruit	ɡ ɹ e ɪ p f ɹ u t
grating	ɡ ɹ e ɪ t ɪ ŋ
graton	ɡ ɹ e ɪ t ə n
gravamen	ɡ ɹ ə v e ɪ m ɛ n
graveyard	ɡ ɹ e ɪ v j ɑ ɹ d
grawlix	ɡ ɹ ɔ l ɪ k s
grayer	ɡ ɹ e ɪ ɚ
grays	ɡ ɹ e ɪ z
great	ɡ ɹ e ɪ t
grecian	ɡ ɹ i ʃ ə n
greeble	ɡ ɹ i b l i
greek	ɡ ɹ i k
greeklish	ɡ ɹ i k l ɪ ʃ
greengage	ɡ ɹ i n ɡ e ɪ d͡ʒ
greening	ɡ ɹ i n ɪ ŋ
greenings	ɡ ɹ i n ɪ ŋ z
greenskin	ɡ ɹ i n s k ɪ n
greeting	ɡ ɹ i t ɪ ŋ
gregorian	ɡ ɹ ɪ ɡ ɔ ɹ i ə n
gremlin	ɡ ɹ ɛ m l ɪ n
grendall	ɡ ɹ ɛ n d ə l
grenoble	ɡ ɹ ə n o ʊ b ə l
gresham	ɡ ɹ ɛ ʃ ə m
gridlocks	ɡ ɹ ɪ d l ɔ k s
griefer	ɡ ɹ i f ɚ
grieved	ɡ ɹ i v d
grievous	ɡ ɹ i v ə s
grift	ɡ ɹ ɪ f t
grilled	ɡ ɹ ɪ l d
grilling	ɡ ɹ ɪ l ɪ ŋ
grim	ɡ ɹ ɪ m
griming	ɡ ɹ a ɪ m ɪ ŋ
grinches	ɡ ɹ ɪ n t͡ʃ ɪ z
grinning	ɡ ɹ ɪ n ɪ ŋ
gripping	ɡ ɹ ɪ p ɪ ŋ
grise	ɡ ɹ i z
grist	ɡ ɹ ɪ s t
groady	ɡ ɹ o ʊ d i
groaning	ɡ ɹ o ʊ n ɪ ŋ
groat	ɡ ɹ o ʊ t
groty	ɡ ɹ o ʊ t i
grouching	ɡ ɹ a ʊ t͡ʃ ɪ ŋ
groundbreaking	ɡ ɹ a ʊ n d b ɹ e ɪ k ɪ ŋ
grounded	ɡ ɹ a ʊ n d ɪ d
grounds	ɡ ɹ a ʊ n d z
groupie	ɡ ɹ u p i
grouse	ɡ ɹ a ʊ s
grover	ɡ ɹ o ʊ v ɚ
growing	ɡ ɹ o ʊ ɪ ŋ
growler	ɡ ɹ a ʊ l ə
growlf	ɡ ɹ a ʊ l f
growth	ɡ ɹ o ʊ θ
grub	ɡ ɹ ʌ b
grubby	ɡ ɹ ʌ b i
grudged	ɡ ɹ ʌ d͡ʒ d
grue	ɡ ɹ u
gruff	ɡ ɹ ʌ f
grumble	ɡ ɹ ʌ m b l̩
grungy	ɡ ɹ ʌ n d͡ʒ i
guard	ɡ ɑ ɹ d
guarded	ɡ ɑ ɹ d ɪ d
guardiancy	ɡ ɑ ɹ d i ə n s i
guerdon	ɡ ɝ d ə n
guile	ɡ a ɪ l
guileless	ɡ a ɪ l l ə s
guiles	ɡ a ɪ l z
guimpe	ɡ ɪ m p
guinevere	ɡ w ɪ n ɪ v ɪ ɹ
guinness	ɡ ɪ n ɪ s
gulches	ɡ ʌ l t͡ʃ ɪ z
gulfy	ɡ ʌ l f i
gulp	ɡ ʌ l p
gum	ɡ ʌ m
gums	ɡ ʌ m z
gunate	ɡ u n e ɪ t
gunite	ɡ ʌ n a ɪ t
gunn	ɡ ʌ n
gunpowder	ɡ ʌ n p a ʊ d ə ɹ
gunship	ɡ ʌ n ʃ ɪ p
gurgle	ɡ ɝ ɡ ə l
gus	ɡ ʌ s
gusla	ɡ ʊ s l ə
gusle	ɡ ʊ s l ə
gutted	ɡ ʌ t ɪ d
guy	ɡ a ɪ
guyed	ɡ a ɪ d
guyu	ɡ u j u
gwent	ɡ w ɛ n t
gwyniad	ɡ w ɪ n i ɑ ɹ d
gyle	ɡ a ɪ l
gynaecomasty	ɡ a ɪ n ɪ k ə m æ s t i
gyno	ɡ a ɪ n o ʊ
gypsum	d͡ʒ ɪ p s ə m
haaf	h ɑ f
habitable	h æ b ɪ t ə b ə l
haboob	h ə b u b
hackles	h æ k ə l z
hacks	h æ k s
hade	h e ɪ d
hades	h e ɪ d i z
hadley	h æ d l i
hadrochemistry	h æ d ɹ o ʊ k ɛ m ɪ s t ɹ i
hafiz	h ɑ f ɪ z
haft	h æ f t
haida	h a ɪ d ə
hailing	h e ɪ l ɪ ŋ
hairy	h ɛ ɹ i
haitch	h e ɪ t͡ʃ
haitian	h e ɪ ʃ ə n
halal	h ə l ɑ l
halewood	h e ɪ l w ʊ d
halfness	h æ f n ə s
hallowed	h æ l o ʊ d
hallucinogen	h ə l u s ɪ n ə d͡ʒ e n
hallucinogenic	h ə l u s ə n ə d͡ʒ e n ɪ k
halpern	h æ l p ə ɹ n
halter	h ɔ l t ɚ
hamstring	h æ m s t ɹ ɪ ŋ
hamulose	h æ m j ʊ l o ʊ z
handiwork	h æ n d i w ɝ k
handle	h æ n d l̩
handprint	h æ n d p ɹ ɪ n t
handsomely	h æ n d s ə m l i
handwavy	h æ n d w e ɪ v i
hangar	h æ ŋ ɚ
hangry	h æ ŋ ɡ ɹ i
hapless	h æ p l ɪ s
haplography	h æ p l ɔ ɡ ɹ ə f i
haptic	h æ p t ɪ k
harden	h ɑ ɹ d n̩
hardened	h ɑ ɹ d n̩ d
harl	h ɑ l
harmonious	h ɑ ɹ m o ʊ n i ə s
harmonize	h ɑ ɹ m ə n a ɪ z
harpist	h ɑ ɹ p ɪ s t
harrage	h æ ɹ ɪ d͡ʒ
haslemere	h e ɪ z ə l m ɪ ə ɹ
haste	h e ɪ s t
hat	h æ t
hate	h e ɪ t
hated	h e ɪ t ɪ d
hath	h æ θ
hatter	h æ t ə ɹ
haudenosaunee	h o ʊ d ə n o ʊ ʃ o ʊ n i
haupt	h a ʊ p t
hauswirth	h a ʊ z w ɝ θ
hauteur	o ʊ t ɝ
hawera	h ɑ w ə ɹ ə
hawes	h ɔ z
hawick	h ɔ ɪ k
hawk	h ɔ k
hayward	h e ɪ w ə ɹ d
haywood	h e ɪ w ʊ d
hazelwood	h e ɪ z ə l w ʊ d
hazmat	h æ z m æ t
headdesk	h ɛ d d ɛ s k
headless	h ɛ d l ə s
headliner	h ɛ d l a ɪ n ɚ
headphone	h e d f o ʊ n
headset	h ɛ d s ɛ t
headwind	h ɛ d w ɪ n d
health	h ɛ l θ
heaps	h i p s
hears	h ɪ ɹ z
hearse	h ɜ ɹ s
hearten	h ɑ t ə n
heartswelling	h ɑ ɹ t s w ɛ l ɪ ŋ
heath	h i θ
heathens	h i ð ə n z
heaty	h i t i
heaume	h o ʊ m
heavenly	h ɛ v ə n l i
heaves	h i v z
heavings	h i v ɪ ŋ z
hebdomadal	h ɛ b d ɔ m ə d ə l
hebrides	h ɛ b ɹ ə d i z
hecatonicosachoron	h ɛ k ə t ɔ n a ɪ k o ʊ s i k o ʊ ɹ ɔ n
hectic	h ɛ k t ɪ k
hecuba	h ɛ k j ʊ b ə
heedless	h i d l ə s
heeling	h i l ɪ ŋ
hefty	h ɛ f t i
height	h a ɪ t
heir	ɛ ɹ
heirdom	ɛ ɹ d ə m
heles	h i l z
helga	h ɛ l ɡ ə
helios	h i l i ɔ s
helix	h i l ɪ k s
hella	h ɛ l ə
hellacious	h ɛ l e ɪ ʃ ə s
hellebore	h ɛ l ɪ b ɔ ɹ
helo	h i l o ʊ
helped	h ɛ l p t
helpless	h ɛ l p l ɪ s
hematocrit	h ɪ m æ t ə k ɹ ɪ t
hemera	h ɛ m ə ɹ ə
hemerology	h ɛ m ə ɹ ɑ l ə d͡ʒ i
hemin	h i m ɪ n
hemorrhage	h ɛ m ə ɹ ɪ d͡ʒ
hence	h ɛ n s
hennepin	h ɛ n ɪ p ɪ n
henpeck	h ɛ n p ɛ k
hentai	h ɛ n t a ɪ
hep	h ɛ p
heparin	h ɛ p ə ɹ ɪ n
heptagon	h ɛ p t ə ɡ ɔ n
heptalemma	h ɛ p t ə l ɛ m ə
herbert	h ɝ b ɚ t
herculaneum	h ɜ ɹ k j ə l e ɪ n i ə m
hereafter	h ɪ ɹ æ f t ɚ
hereby	h ɪ ɹ b a ɪ
heredity	h ə ɹ ɛ ɾ ə ɾ i
heretic	h ɛ ɹ i t ɪ k
heriot	h ɛ ɹ ɪ ə t
herman	h ɝ m ə n
hermeneutics	h ɜ ɹ m ə n j u t ɪ k s
hermit	h ɝ m ɪ t
heroin	h ɛ ɹ o ʊ ɪ n
heron	h ɛ ɹ ə n
hertz	h ɝ t s
hesitating	h ɛ z ɪ t e ɪ t ɪ ŋ
hesperides	h ɛ s p ɛ ɹ ɪ d i z
hesperus	h ɛ s p ə ɹ ə s
hester	h ɛ s t ɚ
hesternal	h ɛ s t ɝ n ə l
heterograph	h ɛ t ə ɹ o ʊ ɡ ɹ æ f
heterophenomenological	h ɛ t ə ɹ o ʊ f ə n ɔ m ɪ n ə l ɔ d͡ʒ ɪ k ə l
heterorganic	h ɛ t ə ɹ ɔ ɹ ɡ æ n ɪ k
hewitt	h j u i t
hexes	h ɛ k s ɪ z
hexings	h ɛ k s ɪ ŋ z
hibakusha	h i b ə k u ʃ ə
hicked	h ɪ k t
hicks	h ɪ k s
hidation	h ɪ d e ɪ ʃ ə n
hides	h a ɪ d z
hiding	h a ɪ d ɪ ŋ
hierarchal	h a ɪ ə ɹ ɑ ɹ k ə l
hierarchic	h a ɪ ɹ ɑ ɹ k ɪ k
hieroglyph	h a ɪ ɹ ə ɡ l ɪ f
hieroglyphic	h a ɪ ɹ ə ɡ l ɪ f ɪ k
higgle	h ɪ ɡ ə l
higham	h a ɪ ə m
higher	h a ɪ ɚ
highfather	h a ɪ f ɑ ð ɚ
hijabi	h ɪ d͡ʒ ɑ b i
hijacker	h a ɪ d͡ʒ æ k ə ɹ
hiked	h a ɪ k t
hikes	h a ɪ k s
hikoi	h i k ɔ ɪ
hilda	h ɪ l d ə
hildebeast	h ɪ l d ə b i s t
hillary	h ɪ l ə ɹ i
hindi	h ɪ n d i
hinduism	h ɪ n d u ɪ z ə m
hinter	h ɪ n t ɚ
hintings	h ɪ n t ɪ ŋ z
hipparchus	h ɪ p ɑ ɹ k ə s
hippie	h ɪ p i
hipshot	h ɪ p ʃ ɔ t
hireling	h a ɪ ɹ l ɪ ŋ
hispanicism	h ɪ s p æ n ɪ s ɪ z m̩
histic	h ɪ s t ɪ k
hitchhike	h ɪ t͡ʃ h a ɪ k
hitching	h ɪ t͡ʃ ɪ ŋ
hitchings	h ɪ t͡ʃ ɪ ŋ z
hithe	h ʌ ɪ ð
hitt	h i t
hivemind	h a ɪ v m a ɪ n d
hives	h a ɪ v z
hmm	h m̩
hmong	h ə m ɑ ŋ
hoard	h ɔ ɹ d
hoarding	h ɔ d ɪ ŋ
hoarse	h ɔ ɹ s
hoed	h o ʊ d
hogan	h o ʊ ɡ ə n
hogo	h o ʊ ɡ o ʊ
hogshead	h ɑ ɡ z h ɛ d
hogwash	h ɔ ɡ w ɔ ʃ
hoisin	h ɔ ɪ s ɪ n
hoist	h ɔ ɪ s t
hoisting	h ɔ ɪ s t ɪ ŋ
hoistings	h ɔ ɪ s t ɪ ŋ z
holds	h o ʊ l d z
holed	h o ʊ l d
holla	h ɑ l ə
hollowing	h ɔ l o ʊ ɪ ŋ
holt	h o ʊ l t
holy	h o ʊ l i
holystone	h o ʊ l i s t o ʊ n
homburg	h ɑ m b ɚ ɡ
homecoming	h o ʊ m k ʌ m ɪ ŋ
homely	h o ʊ m l i
homer	h o ʊ m ə ɹ
homodimer	h o ʊ m o ʊ d a ɪ m ɚ
homogenous	h ə m ɑ d͡ʒ ɪ n ə s
honeyed	h ʌ n i d
honeysuckle	h ʌ n i s ʌ k ə l
honorific	ɑ n ə ɹ ɪ f ɪ k
hoodie	h ʊ d i
hooked	h ʊ k t
hooligan	h u l ɪ ɡ ə n
hoon	h u n
hooptie	h ʊ p t i
hoopty	h ʊ p t i
hooray	h ə ɹ e ɪ
hooscow	h u s k a ʊ
hoosier	h u ʒ ɚ
hooted	h u t ɪ d
hooting	h u t ɪ ŋ
hoots	h u t s
hop	h ɑ p
hopak	h o ʊ p æ k
hopefully	h o ʊ p f ə l i
hopes	h o ʊ p s
horatio	h ə ɹ e ɪ ʃ i o ʊ
horizon	h ə ɹ a ɪ z ə n
hornbill	h ɔ ɹ n b ɪ l
horns	h ɔ ɹ n z
horny	h ɔ ɹ n i
horologion	ɔ ɹ ə l ɔ j ɔ n
horrendous	h ə ɹ ɛ n d ə s
horseheal	h ɔ ɹ s h i l
horsy	h ɔ ɹ s i
hosiery	h o ʊ ʒ ə ɹ i
hospice	h ɑ s p ɪ s
host	h o ʊ s t
hostel	h ɑ s t ə l
hostility	h ɑ s t ɪ l ɪ t i
hound	h a ʊ n d
hounds	h a ʊ n d z
hourglass	a ʊ ə ɡ l ɑ s
houseleek	h a ʊ s l i k
housemother	h ʌ ʊ s m ʌ ð ɚ
houthi	h u θ i
howbeit	h a ʊ b i ɪ t
howling	h a ʊ l ɪ ŋ
howsoever	h a ʊ s o ʊ ɛ v ə ɹ
huanghuali	w ɑ ŋ w ɑ l i
hubble	h ʌ b ə l
hubris	h j u b ɹ ɪ s
hucked	h ʌ k t
huda	h ʊ d ə
hues	h j u z
huffed	h ʌ f t
huffing	h ʌ f ɪ ŋ
hugger	h ʌ ɡ ɚ
huggings	h ʌ ɡ ɪ ŋ z
hulk	h ʌ l k
hulks	h ʌ l k s
hum	h ʌ m
humanity	h j u m æ n ɪ t i
humble	h ʌ m b ə l
humblebrag	h ʌ m b l̩ b ɹ æ ɡ
humbug	h ə m b ə ɡ
humidity	h j u m ɪ d ɪ t i
humped	h ʌ m p t
humping	h ʌ m p ɪ ŋ
humus	h j u m ə s
humvee	h ʌ m v i
hungary	h ʌ ŋ ɡ ə ɹ i
hungry	h ʌ ŋ ɡ ɹ i
hunny	h ʌ n i
hurl	h ɝ l
hurrian	h ʌ ɹ ɪ ə n
husbandry	h ʌ z b ə n d ɹ i
huskings	h ʌ s k ɪ ŋ z
husky	h ʌ s k i
hutchins	h ʌ t͡ʃ ɪ n z
hutt	h ʌ t
huxtable	h ʌ k s t ə b ə l
hydaspes	h a ɪ d æ s p i z
hydraulics	h a ɪ d ɹ ɔ l ɪ k s
hydrofoil	h a ɪ d ɹ o ʊ f ɔ ɪ l
hydrogen	h a ɪ d ɹ ə d͡ʒ ə n
hydropic	h a ɪ d ɹ ɔ p ɪ k
hydroplane	h a ɪ d ɹ o ʊ p l e ɪ n
hydrous	h a ɪ d ɹ ə s
hygrine	h ɪ ɡ ɹ a ɪ n
hylic	h a ɪ l ɪ k
hype	h a ɪ p
hyperbaton	h a ɪ p ɜ b ə t ɔ n
hyperrelativism	h a ɪ p ɚ ɹ ɛ l ə t ɪ v ɪ z m
hypertext	h a ɪ p ə ɹ t ɛ k s t
hypnotize	h ɪ p n ə t a ɪ̯ z
hypoallergenic	h a ɪ p o æ l ɚ d͡ʒ ɛ n ɪ k
hyponatremia	h a ɪ p o ʊ n e ɪ t ɹ i m i ə
hypotrichosis	h a ɪ p o ʊ t ɹ a ɪ k o ʊ s ɪ s
hyrax	h a ɪ ɹ æ k s
hyssop	h ɪ s ə p
hysterokinetic	h ɪ s t ə ɹ o ʊ k ɪ n ɛ t ɪ k
iamblichus	a ɪ æ m b l ɪ k ə s
iatrochemical	a ɪ æ t ɹ o ʊ k ɛ m ɪ k ə l
iatromathematics	a ɪ æ t ɹ o ʊ m æ θ ə m æ t ɪ k s
ibis	a ɪ b ɪ s
icarian	ɪ k ɛ ɹ i ə n
icebreaker	a ɪ s b ɹ e ɪ k ə ɹ
ices	a ɪ s ɪ z
ichnology	ɪ k n ɔ l ə d͡ʒ ɪ
ichthyosis	ɪ k θ ɪ o ʊ s ɪ s
icositetrachoron	a ɪ k o ʊ s i t ɛ t ɹ ə k o ʊ ɹ ɔ n
idarucizumab	a ɪ d ə ɹ u s ɪ z ə m æ b
ide	a ɪ d
idealless	a ɪ d i ə l l ə s
identikit	a ɪ d e n t ə k ɪ t
ideolatry	a ɪ d ɪ ɑ l ə t ɹ i
idiomatic	ɪ d i ə m æ t ɪ k
idiot	ɪ d i j ɪ t
idly	a ɪ d ə l ɪ
idose	a ɪ d o ʊ s
idumea	ɪ d j ʊ m i ə
idyllic	a ɪ d ɪ l ɪ k
iffy	ɪ f i
ifs	ɪ f s
ignatius	ɪ ɡ n e ɪ ʃ ə s
ignifluous	ɪ ɡ n ɪ f l u ə s
ijdb	a i d j e d i b i
ijeoma	ɪ d͡ʒ i o ʊ m ə
ikey	ʌ ɪ k i
ilium	ɪ l i ə m
illabial	ɪ l e ɪ b i ə l
illimitable	ɪ l ɪ m ɪ t ə b ə l
illinoian	ɪ l ə n ɔ ɪ ə n
illogic	ɪ l ɑ d͡ʒ ɪ k
illude	ɪ l u d
illuminating	ɪ l l u m ə n e ɪ t ɪ ŋ
illure	ɪ l ʊ ə ɹ
illustrated	ɪ l ə s t ɹ e ɪ t ɪ d
illyromania	ɪ l ɪ ɹ o ʊ m e ɪ n i ə
ily	ɪ l i
images	ɪ m ɪ d͡ʒ ɪ z
imaginal	ɪ m a d͡ʒ ɪ n ə l
imbar	ɪ m b ɑ ɹ
imitation	ɪ m ɪ t e ɪ ʃ ə n
immane	ɪ m e ɪ n
immeability	ɪ m i ə b ɪ l ɪ t i
immerse	ɪ m ɜ ɹ s
immodest	ɪ m m ɑ d ə s t
immortalize	ɪ m ɔ ɹ t ə l a ɪ z
immortelle	ɪ m ɔ t ɛ l
immune	ɪ m j u n
impale	ɪ m p e ɪ l
impales	ɪ m p e ɪ l z
impatient	ɪ m p e ɪ ʃ ə n t
impede	ɪ m p i d
impel	ɪ m p ɛ l
impelled	ɪ m p ɛ l d
imperative	ɪ m p ɛ ɹ ə t ɪ v
imperfection	ɪ m p ɚ f ɛ k ʃ ə n
imperil	ɪ m p ɛ ɹ ə l
impermissible	ɪ m p ɝ m ɪ s ɪ b l
impersonate	ɪ m p ɜ s ə n e ɪ t
imperturbable	ɪ m p ɚ t ɝ b ə b ə l
impervious	ɪ m p ɝ v i ə s
impings	ɪ m p ɪ ŋ z
implike	ɪ m p l a ɪ k
importune	ɪ m p ɔ ɹ t u n
importunity	ɪ m p ɔ ɹ t u n ɪ t i
impose	ɪ m p o ʊ z
impoverished	ɪ m p ɑ v ə ɹ ɪ ʃ t
imprecate	ɪ m p ɹ ə k e ɪ t
impregnable	ɪ m p ɹ ɛ ɡ n ə b ə l
impriming	ɪ m p ɹ a ɪ m ɪ ŋ
imprint	ɪ m p ɹ ɪ n t
improv	ɪ m p ɹ ɑ v
improvisatrice	ɪ m p ɹ ɔ v ə z ə t ɹ i t͡ʃ i
imprudence	ɪ m p ɹ u d n̩ s
impudent	ɪ m p j ə d ə n t
impulse	ɪ m p ʌ l s
imputation	ɪ m p j ʊ t e ɪ ʃ ə n
impute	ɪ m p j u t
inactivate	ɪ n æ k t ɪ v e ɪ t
inadequate	ɪ n æ d ə k w ɪ t
inapposite	ɪ n æ p ə z ɪ t
inappropro	ɪ n ə p ɹ o ʊ p ɹ o ʊ
inapt	ɪ n æ p t
inasmuch	ɪ n ə z m ʌ t͡ʃ
inattentive	ɪ n ə t ɛ n t ɪ v
inborn	ɪ n b ɔ ɹ n
incapacitation	ɪ n k ə p æ s ɪ t e ɪ ʃ ə n
incautious	ɪ n k ɑ ʃ ə s
inceptive	ɪ n s ɛ p t ɪ v
inching	ɪ n t͡ʃ ɪ ŋ
incide	ɪ n s a ɪ d
incisive	ɪ n s a ɪ s ɪ v
incombustible	ɪ ŋ k ə m b ʌ s t ɪ b ə l
income	ɪ n k ʌ m
incomplete	ɪ n k ə m p l i t
inconditionate	ɪ ŋ k ə n d ɪ ʃ ə n ə t
inconsistency	ɪ n k ə n s ɪ s t ə n s i
incorporeal	ɪ ŋ k ɔ ɹ p ɔ ɹ i ə l
incriminate	ɪ ŋ k ɹ ɪ m ɪ n e ɪ t
incur	ɪ n k ɝ
indatraline	ɪ n d æ t ɹ ə l i n
indebted	ɪ n d ɛ t ɪ d
indecision	ɪ n d ɪ s ɪ ʒ ə n
indefatigable	ɪ n d ə f æ t ə ɡ ə b ə l
indefectible	ɪ n d ɪ f ɛ k t ɪ b ə l
indelible	ɪ n d ɛ l ə b l
indentured	ɪ n d ɛ n t͡ʃ ɚ d
independence	ɪ n d ɪ p ɛ n d ə n s
independentist	ɪ n d ə p ɛ n d ə n t ɪ s t
indeterminate	ɪ n d ɪ t ɜ ɹ m ɪ n ə t
indevotional	ɪ n d ɪ v o ʊ ʃ ə n ə l
indianapolis	ɪ n d i ə n æ p ə l ɪ s
indicate	ɪ n d ɪ k e ɪ t
indicated	ɪ n d ɪ k e ɪ t ɪ d
indice	ɪ n d ɪ s
indict	ɪ n d a ɪ t
indictment	ɪ n d a ɪ t m ə n t
indignant	ɪ n d ɪ ɡ n ə n t
indigo	ɪ n d ɪ ɡ o ʊ
indiscovery	ɪ n d ɪ s k ʌ v ə ɹ i
indissipable	ɪ n d ɪ s ɪ p ə b ə l
individuals	ɪ n d ɪ v ɪ d͡ʒ u ə l z
indominable	ɪ n d ɑ m ɪ n ə b l̩
indonesian	ɪ n d ə n i ʒ ə n
induce	ɪ n d u s
industrials	ɪ n d ʌ s t ɹ ɪ ə l z
industries	ɪ n d ə s t ɹ i z
industrious	ɪ n d ʌ s t ɹ i ə s
inebriated	ɪ n i b ɹ i e ɪ t ɪ d
inelastic	ɪ n ə l æ s t ɪ k
inequality	ɪ n ɪ k w ɔ l ɪ t i
inerrable	ɪ n ɜ ɹ ə b ə l
inerrant	ɪ n ɛ r ə n t
infeasibly	ɪ n f i z ɪ b ə l i
infective	ɪ n f ɛ k t ɪ v
infelt	ɪ n f ɛ l t
infest	ɪ n f ɛ s t
infiltration	ɪ n f ɪ l t ɹ e ɪ ʃ ə n
infiltrationism	ɪ n f ɪ l t ɹ e ɪ ʃ ə n ɪ z m̩
infirm	ɪ n f ɝ m
inflammable	ɪ n f l æ m ə b ə l
infliction	ɪ n f l ɪ k ʃ ə n
informant	ɪ n f ɔ ɹ m ə n t
informatisation	ɪ n f ə ɹ m a t a ɪ z e ɪ ʃ ə n
infra	ɪ n f ɹ ə
infrastructure	ɪ n f ɹ ə s t ɹ ʌ k t͡ʃ ɚ
infringement	ɪ n f ɹ ɪ n d͡ʒ m ə n t
ingenuitive	ɪ n d͡ʒ ə n j u ə t ɪ v
ingrew	ɪ n ɡ r u
ingrown	ɪ n ɡ ɹ o ʊ n
inguinal	ɪ ŋ ɡ w ɪ n ə l
inhabit	ɪ n h æ b ɪ t
inhalation	ɪ n h ə l e ɪ ʃ ə n
inhale	ɪ n h e ɪ l
inheritance	ɪ n h ɛ ɹ ə t ə n s
inhibit	ɪ n h ɪ b ɪ t
inhospitable	ɪ n h ɔ s p ɪ t ə b ə l
inimical	ɪ n ɪ m ɪ k ə l
iniquitous	ɪ n ɪ k w i t ə s
injector	ɪ n d͡ʒ ɛ k t ɚ
injunction	ɪ n d͡ʒ ʌ n k ʃ ə n
injured	ɪ n d͡ʒ ɚ d
inkstick	ɪ ŋ k s t ɪ k
inland	ɪ n l ə n d
innermost	ɪ n ɚ m o ʊ s t
inning	ɪ n ɪ ŋ
innovation	ɪ n ə v e ɪ ʃ ə n
inoculate	ɪ n ɑ k j u l e ɪ t
inoculation	ɪ n ɑ k j ə l e ɪ ʃ ə n
inosculate	ɪ n ɔ s k j ʊ l e ɪ t
inosite	ɪ n ə s a ɪ t
inpat	ɪ n p æ t
inquest	ɪ ŋ k w ɛ s t
inquiration	ɪ ŋ k w ɪ ɹ e ɪ ʃ ə n
inquisition	ɪ ŋ k w ɪ z ɪ ʃ ə n
inroads	ɪ n ɹ o ʊ d z
insalubrious	ɪ n s ə l u b ɹ ɪ ə s
inscription	ɪ n s k ɹ ɪ p ʃ ə n
insects	ɪ n s ɛ k t s
insensitive	ɪ n s ɛ n s ɪ t ɪ v
inset	ɪ n s ɛ t
insider	ɪ n s a ɪ d ɚ
insight	ɪ n s a ɪ t
insightful	ɪ n s a ɪ t f ə l
insisted	ɪ n s ɪ s t ɪ d
insistent	ɪ n s ɪ s t ə n t
insists	ɪ n s ɪ s t s
insolence	ɪ n s ə l ə n s
insolvable	ɪ n s ɔ l v ə b ə l
insomnia	ɪ n s ɔ m n i ə
inspissate	ɪ n s p ɪ s e ɪ t
instances	ɪ n s t ə n s ɪ z
instigator	ɪ n s t ə ɡ e ɪ t ɚ
instinct	ɪ n s t ɪ ŋ k t
instinctively	ɪ n s t ɪ ŋ k t ɪ v l i
instincts	ɪ n s t ɪ ŋ k t s
instow	ɪ n s t o ʊ
instructions	ɪ n s t ɹ ʌ k ʃ ə n z
instructive	ɪ n s t ɹ ʌ k t ɪ v
insulin	ɪ n s ə l ɪ n
insulting	ɪ n s ʌ l t ɪ ŋ
insure	ɪ n ʃ ʊ ɚ
intangible	ɪ n t æ n d͡ʒ ə b ə l
integer	ɪ n t ɪ d͡ʒ ə ɹ
intensely	ɪ n t ɛ n s l i
intension	ɪ n t ɛ n ʃ ə n
intently	ɪ n t ɛ n t l i
interactive	ɪ n t ɚ æ k t ɪ v
intercede	ɪ n t ə ɹ s i d
intercident	ɪ n t ɜ ɹ s ɪ d ə n t
intercrural	ɪ n t ɚ k ɹ u ɹ ə l
interface	ɪ n t ɚ f e ɪ s
interfere	ɪ n t ɚ f ɪ ɹ
interfered	ɪ n t ɚ f ɪ ɹ d
interlanguage	ɪ n t ɜ ɹ l æ ŋ ɡ w ɪ d͡ʒ
intermarry	ɪ n t ə ɹ m æ ɹ i
intermezzo	ɪ n t ɚ m ɛ t s o ʊ
intermittent	ɪ n t ɚ m ɪ t n̩ t
internalize	ɪ n t ɝ n ə l a ɪ z
interocular	ɪ n t ə ɹ ɔ k j ə l ə ɹ
interpolate	ɪ n t ɜ ɹ p ə l e ɪ t
interruption	ɪ n t ə ɹ ʌ p ʃ ə n
intersectional	ɪ n t ə ɹ s ɛ k ʃ ə n l̩
interslavic	ɪ n t ɚ s l ɑ v ɪ k
intertex	ɪ n t ə ɹ t ɛ k s
interventive	ɪ n t ɚ v ɛ n t ə v
interview	ɪ n t ɚ v j u
into	ɪ n t u
intolerable	ɪ n t ɑ l ə ɹ ə b l̩
intolerator	ɪ n t ɔ l ə ɹ ə ɪ t ə ɹ
intrahepatic	ɪ n t ɹ ə h ə p æ t ɪ k
intraordinary	ɪ n t ɹ ə ɔ ɹ d ɪ n ɛ ɹ i
intravital	ɪ n t ɹ ə v a ɪ t l
intromit	ɪ n t ɹ ə m ɪ t
invaders	ɪ n v e ɪ d ə ɹ z
invariably	ɪ n v ɛ ɹ i ə b l i
invasion	ɪ n v e ɪ ʒ ə n
invasive	ɪ n v e ɪ s ɪ v
inventor	ɪ n v ɛ n t ɚ
inverse	ɪ n v ɝ s
investor	ɪ n v ɛ s t ɚ
invitement	ɪ n v a ɪ t m ə n t
inwardly	ɪ n w ɚ d l i
ionic	a ɪ ɔ n ɪ k
iphigenia	ɪ f ɪ d͡ʒ ɪ n a ɪ ə
iphone	a ɪ f o ʊ̯ n
ipsative	ɪ p s ə t ɪ v
ipsedixitism	ɪ p s i d ɪ k s ɪ t ɪ z ə m
iri	a ɪ ɑ ɹ a ɪ
irk	ɝ k
irkutsk	ɪ ɹ k ʊ t s k
irrational	ɪ ɹ æ ʃ ə n ə l
irrawaddy	ɪ ɹ ə w ɑ d i
irredeemable	ɪ ɹ ə d i m ə b ə l
irresponsible	ɪ r ə s p ɑ n s ɪ b ə l
irritated	ɪ ɹ ɪ t e ɪ t ɪ d
irruent	ɪ ɹ ɪ ʊ ə n t
isabella	ɪ z ə b ɛ l ə
isadore	ɪ z ə d ɔ ɹ
isangoma	i s æ ŋ ɡ o ʊ m ə
ischemic	ɪ s k i m ɪ k
ishkabibble	ɪ ʃ k ə b ɪ b ə l
islet	a ɪ l ə t
isogloss	a ɪ s ə ɡ l ɑ s
isolationism	a ɪ s ə l e ɪ ʃ ə n ɪ z ə m
isosceles	a ɪ s ɔ s ə l i z
isotonic	ɑ ɪ s ə t ɑ n ɪ k
isthmus	ɪ s m ə s
italicization	ɪ t æ l ɪ s a ɪ z e ɪ ʃ ə n
ithe	a ɪ ð
ithyphallic	ɪ θ ɪ f æ l ɪ k
itinerant	a ɪ t ɪ n ɚ ə n t
iuka	a ɪ j u k ə
iuliyanov	j u l i ɑ n ɔ v
ivied	a ɪ v i d
ivy	a ɪ v i
ivybridge	a ɪ v i b ɹ ɪ d͡ʒ
iwan	i w ɑ n
iwis	ɪ w ɪ s
ixnay	ɪ k s n e ɪ
izzard	ɪ z ə ɹ d
izzy	ɪ z i
jabbed	d͡ʒ æ b d
jace	d͡ʒ e ɪ s
jack	d͡ʒ æ k
jackboot	d͡ʒ æ k b u t
jackpudding	d͡ʒ æ k p ʊ d ɪ ŋ
jaconet	d͡ʒ æ k ə n ɪ t
jainism	d͡ʒ e ɪ n ɪ z m̩
jake	d͡ʒ e ɪ k
jam	d͡ʒ æ m
jamb	d͡ʒ æ m
james	d͡ʒ e ɪ m z
jameson	d͡ʒ e ɪ m ə s ə n
jamming	d͡ʒ æ m ɪ ŋ
janissary	d͡ʒ æ n ə z e ɹ i
janitor	d͡ʒ æ n ɪ t ɚ
janken	d͡ʒ ɑ ŋ k ɛ n
januaries	d͡ʒ æ n j u ɛ ɹ i z
januarys	d͡ʒ æ n j u ɛ ɹ i z
jasmine	d͡ʒ æ z m ɪ n
jasper	d͡ʒ æ s p ɚ
jawn	d͡ʒ ɔ n
jaws	d͡ʒ ɔ z
jayla	d͡ʒ e ɪ l ə
jaysus	d͡ʒ e ɪ z ə s
jazz	d͡ʒ æ z
jbiebs	d͡ʒ e ɪ b i b s
jedi	d͡ʒ ɛ d a ɪ
jeff	d͡ʒ ɛ f
jenglish	d͡ʒ ɪ ŋ ɡ l ɪ ʃ
jentacular	d͡ʒ ɛ n t æ k j ə l ə ɹ
jerkin	d͡ʒ ɜ ɹ k ɪ n
jerome	d͡ʒ ə ɹ o ʊ m
jesse	d͡ʒ ɛ s i
jestings	d͡ʒ ɛ s t ɪ ŋ z
jesuitic	d͡ʒ ɛ z j u ɪ t ɪ k
jethro	d͡ʒ ɛ θ ɹ o ʊ
jeweler	d͡ʒ u ə l ɚ
jewry	d͡ʒ u ɹ i
jez	d͡ʒ ɛ z
jigs	d͡ʒ ɪ ɡ z
jilin	d͡ʒ i l ɪ n
jilting	d͡ʒ ɪ l t ɪ ŋ
jiltings	d͡ʒ ɪ l t ɪ ŋ z
jingly	d͡ʒ ɪ ŋ ɡ l i
jingoistic	d͡ʒ ɪ ŋ ɡ o ʊ ɪ s t ɪ k
jingpo	d͡ʒ ɪ ŋ p o ʊ
jism	d͡ʒ ɪ z ə m
jodhpurs	d͡ʒ ɑ d p ɚ z
jog	d͡ʒ ɑ ɡ
john	d͡ʒ ɑ n
joinings	d͡ʒ ɔ ɪ n ɪ ŋ z
joking	d͡ʒ o w k ɪ ŋ
jollier	d͡ʒ ɑ l i ɚ
jolliest	d͡ʒ ɑ l i ɪ s t
jollop	d͡ʒ ɔ l ə p
jolt	d͡ʒ o ʊ l t
jonathan	d͡ʒ ɑ n ə θ ə n
josephine	d͡ʒ o ʊ s ə f i n
josh	d͡ʒ ɑ ʃ
jot	d͡ʒ ɑ t
journalistic	d͡ʒ ɜ ɹ n ə l ɪ s t ɪ k
jovial	d͡ʒ o ʊ v ɪ ə l
jovially	d͡ʒ o ʊ v ɪ ə l i
joyous	d͡ʒ ɔ ɪ ə s
jpegged	d͡ʒ e ɪ p ɛ ɡ d
juche	d͡ʒ u t͡ʃ e ɪ
judson	d͡ʒ ʌ d s ə n
jugendstil	j u ɡ ə n t͡ʃ ɪ l
juggler	d͡ʒ ʌ ɡ l̩ ə ɹ
juicer	d͡ʒ u s ɚ
jujitsu	d͡ʒ u d͡ʒ ɪ t s u
juke	d͡ʒ u k
julian	d͡ʒ u l i ə n
jumping	d͡ʒ ʌ m p ɪ ŋ
junction	d͡ʒ ʌ ŋ k ʃ ə n
juneau	d͡ʒ u n o ʊ
juneteenth	d͡ʒ u n t i n θ
junior	d͡ʒ u n j ɚ
junket	d͡ʒ ʌ ŋ k ɪ t
justice	d͡ʒ ʌ s t ɪ s
justified	d͡ʒ ʌ s t ɪ f a ɪ d
jutted	d͡ʒ ʌ t ɪ d
juxtology	d͡ʒ ʌ k s t ɑ l ə d͡ʒ i
jyutping	j u t pʰ ɪ ŋ
kabuki	k ə b u k i
kabyle	k ə b a ɪ l
kafkaesque	k ɑ f k ə ɛ s k
kaiser	k a ɪ z ɚ
kaliningrad	k ə l ɪ n ɪ n ɡ ɹ æ d
kama	k ɑ m ə
kamees	k ə m i z
kangaroo	k a ŋ ɡ ə ɹ u
kangxi	k ɑ ŋ ʃ i
kansas	k æ n z ə s
kanuri	k ə n u r i
kaon	k e ɪ ɑ n
kapuskasing	k æ p ʉ s k e ɪ s ɪ ŋ
karyology	k æ ɹ i ɔ l ə d͡ʒ i
kash	k æ ʃ
kastom	k ɑ s t ɔ m
katabasis	k ə t æ b ə s ɪ s
katahdin	k ə t ɑ d ɪ n
katherine	k æ θ ə ɹ ɪ n
kathmandu	k a t m a n d u
katydid	k e ɪ t i d ɪ d
kayak	k a ɪ æ k
kayfabe	k e ɪ f e ɪ b
kazi	k ɑ z i
kebab	k ɪ b ɑ b
kedgeree	k ɛ d͡ʒ ə ɹ i
keene	k i n
keepsake	k i p s e ɪ k
keet	k i t
keg	k ɛ ɡ
kellia	k ɛ l i ə
kelp	k ɛ l p
kenken	k ɛ n k ɛ n
kenneth	k ɛ n ə θ
kenosis	k ɪ n o ʊ s ɪ s
kenspeckle	k ɛ n s p ɛ k ə l
kepstrum	k ɛ p s t ɹ ə m
kerberos	k ɜ ɹ b ə ɹ ə s
kereru	k ɛ ɹ ə ɹ u
keriorrhea	k ɛ ɹ ɪ ə ɹ i ə
kern	k ɝ n
kers	k ɜ ɹ z
kerygma	k ə ɹ ɪ ɡ m ə
keynote	k i n o ʊ t
keynsham	k e ɪ n ʃ ə m
keypad	k i p æ d
khedive	k ə d i v
khedivial	k ə d ɪ v i ə l
kiang	k i ɑ ŋ
kiasi	k ɪ ɑ̃ s îː
kibbeh	k ɪ b i
kibitz	k ɪ b ɪ t s
kickback	k ɪ k b æ k
kid	k ɪ d
kiddy	k ɪ ɾ i
kids	k ɪ d z
kiki	k i k i
kilogram	k ɪ l ə ɡ ɹ æ m
kilos	k i l o ʊ z
kinds	k a ɪ n d z
kinesthetic	k ɪ n ɪ s θ ɛ t ɪ k
kinetochore	k ə n i ɾ o ʊ k ɔ ɹ
kingsley	k ɪ ŋ z l i
kingsteignton	k ɪ ŋ s t e ɪ n t ə n
kinshasa	k ɪ n ʃ ɑ s ə
kipfel	k ɪ p f ə l
kipling	k ɪ p l ɪ ŋ
kirby	k ɝ b i
kiritimati	k ə ɹ ɪ s m ə s
kirkcudbright	k ɚ k u b ɹ i
kirtle	k ɚ t ə l
kirtled	k ɚ t ə l d
kites	k a ɪ t s
kithe	k ʌ ɪ ð
kithless	k ɪ θ l ɪ s
kitinen	k ɪ t ɪ n ɛ n
kitsch	k ɪ t͡ʃ
kitting	k ɪ t ɪ ŋ
klamath	k l æ m ə θ
klatch	k l æ t͡ʃ
kleenex	k l i n ɛ k s
klepto	k l ɛ p t o ʊ
kleptocrat	k l ɛ p t ə k ɹ æ t
kleptomaniac	k l ɛ p t ə m e ɪ n i æ k
kluge	k l u d͡ʒ
knacker	n æ k ɚ
knife	n a ɪ f
knifes	n a ɪ f s
kniffles	n ɪ f l i z
knighton	n a ɪ t ə n
knits	n ɪ t s
knitting	n ɪ t ɪ ŋ
knittings	n ɪ t ɪ ŋ z
knocked	n ɑ k t
knot	n ɑ t
knots	n ɑ t s
knowing	n o ʊ ɪ ŋ
knowledgeful	n ɔ l ɪ d͡ʒ f ə l
knows	n o ʊ z
knuckle	n ʌ k ə l
knuff	n ʌ f
kohls	k o ʊ l z
koi	k ɔ ɪ
kokborok	k o ʊ k v o ʊ ɹ o ʊ k
kolache	k ə l ɑ t͡ʃ i
kosraean	k o ʊ ʃ a ɪ ə n
kozachok	k ə z ɑ t͡ʃ ɔ k
kraut	k ɹ a ʊ t
kriol	k ɹ i o ʊ l
kuban	k u b ɑ n
kuchen	k u k ə n
kulak	k u l æ k
kylie	k a ɪ l i
kylixes	k a ɪ l ɪ k s ə z
kyoto	k j o ʊ t o ʊ
kyphotone	k a ɪ f ə t o ʊ n
laborer	l e ɪ b ɚ ɚ
laborious	l ə b ɔ ɹ i ə s
laboriously	l ə b ɔ ɹ i ə s l i
lacerated	l æ s ə ɹ e ɪ t ɪ d
laceration	l æ s ə ɹ e ɪ ʃ ə n
lacertus	l ə s ɝ t ə s
lachrymatory	l æ k ɹ ɪ m ə t ə ɹ i
lack	l æ k
laconia	l ə k o ʊ n i ə
lacrimogenous	l æ k ɹ ɪ m ɑ d͡ʒ ə n ə s
lactate	l æ k t e ɪ t
lactation	l æ k t e ɪ ʃ ə n
lactory	l æ k t ə ɹ i
lactose	l æ k t o ʊ s
laddie	l æ d i
laden	l e ɪ d ə n
ladle	l e ɪ d ə l
lady	l e ɪ d i
laertes	l e ɪ ɜ ɹ t i z
laestrygonian	l ɛ s t ɹ ɪ ɡ o ʊ n i ə n
lageniform	l ə d͡ʒ ɛ n ə f ɔ ɹ m
lagniappe	l æ n j æ p
lai	l a ɪ
laid	l e ɪ d
lakin	l e ɪ k ɪ n
lambaste	l æ m b æ s t
lambdacism	l æ m b d ə s ɪ z ə m
lamber	l æ m ɚ
lames	l e ɪ m z
lan	l æ n
lancet	l æ n s ɪ t
landlady	l æ n d l e ɪ d i
landlocked	l æ n d l ɑ k t
landon	l æ n d ə n
landover	l æ n d o ʊ v ə ɹ
landowner	l æ n d o ʊ n ɚ
landwehr	l ɑ n t v e ɪ ɹ
lane	l e ɪ n
langth	l æ ŋ k θ
languet	l æ ŋ ɡ w ɪ t
languid	l æ ŋ ɡ w ɪ d
languish	l æ ŋ ɡ w ɪ ʃ
lank	l æ ŋ k
lanugo	l ə n j u ɡ o ʊ
laodicea	l e ɪ ə d ɪ s i ə
lapidary	l æ p ɪ d ə ɹ i
lapping	l æ p ɪ ŋ
lapse	l æ p s
lapsus	l æ p s ə s
larceny	l ɑ ɹ s ə n i
larch	l ɑ ɹ t͡ʃ
lariat	l æ ɹ ɪ ə t
larissa	l ə ɹ ɪ s ə
larp	l ɑ ɹ p
larrup	l æ ɹ ə p
larvae	l ɑ ɹ v i
larynx	l æ ɹ ɪ ŋ k s
lase	l e ɪ z
lasher	l æ ʃ ə r
lashing	l æ ʃ ɪ ŋ
lasted	l æ s t ɪ d
lasting	l æ s t ɪ ŋ
latebricole	l ə t ɛ b ɹ ə k o ʊ l
lately	l e ɪ t l i
latency	l e ɪ t ə n s i
laters	l e ɪ t ɚ z
latibulum	l ə t ɪ b j ʊ l ə m
latigo	l æ t ɪ ɡ o ʊ
latreutic	l ə t ɹ u t ɪ k
latus	l e ɪ t ə s
laud	l ɔ d
laugher	l æ f ɚ
launderette	l ɔ n d ə ɹ ɛ t
laundry	l ɔ n d ɹ i
lauraceous	l ɔ ɹ e ɪ ʃ ə s
laureation	l ɔ ɹ i e ɪ ʃ ə n
laurin	l ɔ ɹ ɪ n
lauter	l a ʊ t ɚ
lavandin	l æ v ə n d ɪ n
lavatory	l æ v ə t ɔ ɹ i
lawny	l ɔ n i
laxative	l æ k s ə t ɪ v
laxly	l æ k s l i
laying	l e ɪ ɪ ŋ
lazarus	l æ z ə ɹ ə s
leaden	l ɛ d ə n
leadman	l i d m ə n
league	l i ɡ
leagues	l i ɡ z
leak	l i k
leaked	l i k t
leaks	l i k s
leaky	l i k i
leaned	l i n d
leap	l i p
leapfrog	l i p f ɹ ɑ ɡ
leaping	l i p ɪ ŋ
leapling	l i p l ɪ ŋ
leaven	l ɛ v ə n
lect	l ɛ k t
lee	l i
leed	l i d
leeds	l i d z
leetspeak	l i t s p i k
leeuwarden	l e ɪ w ɑ ɹ d ə n
lefkas	l ɛ f k æ s
lefties	l ɛ f t i z
legging	l ɛ ɡ ɪ ŋ
legible	l ɛ d͡ʒ ə b l
legion	l i d͡ʒ ə n
leh	l e ɪ
leia	l e ɪ ə
leipsic	l ɪ p s ɪ k
lemmatically	l ə m æ t ɪ k ə l l i
lemme	l ɛ m i
lemniscatic	l ɛ m n ɪ s k æ t ɪ k
lemuel	l e m j ə w ə l
lend	l ɛ n d
leninite	l ɛ n ɪ n a ɪ t
lenox	l ɛ n ɪ k s
lentous	l ɛ n t ə s
leo	l i o ʊ
leominster	l ɛ m ə n s t ə ɹ
les	l ɛ z
lesbic	l ɛ z b ɪ k
less	l ɛ s
lesser	l ɛ s ɚ
lesson	l ɛ s n̩
lessons	l ɛ s n̩ z
let	l ɛ t
lethargy	l ɛ θ ɚ d͡ʒ i
levitate	l ɛ v ɪ t e ɪ t
levitous	l ɛ v ɪ t ə s
levobupivacaine	l i v o ʊ b j u p ɪ v ə k e ɪ n
levomilnacipran	l i v ə m ɪ l n æ s ə p ɹ æ n
lewdness	l u d n ə s
lexeme	l ɛ k s i m
lexemes	l ɛ k s i m z
leyburn	l e ɪ b ɜ ɹ n
lezzer	l ɛ z ɚ
lgbt	ɛ l d͡ʒ i b i t i
li	l i
lias	l i ə s
lib	l ɪ b
libate	l a ɪ b e ɪ t
lice	l a ɪ s
licentious	l a ɪ s ɛ n ʃ ə s
licentuous	l a ɪ s ɛ n t͡ʃ u ə s
licking	l ɪ k ɪ ŋ
lidocaine	l a ɪ d ə k e ɪ n
lieder	l i d ɚ
lieutenant	l j u t ɛ n ə n t
ligase	l a ɪ ɡ e ɪ z
ligger	l ɪ ɡ ɚ
lighter	l a ɪ t ɚ
lighthouse	l a ɪ t h a ʊ s
lights	l a ɪ t s
lightsaber	l a ɪ t s e ɪ b ɚ
likam	l a ɪ k ə m
like	l a ɪ k
likewise	l a ɪ k w a ɪ z
lil	l ɪ l
liliate	l ɪ l i ə t
limber	l ɪ m b ə ɹ
limbs	l ɪ m z
lime	l a ɪ m
limer	l a ɪ m ə ɹ
limit	l ɪ m ɪ t
limits	l ɪ m ɪ t s
limmer	l ɪ m ə
limner	l ɪ m n ɚ
limo	l ɪ m o ʊ
limoncello	l ɪ m ə n t͡ʃ ɛ l o ʊ
limousine	l ɪ m ə z i n
limps	l ɪ m p s
linch	l ɪ n ʃ
lincoln	l ɪ ŋ k ə n
lindsay	l ɪ n z i
lineage	l ɪ n i ɪ d͡ʒ
linearithmic	l ɪ n i ə ɹ ɪ ð m ɪ k
linearity	l ɪ n i æ ɹ ə t i
linezolid	l ɪ n ɛ z ə l ɪ d
linhay	l ɪ n i
linkrot	l ɪ ŋ k ɹ ɔ t
linlithgow	l ɪ n l ɪ θ ɡ o ʊ
linq	l ɪ ŋ k
linwood	l ɪ n w ʊ d
lionel	l a ɪ ə n l
liothyronine	l a ɪ o ʊ θ a ɪ ɹ ə n i n
lipread	l ɪ p ɹ i d
lipstick	l ɪ p s t ɪ k
liquid	l ɪ k w ɪ d
liquidity	l ɪ k w ɪ d ə t i
liquor	l ɪ k ɚ
lisbon	l ɪ z b ə n
lisdexamfetamine	l ɪ s d ɛ k s æ m f ɛ t m ə i n
lissencephaly	l ɪ s ɛ n s ɛ f ə l i
litany	l ɪ t ə n i
literate	l ɪ t ə ɹ ə t
lithen	l a ɪ ð ə n
lithophyte	l ɪ θ ə f a ɪ t
litmus	l ɪ t m ə s
litre	l i t ɚ
litterateur	l ɪ t ə ɹ ə t ʊ ɚ
litterateuse	l ɪ t ə ɹ ə t u z
littlest	l ɪ t l̩ ə s t
littoral	l ɪ t ə ɹ ə l
liturgy	l ɪ t ɚ d͡ʒ i
lived	l ɪ v d
liveliness	l a ɪ v l i n ə s
lizard	l ɪ z ɚ d
ljbf	l ɪ d͡ʒ b ɪ f
lkg	ɛ l k e ɪ d͡ʒ i
llanrwst	h l æ n ɹ u s t
lnav	ɛ l n e ɪ v
loads	l o ʊ d z
loaf	l o ʊ f
loam	l o ʊ m
loathe	l o ʊ ð
lobster	l ɑ b s t ɚ
locale	l o ʊ k æ l
locative	l ɑ k ə t ɪ v
locked	l ɑ k t
lodgment	l ɑ d͡ʒ m ə n t
lofty	l ɔ f t i
logarithmancy	l ɔ ɡ ə ɹ ɪ ð m ə n s i
loggat	l ɔ ɡ ə t
logo	l o ʊ ɡ o ʊ
logological	l ɑ ɡ o ʊ l ɑ d͡ʒ i k ə l
logophor	l o ʊ ɡ ɵ f o ʊ ɹ
logorrhea	l ɔ ɡ ə ɹ i ə
logy	l o ʊ ɡ i
loiret	l w ɑ ɹ e ɪ
lola	l o ʊ l ə
lollapalooza	l ɑ l ə p ə l u z ə
londraville	l ɑ n d ɹ ə v ɪ l
lone	l o ʊ n
long	l ɔ ŋ
longed	l ɔ ŋ d
longeval	l ɔ n d͡ʒ i v ə l
longhand	l ɔ ŋ h æ n d
longhaul	l ɔ ŋ h ɔ l
longinquity	l ɔ n d͡ʒ ɪ ŋ k w ɪ t i
longsome	l ɔ ŋ s ə m
looked	l ʊ k t
loon	l u n
loong	l ʊ ŋ
loop	l u p
looped	l u p t
looper	l u p ə ɹ
loopies	l u p i e s
loose	l u s
loot	l u t
looter	l u t ɚ
loperamide	l o ʊ p ɛ ɹ ə m a ɪ d
lopsided	l ɑ p s a ɪ d ɪ d
lorazepam	l ɔ ɹ æ z ə p æ m
lordly	l ɔ ɹ d l i
lordship	l ɔ ɹ d ʃ ɪ p
lorenz	l ə ɹ ɛ n z
lorn	l ɔ ɹ n
lorry	l ɔ ɹ i
lory	l ɔ ɹ i
lote	l o ʊ t
lotus	l o ʊ t ə s
loupe	l u p
lovely	l ʌ v l i
lowe	l o ʊ
lowson	l o ʊ s ə n
loxodromic	l ɔ k s ə d ɹ ɔ m ɪ k
lozenge	l ɑ z ɪ n d͡ʒ
lube	l u b
lubiprostone	l u b ɪ p ɹ ɑ s t o ʊ n
lucea	l u s i ə
lucidly	l u s ɪ d l i
lucknow	l ʌ k n a ʊ
luddite	l ʌ d a ɪ t
ludic	l u d ɪ k
ludomusicality	l u d o ʊ m j u z ɪ k æ l ɪ t i
ludomusicological	l u d o ʊ m j u z ɪ k ə l ɑ d͡ʒ ɪ k ə l
luetic	l u ɛ t ɪ k
luff	l ʌ f
luggage	l ʌ ɡ ɪ d͡ʒ
luigino	l u i d͡ʒ i n o ʊ
lukewarm	l u k w ɔ ɹ m
lullaby	l ʌ l ə b a ɪ
lum	l ʌ m
lumen	l u m ə n
luminescences	l u m ɪ n ɛ s ə n s ɛ s
luminous	l u m ɪ n ə s
lunar	l u n ɚ
lunching	l ʌ n t͡ʃ ɪ ŋ
lunging	l ʌ n d͡ʒ ɪ ŋ
lunky	l ʌ ŋ k i
lupin	l u p ɪ n
lupus	l u p ə s
lurgy	l ɝ ɡ i
lurker	l ɝ k ɚ
lusk	l ʌ s k
lusterless	l ʌ s t ɚ l ə s
lustrum	l ʌ s t ɹ ə m
lute	l u t
lutetium	l j u t i ʃ i ə m
lutherie	l u t ə ɹ i
lutulent	l ʌ t j ʊ l ə n t
luv	l ʌ v
luxembourg	l ʌ k s ə m b ɝ ɡ
lyceum	l a ɪ s i ə m
lymm	l ɪ m
lymphoma	l ɪ m f o ʊ m ə
lynwood	l ɪ n w ʊ d
lyssa	l ɪ s ə
maastricht	m ɑ s t r ɪ k t
mabel	m e ɪ b l̩
maccabee	m æ k k ə b i
maceration	m æ s ə ɹ e ɪ ʃ ə n
macerator	m æ s ə ɹ e ɪ t ɚ
machaon	m ə k e ɪ ə n
macho	m ɑ t͡ʃ o ʊ
mack	m æ k
mackintosh	m æ k ɪ n t ɑ ʃ
macos	m æ k o ʊ ɛ s
macropicide	m ə k ɹ ɑ p ɪ s a ɪ d
macropsy	m æ k ɹ ɔ p s i
madam	m æ d ə m
madden	m æ d ə n
maddie	m æ d i
maddy	m æ d i
made	m e ɪ d
maeve	m e ɪ v
maftivimab	m æ f t ɪ v ɪ m æ b
magenstrasse	m ɑ ɡ ə n s t r ɑ s ə
maggie	m æ ɡ i
maggots	m æ ɡ ə t s
magister	m æ d͡ʒ ɪ s t ə ɹ
magistrand	m æ d͡ʒ ɪ s t ɹ æ n d
magnality	m æ ɡ n æ l ɪ t i
magnoperate	m æ ɡ n ɔ p ə ɹ e ɪ t
mahal	m ə h ɑ l
maidan	m a ɪ d ɑ n
mails	m e ɪ l z
mainer	m e ɪ n ɚ
mainstay	m e ɪ n s t e ɪ
maka	m ɑ k ə
makonde	m ə k ɔ n d e ɪ
malachite	m æ l ə k a ɪ t
malamute	m æ l ə m j u t
malapropism	m æ l ə p ɹ ɑ p ɪ z ə m
malaria	m ə l ɛ ɹ i ə
malayalam	m ɑ l ə j ɑ l ə m
malcontent	m æ l k ə n t ɛ n t
maleficial	m æ l ɪ f ɪ ʃ ə l
malevolence	m ə l ɛ v ə l ə n s
malevolent	m ə l ɛ v ə l ə n t
malic	m æ l ɪ k
malicious	m ə l ɪ ʃ ə s
mallet	m æ l ɪ t
maltese	m ɑ l t i z
malvesey	m æ l v ə z i
mamaroneck	m ə m ɑ ɹ ə n ɛ k
mamma	m æ m ə
mammal	m æ m ə l
mammary	m æ m ə ɹ i
mammon	m æ m ə n
mampy	m æ m p i
mana	m ɑ n ə
manacle	m æ n ə k ə l
managed	m æ n ɪ d͡ʒ d
manager	m æ n ɪ d͡ʒ ɚ
manchin	m æ n t͡ʃ ɪ n
manchu	m æ n t͡ʃ u
manchurian	m æ n t͡ʃ ʊ ə ɹ i ə n
mandaeism	m æ n d e ɪ ɪ z ə m
mandatary	m æ n d e ɪ t ə ɹ i
mandatory	m æ n d ə t ɔ ɹ i
mandy	m æ n d i
manganese	m æ ŋ ɡ ə n i z
mange	m e ɪ n d͡ʒ
mangemange	m æ ŋ i m æ ŋ i
mangle	m æ ŋ ɡ ə l
mangrove	m æ ŋ ɡ ɹ o ʊ v
manichaean	m æ n ɪ k i ə n
manipur	m ə n ɪ p ʊ ɹ
manism	m ɑ n ɪ z ə m
manita	m ə n i t ə
mankiw	m æ n k j u
manly	m æ n l i
manned	m æ n d
mannequin	m æ n ə k ɪ n
mannopeptimycin	m n æ o ʊ p ɛ p t ɪ m a ɪ s ɪ n
manor	m æ n ə ɹ
manpack	m æ n p æ k
manspread	m æ n s p ɹ ɛ d
mantle	m æ n t ə l
manufactured	m æ n j ə f æ k t͡ʃ ɚ d
manufacturing	m æ n j ə f æ k t͡ʃ ə ɹ ɪ ŋ
manurial	m ə n ʌ ɹ i ə l
manyfold	m æ n ɪ f o l d
mao	m a ʊ̯
marcher	m ɑ ɹ t͡ʃ ɚ
marchland	m ɑ ɹ t͡ʃ l æ n d
mares	m ɛ ɹ z
margin	m ɑ ɹ d͡ʒ ə n
marginated	m ɑ ɹ d͡ʒ ɪ n e ɪ t ə d
margravine	m ɑ ɹ ɡ ɹ ə v i n
mariah	m ə ɹ a ɪ ə
marie	m ə ɹ i
marigot	m æ ɹ ɪ ɡ o ʊ
marise	m ə ɹ i z
marjoram	m ɑ ɹ d͡ʒ ə ɹ ə m
marked	m ɑ ɹ k t
markie	m ɑ ɹ k i
marks	m ɑ ɹ k s
marlite	m ɑ ɹ l a ɪ t
marquee	m ɑ ɹ k i
marram	m æ ɹ ə m
marrying	m ɛ ɹ i ɪ ŋ
marsha	m ɑ ɹ ʃ ə
marshall	m ɑ ɹ ʃ ə l
marshy	m ɑ ɹ ʃ i
martinez	m ɑ ɹ t i n ɛ z
martyr	m ɑ ɹ t ɚ
maru	m ɑ ɹ u
mascle	m æ s k ə l
masher	m æ ʃ ə ɹ
masochist	m æ s ə kʰ ɪ s t
mason	m e ɪ s ə n
massachusetts	m æ s ə t͡ʃ u s ɪ t s
massingbird	m æ s ɪ ŋ b ɜ ɹ d
masterpiece	m æ s t ɚ p i s
masturbatorium	m æ s t ɜ ɹ b ə t ɔ ɹ i ə m
matanza	m ə t ɑ n z ə
materialistic	m ə t ɪ ə ɹ i ə l ɪ s t ɪ k
matronymic	m æ t ɹ ə n ɪ m ɪ k
mats	m æ t s
matting	m æ t ɪ ŋ
matutinal	m ə t ʊ t ə n ə l
maugre	m ɔ ɡ ɚ
maumy	m ɔ m i
mavrodaphne	m æ v ɹ ə d æ f n i
maw	m ɔ
mayhem	m e ɪ h ɛ m
mcdonald	m ə k d ɑ n ə l d
mcintosh	m æ k ɪ n t ɔ ʃ
mcpherson	m ə k f ɜ ɹ s ə n
mcsally	m ə k s æ l i
meadery	m i d ə ɹ i
meager	m i ɡ ɚ
meant	m ɛ n t
meantime	m i n t a ɪ m
measly	m i z l i
measured	m ɛ ʒ ɚ d
meath	m i ð
meatloaf	m i t l o ʊ f
meatus	m i e ɪ t ə s
mechanise	m ɛ k ə n a ɪ z
meclozine	m ɛ k l ə z i n
medevac	m ɛ d ɪ v æ k
mediaeval	m ɪ d i v ə l
mediately	m i d i ə t l i
mediocre	m i d i o ʊ k ə ɹ
meditation	m ɛ d ɪ t e ɪ ʃ ə n
meed	m i d
meg	m ɛ ɡ
megabit	m ɛ ɡ ə b ɪ t
megalopoleis	m ɛ ɡ æ l ɔ p ɔ l ɛ ɪ z
meister	m a ɪ̯ s t ə r
melatonin	m ɛ l ə t o ʊ n ɪ n
melbourne	m ɛ l b ɚ n
melisma	m ə l ɪ z m ə
melittin	m ə l ɪ t ə n
melodrama	m ɛ l ə d ɹ ɑ m ə
melons	m ɛ l ə n z
melphalan	m ɛ l f ə l æ n
melpomene	m ɛ l p ɔ m ɪ n i
membraneous	m ɛ m b ɹ e ɪ n i ə s
meme	m i m
memester	m i m s t ɚ
memo	m ɛ m o ʊ̯
memoriter	m ə m ɔ ɹ ɪ t ə ɹ
mend	m ɛ n d
mendacious	m ɛ n d e ɪ ʃ ə s
mende	m ɛ n d i
mendelevium	m ɛ n d ə l i v i ə m
mendicant	m ɛ n d ɪ k ə n t
menendez	m ə n ɛ n d ɛ z
mensch	m ɛ n t͡ʃ
menses	m e n s i z
mentally	m ɛ n t ə l i
mentioning	m ɛ n ʃ ə n ɪ ŋ
mephenytoin	m ə f ɛ n ɪ t o ʊ ɪ n
mephobarbital	m ɛ f o ʊ b ɑ ɹ b ə t ɔ l
merdivorous	m ɜ d ɪ v ə ɹ ə s
merengue	m ə ɹ ɛ ŋ ɡ e ɪ
mereotopology	m ɛ ɹ ɪ ə t ə p ɔ l ə d͡ʒ i
merger	m ɝ d͡ʒ ɚ
meringue	m ə ɹ æ ŋ
merino	m ə ɹ i n o ʊ
merismus	m ə ɹ ɪ z m ə s
meritable	m ɛ ɹ ɪ t ə b l̩
meritocracy	m ɛ ɹ ə t ɑ k ɹ ə s i
meromictic	m ɛ ɹ ə m ɪ k t ɪ k
mesalazine	m ə s æ l ə z i n
mesemb	m ə z ɛ m
mesilate	m ɛ s ɪ l e ɪ t
mesilect	m ɛ s ɪ l ɛ k t
mesmerize	m ɛ z m ə ɹ a ɪ z
message	m ɛ s ɪ d͡ʒ
messia	m e s ɪ ə
messiah	m ə s a ɪ ə
messrs	m ɛ s ɚ z
metacosm	m ɛ t ə k ɔ z ə m
metaller	m ɛ t ə l ə
metallurgy	m ɛ t ə l ə ɹ d͡ʒ i
metamorphic	m ɛ t ə m ɔ ɹ f ɪ k
mete	m i t
meteorological	m i t i ə ɹ ə l ɑ d͡ʒ ɪ k l̩
metformin	m ɛ t f ɔ ɹ m ɪ n
methadone	m ɛ θ ə d o ʊ n
methane	m ɛ θ e ɪ n
methimazole	m ə θ ɪ m ə z o ʊ l
methoctramine	m ɛ θ ɑ k t ɹ ə m i n
methylation	m ɛ θ ɪ l e ɪ ʃ ə n
methylations	m ɛ θ ɪ l e ɪ ʃ ə n z
methylenetetrahydrofolatereductase	m ɛ θ ə l i n t ɛ t ɹ ə h a ɪ d ɹ ə f o ʊ l e ɪ t ɹ ɪ d ʌ k t e ɪ z
meticillin	m ɛ t ɪ s ɪ l ɪ n
metroscopy	m ə t ɹ ɑ s k ə p i
mexiletine	m ɛ k s ɪ l ə t i n
miami	m a ɪ æ m i
mica	m a ɪ k ə
micacious	m a ɪ k e ɪ ʃ ə s
micah	m a ɪ k ə
micawberly	m ɪ k ɔ b ə ɹ l i
michaelmas	m ɪ k ə l m ə s
michelangelesque	m a ɪ k ə l æ n d͡ʒ ə l ɛ s k
michigan	m ɪ ʃ ɪ ɡ ə n
mickey	m ɪ k i
mickle	m ɪ k ə l
micron	m a ɪ k ɹ ɔ n
midge	m ɪ d͡ʒ
midinette	m ɪ d ɪ n ɛ t
midst	m ɪ d s t
mighty	m a ɪ t i
migraine	m a ɪ ɡ ɹ e ɪ n
migratory	m a ɪ ɡ ɹ ə t ɔ ɹ i
mildew	m ɪ l d j u
miletus	m a ɪ l i t ə s
miley	m a ɪ l i
milford	m ɪ l f ə ɹ d
militia	m ə l ɪ ʃ ə
milksop	m ɪ l k s ɔ p
millenarianism	m ɪ l ɪ n ɛ ɹ i ə n ɪ z ə m
milliard	m ɪ l i ɑ ɹ d
millionaire	m ɪ l j ə n ɛ ɚ
millipede	m ɪ l ə p i d
millisor	m ɪ l a ɪ z ɚ
millstone	m ɪ l s t o ʊ n
milnacipran	m ɪ l n æ s ə p ɹ æ n
milne	m ɪ l n
milquetoast	m ɪ l k t o ʊ s t
milrinone	m ɪ l ɹ ə n o ʊ n
milt	m ɪ l t
milwaukee	m ɪ l w ɔ k i
mimantean	m ɪ m æ n t i ə n
mimbar	m ɪ m b ɑ
mime	m a ɪ m
mimeo	m ɪ m ɪ o ʊ
miming	m a ɪ m ɪ ŋ
minah	m a ɪ n ə
minarchism	m ɪ n ɚ k ɪ z ə m
mince	m ɪ n s
mineralogy	m ɪ n ə ɹ ɑ l ə d͡ʒ i
ming	m ɪ ŋ
minge	m ɪ n d͡ʒ
minging	m ɪ ŋ ɪ ŋ
miniaturised	m ɪ n ɪ t͡ʃ ə ɹ ʌ ɪ z d
minister	m ɪ n i s t ɚ
minster	m ɪ n s t ɚ
minto	m ɪ n t o ʊ
misandry	m ɪ s æ n d ɹ i
misanthrope	m ɪ s ə n θ ɹ o ʊ p
misanthropic	m ɪ s ə n θ ɹ ɑ p ɪ k
misbeliever	m ɪ s b ɪ l i v ɚ
miscreator	m ɪ s k ɹ ɪ e ɪ t ə
miserable	m ɪ z ə ɹ ə b ə l
miserabler	m ɪ z ɹ ə b ə l ə ɹ
miserly	m a ɪ z ə ɹ l i
misery	m ɪ z ə ɹ i
mishear	m ɪ s h ɪ ə ɹ
misheard	m ɪ s h ɜ ɹ d
mislive	m ɪ s l ɪ v
misogynist	m ɪ s ɑ d͡ʒ ə n ɪ s t
misoprostol	m a ɪ s o ʊ p ɹ ɑ s t ɔ l
missies	m ɪ s i z
missouran	m ə z ɝ ə n
missy	m ɪ s i
misunderstanding	m ɪ s ʌ n d ɚ s t æ n d ɪ ŋ
mithraeum	m ɪ θ ɹ i ə m
mitigation	m ɪ t ɪ ɡ e ɪ ʃ ə n
mitre	m a ɪ t ə ɹ
mitt	m ɪ t
mix	m ɪ k s
mixin	m ɪ k s ɪ n
mixoscopy	m ɪ k s ɔ s k ə p i
mixture	m ɪ k s t͡ʃ ɚ
miyakawa	m i j ə k ɑ w ə
mizzen	m ɪ z ə n
mnemotechnical	n ɛ m o ʊ t ɛ k n ɪ k ə l
moai	m o ʊ a ɪ
moat	m o ʊ t
mobility	m o ʊ b ɪ l ɪ t i
mocha	m o ʊ k ə
mode	m o ʊ d
modulo	m ɔ d͡ʒ ə l o ʊ
mohawk	m o ʊ h ɔ k
mojado	m o ʊ h ɑ d o ʊ
molecule	m ɑ l ə k j u l
molehill	m o ʊ l h ɪ l
molestation	m o ʊ l ɪ s t e ɪ ʃ ə n
molise	m ɔ l i z e ɪ
mollie	m ɑ l i
molly	m ɑ l i
mome	m o ʊ m
moment	m o ʊ m ə n t
moments	m o ʊ m ə n t s
momist	m o ʊ m ɪ s t
monaco	m ɑ n ə k o ʊ
monarchy	m ɑ n ɚ k i
mongeese	m ɑ ŋ ɡ i s
monkey	m ʌ ŋ k i
monmouth	m ɔ n m ə θ
monoceros	m ə n ɔ s ə ɹ ə s
monoclonal	m ɑ n ə k l o ʊ n ə l
monocotyledon	m ɔ n ə k ɔ t ɪ l i d ə n
monogamy	m ə n ɑ ɡ ə m i
monogenean	m ɔ n ə d͡ʒ i n i ə n
monolid	m ɔ n o ʊ l ɪ d
monology	m ə n ɔ l ə d͡ʒ i
monotheistic	m ɑ n ə θ i ɪ s t ɪ k
monotypy	m ɔ n ɔ t ɪ p i
montagovian	m ɔ n t ə ɡ o ʊ v ɪ ə n
montferrat	m ɑ n t f ə ɹ ɑ t
month	m ʌ n θ
montseny	m ɔ n t s e ɪ n
moose	m u s
mope	m o ʊ p
mopy	m ɔ p i
moralphobia	m ɔ ɹ ə l f o ʊ b i ə
mordent	m ɔ ɹ d ə n t
mordicant	m ɔ ɹ d ɪ k ə n t
more	m ɔ ɹ
morecambe	m ɔ k ə m
morel	m ə ɹ ɛ l
moreover	m ɔ ɹ o ʊ v ɚ
morning	m ɔ ɹ n ɪ ŋ
morose	m ɔ ɹ o ʊ s
morphology	m ɔ ɹ f ɑ l ə d͡ʒ i
mort	m ɔ ɹ t
mortality	m ɔ ɹ t æ l ɪ t i
mosasaurid	m o ʊ z ə s ɔ ɹ ɪ d
mosby	m o ʊ z b i
moschatel	m ɔ s k ə t ɛ l
mosey	m o ʊ z i
mossie	m ɔ s i
mothered	m ʌ ð ə ɹ d
motherfucking	m ʌ ð ə ɹ f ʌ k ɪ ŋ
mothers	m ʌ ð ɚ z
motorcycle	m o ʊ t ɚ s a ɪ k ə l
motorola	m o ʊ t ɚ ɹ o ʊ l ə
motown	m o ʊ t a ʊ n
mottle	m ɑ t ə l
mountebank	m a ʊ n t ə b æ ŋ k
mounted	m a ʊ n t ɪ d
mousehole	m a ʊ z ə l
movements	m u v m ə n t s
moves	m u v z
mozambique	m o ʊ z æ m b i k
mozz	m ɔ t s
mth	ɛ m θ
mucker	m ʌ k ə ɹ
muckle	m ʌ k ə l
mucus	m j u k ə s
mugging	m ʌ ɡ ɪ ŋ
muh	m ə
mujaddara	m u d͡ʒ ɑ d ə ɹ ə
mujahideen	m u d͡ʒ ɑ h ɛ d i n
mukluk	m ʌ k l ʌ k
mulberry	m ʌ l b ɛ ɹ i
mulch	m ʌ l t͡ʃ
mulct	m ʌ l k t
muleteer	m j u l ə t ɪ ə ɹ
mull	m ʌ l
multilingual	m ʌ l t i l ɪ ŋ ɡ w ə l
multiloquent	m ʌ l t ɪ l ə k w ə n t
multitalented	m ʌ l t i t æ l ə n t ɪ d
mumbai	m ʊ m b a ɪ
mumchance	m ʌ m t͡ʃ æ n s
mummiform	m ʌ m ɪ f ɔ ɹ m
mumpsimus	m ʌ m p s ɪ m ə s
mundane	m ʌ n d e ɪ n
mundialization	m ɑ n d i ə l ə z e ɪ ʃ ə n
mundungus	m ə n d ə ŋ ɡ ə s
municipium	m j u n ə s ɪ p i ə m
munshi	m u n ʃ i
mura	m u ɹ ə
murdoch	m ɜ ɹ d ɔ k
mure	m j ʊ ə ɹ
murgeon	m ɝ d͡ʒ ə n
murrelet	m ɚ l ə t
murry	m ɜ ɹ i
murther	m ɜ ɹ ð ə ɹ
murupara	m u ɹ u p ɑ ɹ ə
muscle	m ʌ s ə l
muscles	m ʌ s ə l z
muskrat	m ʌ s k ɹ æ t
mussitate	m ʌ s ɪ t e ɪ t
mussolini	m ʊ s ə l i n i
mustached	m ʌ s t æ ʃ t
mutant	m j u ʔ n̩ t
mutate	m j u t e ɪ t
mutch	m ʌ t͡ʃ
myall	m a ɪ ə l
mycenaean	m a ɪ s ɪ n i ə n
myelogenous	m a ɪ ə l ɔ d͡ʒ ɪ n ə s
myeloid	m a ɪ ə l ɔ ɪ d
mylar	m a ɪ l ɑ ɹ
myoglobinemia	m a ɪ o ʊ ɡ l o ʊ b ɪ n i m i ə
myopia	m a ɪ o ʊ p i ə
myoxine	m a ɪ ɔ k s a ɪ n
myriagon	m ɪ ɹ i ə ɡ ɑ n
myrmidonian	m ɜ ɹ m ɪ d o ʊ n i ə n
myroblyte	m ɪ ɹ ə b l a ɪ t
myrrhic	m ɜ ɹ i k
mysia	m ɪ ʒ ə
mystic	m ɪ s t ɪ k
mysticism	m ɪ s t ɪ s ɪ z ə m̩
mystique	m ɪ s t i k
naam	n ɑ m
nabby	n æ b i
nackawic	n æ k ə w ɪ k
nadsat	n ɑ d s ə t
nafarelin	n æ f ə ɹ ɛ l ɪ n
nagger	n æ ɡ ɚ
naggy	n æ ɡ i
nagle	n e ɪ ɡ ə l
namaste	n ʌ m ə s t e ɪ
namely	n e ɪ m l i
nandrolone	n æ n d ɹ ə l o ʊ n
nanny	n æ n i
nano	n æ n o ʊ
nanterre	n ɑ n t ɛ ɹ
napiform	n e ɪ p ɪ f ɔ ɹ m
nappy	n æ p i
narcissine	n ɑ ɹ s ɪ s i n
nash	n æ ʃ
nasoileal	n e ɪ z o ʊ ɪ l i ə l
nate	n e ɪ t
nauseated	n ɔ z i e ɪ t ɪ d
nausicaan	n ɔ s ɪ k e ɪ ə n
nautch	n ɔ t͡ʃ
nautical	n ɔ t ɪ k l̩
navaratna	n ɑ v ɑ ɹ ɑ t n ɑ
navigation	n æ v ɪ ɡ e ɪ ʃ ə n
navratna	n ʌ v ɹ ʌ t n ə
nawrocki	n ə ɹ ɑ k i
nay	n e ɪ
naypyidaw	n e ɪ p j ɪ d ɔ
naysayer	n e ɪ s e ɪ ɚ
ncaa	ɛ n s i e ɪ e ɪ
neapolitan	n i ə p ɔ l ɪ t ə n
neb	n ɛ b
nebbish	n ɛ b ɪ ʃ
nebulous	n ɛ b j ʊ l ə s
necessitate	n ə s ɛ s ə t e ɪ t
nechako	n ə t͡ʃ æ k o ʊ
necktie	n ɛ k t a ɪ
necrophagy	n ɛ k ɹ ɔ f ə d͡ʒ i
neds	n ɛ d z
need	n i d
needed	n i d ɪ d
needle	n i d l
neepawa	n i p ə w ə
nefandous	n ə f æ n d ə s
nefazodone	n ə f æ z ə d o ʊ n
nefertem	n ɛ f ə ɹ t ɛ m
negarchy	n ɛ ɡ ɑ ɹ k i
negative	n ɛ ɡ ə t ɪ v
neglect	n ɪ ɡ l ɛ k t
negotiations	n ɪ ɡ o ʊ ʃ i e ɪ ʃ ə n z
nehru	n e ɪ r u
nell	n ɛ l
neodymium	n i o ʊ d ɪ m i ə m
neolithic	n i o ʊ l ɪ θ ɪ k
neonatology	n i o ʊ n ə t ɔ l ə d͡ʒ i
neoprene	n i ɵ p ɹ i n
nepenthe	n ə p ɛ n θ i
nephite	n i f a ɪ t
nepotic	n ə p ɔ t ɪ k
neptune	n ɛ p t u n
nerd	n ɝ d
nervy	n ɝ v i
nessary	n ɛ s ə ɹ i
netball	n ɛ t b ɔ l
netherlands	n ɛ ð ɚ l ə n d z
netter	n ɛ t ə ɹ
neurocysticercosis	n j ʊ ə ɹ ə s ɪ s t ɪ s ɜ ɹ k o ʊ s ɪ s
nevertheless	n ɛ v ɚ ð ə l ɛ s
newcastle	n j u k æ s l̩
newer	n j u ɚ
newman	n u m ə n
newquay	n j u k i
newspaper	n j u z p e ɪ p ɚ
newsroom	n j u z ɹ u m
niagara	n a ɪ æ ɡ ɹ ə
nibbling	n ɪ b ə l ɪ ŋ
nicene	n a ɪ s i n
nickname	n ɪ k n e ɪ m
nicole	n ɪ k o ʊ l
nicosia	n ɪ k ə s i ə
nief	n i f
niello	n i ɛ l o ʊ
nietzsche	n i t͡ʃ ə
nifty	n ɪ f t i
nifurtimox	n a ɪ f ɝ t ɪ m ɑ k s
niggardly	n ɪ ɡ ɚ d l i
niggerfaggot	n ɪ ɡ ə ɹ f æ ɡ ə t
nigh	n a ɪ
nightgown	n a ɪ t ɡ a ʊ n
nightlife	n a ɪ t l a ɪ f
nihoa	n i h o ʊ ə
nike	n a ɪ k i
nil	n ɪ l
nimby	n ɪ m b i
ningxia	n ɪ ŋ ʃ j ɑ
niobium	n a ɪ o ʊ b i ə m
nipper	n ɪ p ə ɹ
nit	n ɪ t
nithing	n a ɪ ð ɪ ŋ
nitpick	n ɪ t p ɪ k
nitrile	n a ɪ t ɹ a ɪ l
nitrite	n a ɪ t ɹ a ɪ t
nitty	n ɪ t i
niuean	n j u e ɪ ə n
nizatidine	n a ɪ z æ t ɪ d i n
noah	n o ʊ ə
nobility	n o ʊ b ɪ l ɪ t i
nobodies	n ɔ b ɔ d ɪ s
nocebo	n o ʊ s i b o ʊ
nocive	n o ʊ s ɪ v
nock	n ɔ k
noctule	n ɑ k t͡ʃ u l
nocturnal	n ɑ k t ɚ n ə l
nodulus	n ɑ d͡ʒ ə l ə s
nog	n ɔ ɡ
nogoodnik	n o ʊ ɡ ʊ d n ɪ k
nojito	n o ʊ h i t o ʊ
nolan	n o ʊ l ə n
nome	n o ʊ m
nominalize	n ɑ m ə n ə l a ɪ z
nonage	n o ʊ n ə d͡ʒ
nonassessable	n ɔ n ə s ɛ s ə b ə l
nonogram	n ɑ n ə ɡ ɹ æ m
noo	n u
noon	n u n
noonan	n u n ə n
nooser	n u s ɚ
norcal	n ɔ ɹ k æ l
normal	n ɔ ɹ m ə l
normalcy	n ɔ ɹ m ə l s i
normative	n ɔ ɹ m ə t ɪ v
northumber	n ɔ ɹ θ ʌ m b ɚ
nostrify	n ɑ s t ɹ ə f a ɪ
notarial	n o ʊ t ɛ ɹ i ə l
noted	n o ʊ t ɪ d
notion	n o ʊ ʃ ə n
noumenon	n u m ə n ɑ n
nova	n o ʊ v ə
novelist	n ɑ v ə l ɪ s t
novels	n ɑ v l̩ z
novemdecillion	n o ʊ v ə m d ə s ɪ l i ə n
novice	n ɑ v ɪ s
novity	n ɑ v ɪ t i
nowadays	n a ʊ ə d e ɪ z
nowhere	n o ʊ w ɛ ɹ
nox	ɛ n o ʊ ɛ k s
nozzle	n ɔ z ə l
nu	n u
nucleon	n j u k l i ɔ n
nuclide	n j u k l a ɪ d
nudibranch	n j u d ɪ b ɹ æ ŋ k
nuke	n j u k
nukes	n j u k s
null	n ʌ l
nullify	n ʌ l ɪ f a ɪ
numbers	n ʌ m b ɚ z
numinous	n j u m ə n ə s
numismatics	n u m ə z m æ t ɪ k s
nunchaku	n ʌ n t͡ʃ ɑ k u
nuncio	n ʌ n ʃ i o ʊ
nunya	n ʌ n j ə
nutrient	n u t ɹ i ə n t
nutso	n ʌ t s o ʊ
nuttin	n ʌ ʔ n̩
nye	n a ɪ
nymph	n ɪ m f
nympha	n ɪ m f ə
nympholepsy	n ɪ m f ə l ɛ p s i
oak	o ʊ k
oakley	o ʊ k l i
oaky	o ʊ k i
ob	ɔ b
obese	o ʊ b i s
obi	o ʊ b i
objected	ə b d͡ʒ ɛ k t ɪ d
objectification	ɔ b d͡ʒ ɛ k t ɪ f ɪ k e ɪ ʃ ʌ n
objection	ə b d͡ʒ ɛ k ʃ ə n
objective	ə b d͡ʒ ɛ k t ɪ v
objurgatory	ɔ b d͡ʒ ʌ ɹ ɡ ə t ɔ ɹ i
oblast	ɔ b l ə s t
oblectation	ɑ b l ɛ k t e ɪ ʃ ə n
obligate	ɑ b l ɪ ɡ e ɪ t
oblige	ə b l a ɪ d͡ʒ
obnoxious	ə b n ɑ k ʃ ə s
obsecratory	ɑ b s ɛ k ɹ ə t ɔ ɚ ɹ i
observed	ə b z ɝ v d
observer	ə b z ɝ v ɚ
obsess	ə b s ɛ s
obsidian	ə b s ɪ d i ə n
obsolescently	ɑ b s ə l ɛ s ə n t l i
obummer	o ʊ b ʌ m ɚ
occasionable	ə k e ɪ ʒ ə n ə b ə l
occasional	ə k e ɪ ʒ ə n ə l
occidental	ɔ k s ə d ɛ n t ə l
occulture	ə k ʌ l t͡ʃ ə ɹ
octane	ɔ k t e ɪ n
octobers	ɑ k t o ʊ b ɚ z
octopodes	ɔ k t ɔ p ə d i z
octosyllabic	ɑ k t o ʊ s ɪ l æ b ɪ k
octyne	ɔ k t a ɪ n
oculist	ɑ k j ə l ɪ s t
odd	ɑ d
ode	o ʊ d
odious	o ʊ d i ə s
odor	o ʊ d ɚ
odsooks	ɔ d z u k s
oestrus	i s t ɹ ə s
offeree	ɑ f ɚ ɹ i
offhandedness	ɑ f h æ n d ə d n ə s
offworld	ɔ f w ɜ ɹ l d
ofsted	ɔ f s t ɛ d
oganesson	o ʊ ɡ ə n ɛ s ɔ n
ogee	o ʊ d͡ʒ i
ogre	o ʊ ɡ ɚ
ogun	o ɡ ú nː
oik	ɔ ɪ k
ok	o ʊ k e ɪ
okotoks	o ʊ k ə t o ʊ k s
okra	o ʊ k ɹ ə
oldie	o ʊ l d i
olecranon	o ʊ l ɛ k ɹ ə n ɑ n
oligo	ɑ l ɪ ɡ o ʊ
oligophrenia	ɔ l ɪ ɡ o ʊ f ɹ i n ɪ ə
olinguito	o ʊ l ɪ ŋ ɡ i t o ʊ
olio	o ʊ l j o ʊ
oliver	ɑ l ɪ v ɚ
olla	ɔ l ə
olwen	o l w ɛ n
olykoek	ɑ l ə k ʊ k
olympus	ə l ɪ m p ə s
omination	ɔ m ɪ n e ɪ ʃ ə n
ominosity	ɔ m ɪ n ɔ s ɪ t i
omohyoid	o ʊ m o ʊ h a ɪ ɔ ɪ d
onanism	o ʊ n ə n ɪ z ə m
once	w ʌ n t s
onchocerciasis	ɔ ŋ k ə s ɜ k a ɪ ə s ɪ s
oneiric	o ʊ n a ɪ ɹ ɪ k
oneironautics	o ʊ n a ɪ ɹ o ʊ n ɔ t ɪ k s
onement	w ʌ n m ə n t
onirocritic	o ʊ n ɪ ɹ ə k ɹ ɪ t ɪ k
only	o ʊ n l i
onomatopoeic	ɔ n ə m æ t ə p i ɪ k
onry	ɔ n ɹ i
onto	ɑ n t u
onymous	ɑ n ɪ m ə s
oogamy	o ʊ ɔ ɡ ə m i
oogone	o ʊ o ʊ ɡ o ʊ n
oolong	u l ʊ ŋ
oophorectomy	o ʊ ə f ə ɹ ɛ k t ə m i
ootheca	o ʊ ə θ i k ə
opacate	o ʊ p ə k e ɪ t
operate	ɑ p ə ɹ e ɪ t
ophthalmia	ɑ p θ æ l m i ə
ophthocillin	ɔ f θ ə s ɪ l ɪ n
opipramol	o ʊ p ɪ p ɹ ə m ɔ l
oppilation	ɔ p ɪ l e ɪ ʃ ə n
oppression	ə p ɹ ɛ ʃ ə n
oppressive	ə p ɹ ɛ s ɪ v
opprobrium	ə p ɹ o ʊ b ɹ i ə m
oppugn	ə p j u n
oppugnation	ɔ p ʌ ɡ n e ɪ ʃ ə n
optimism	ɑ p t ɪ m ɪ z ə m
optoacoustic	ɑ p t o ʊ ə k u s t ɪ k
opuscule	o ʊ p ə s k j u l
orach	ɔ ɹ ɪ t͡ʃ
orangeat	ɔ ɹ æ n ʒ æ t
ordain	ɔ ɹ d e ɪ n
ordeal	ɔ ɹ d i l
ordinarily	ɔ ɹ d ɪ n ɛ ɹ ɪ l i
ordnance	ɔ ɹ d n ə n s
orestes	ɔ ɹ ɛ s t i z
orexis	ə ɹ ɛ k s ɪ s
organism	ɔ ɹ ɡ ə n ɪ z ə m
organization	ɔ ɹ ɡ ə n ɪ z e ɪ ʃ ə n
organizer	ɔ ɹ ɡ ə n a ɪ z ɚ
organs	ɔ ɹ ɡ ə n z
organum	ɔ ɹ ɡ ə n ə m
orgasm	ɔ ɹ ɡ æ z ə m
orientalist	ɔ ɹ i ɛ n t ə l ɪ s t
orl	ɔ ɹ l
ornge	ɔ ɹ n d͡ʒ
oroch	ɔ ɹ ɔ t͡ʃ
oroide	o ʊ ɹ ə w a ɪ d
orontes	ɔ ɹ ɔ n t i z
orotundity	ɔ ɹ ə t ʌ n d ɪ t i
orphanage	ɔ ɹ f ə n ɪ d͡ʒ
orphrey	ɔ ɹ f ɹ i
orpiment	ɔ ɹ p ə m ə n t
orson	ɔ ɹ s ə n
orthodoxy	ɔ ɹ θ ə d ɑ k s i
orthoepic	ɔ r θ o ʊ ɛ p ɪ k
osier	o ʊ ʒ ə ɹ
oskemen	ɔ s k ə m ɛ n
osm	ɔ s ə m
osprey	ɑ s p ɹ i
ossetian	ɑ s e t i ə n
ossetic	ɑ s e t ɪ k
ostensible	ɑ s t ɛ n s ɪ b ə l
ostent	ɑ s t ɛ n t
osteophyte	ɑ s t i o ʊ f a ɪ t
osteoprotegerin	ɑ s t i o ʊ p ɹ ə t ɛ d͡ʒ ə ɹ ɪ n
ostracize	ɑ s t ɹ ə s a ɪ z
otira	o ʊ t ɪ ɹ ɑ
otitis	o ʊ t a ɪ t ɪ s
otorhinolaryngology	ɑ t ɔ ɹ a j n o l æ ɹ ɪ ŋ ɡ ɑ l ə d͡ʒ i
otto	ɑ t o ʊ
oughts	ɑ t s
ouroboric	ɔ ɹ ə b ɔ ɹ ɪ k
outargue	a ʊ ɾ ɑ ɹ ɡ j u
outbid	a ʊ t b ɪ d
outcaste	a ʊ t k æ s t
outcome	a ʊ t k ʌ m
outcrop	a ʊ t k ɹ ɑ p
outdated	a ʊ t d e ɪ t ɪ d
outfly	a ʊ t f l a ɪ
outgrow	ɑ ʊ t ɡ ɹ o ʊ
outlier	a ʊ t l a ɪ ə ɹ
outline	a ʊ t l a ɪ n
outpad	a ʊ t p æ d
output	a ʊ t p ʊ t
outre	u t ɹ e ɪ
outrecuidant	u t ə k w i d ə n t
outsiderness	a ʊ t s a ɪ d ɚ n ə s
outsold	ɑ ʊ t s ɔ l d
outsuave	a ʊ t s w ɑ v
outwall	a ʊ t w ɔ l
ovary	o ʊ v ə ɹ i
overact	o ʊ v ə ɹ æ k t
overawe	o ʊ v ɚ ɔ
overboard	o ʊ v ə ɹ b ɔ ɹ d
overdue	o ʊ v ə ɹ d u
overfloat	o ʊ v ə ɹ f l o ʊ t
overheat	o ʊ v ɚ h i t
overlaid	o ʊ v ɚ l e ɪ d
overlive	o ʊ v ə ɹ l ɪ v
overloading	o ʊ v ɚ l o ʊ d i ŋ
overnourished	o ʊ v ɚ n ʌ ɹ ɪ ʃ t
overnutrition	o ʊ v ə ɹ n j u t ɹ ɪ ʃ ə n
overpay	o ʊ v ɚ p e ɪ
overpopulated	o ʊ v ɚ p ɑ p j ə l e ɪ t ɪ d
overproof	o ʊ v ɚ p ɹ u f
overran	o ʊ v ɚ ɹ a n
overreactive	o ʊ v ə ɹ ɹ i æ k t ɪ v
overrule	o ʊ v ə ɹ ɹ u l
oversaw	o ʊ v ɚ s ɔ
overseas	o ʊ v ɚ s i z
oversow	o ʊ v ɚ s o ʊ
oversparred	o ʊ v ɚ s p ɑ ɹ d
overspecialization	o ʊ v ɚ s p ɛ ʃ ə l ɪ z e ɪ ʃ n̩
overspecialize	o ʊ v ɚ s p ɛ ʃ ə l a ɪ z
overspeed	o ʊ v ə r s p i d
overspray	o ʊ v ɚ s p ɹ e ɪ
overstuffed	o ʊ v ɚ s t ʌ f t
overswell	o ʊ v ɚ s w ɛ l
overtaken	o v ə ɹ t e ɪ k ə n
overtook	o ʊ v ɚ t ʊ k
overview	o ʊ v ə ɹ v j u
overwear	o ʊ v ə ɹ w ɛ ɹ
overweigh	o ʊ v ə ɹ w e ɪ
overwhelmed	o ʊ v ɚ w ɛ l m d
ovine	o ʊ v a ɪ n
ovovegetarian	o v o v ɛ d͡ʒ ɪ t ɛ ɹ i ə n
ow	a ʊ
owling	a ʊ l ɪ ŋ
oxbridge	ɑ k s b ɹ ɪ d͡ʒ
oxen	ɑ k s ə n
oxibendazole	ɔ k s ɪ b ɛ n d ə z o ʊ l
oxide	ɔ k s a ɪ d
oximeter	ɑ k s ɪ m ə t ɚ
oxish	ɑ k s ɪ ʃ
oxishly	ɑ k s ɪ ʃ l i
oxymetazoline	ɑ k s ɪ m ə t æ z ə l i n
oxytetracycline	ɑ k s ɪ t ɛ t ɹ ə s a ɪ k l i n
oxytocin	ɑ k s i t o ʊ s ɪ n
paan	p ɑ n
paced	p e ɪ s t
pacifist	p æ s ɪ f ɪ s t
pacts	p æ k t s
paddies	p æ d i z
paddock	p æ d ə k
padilla	p ə d i ə
paged	p e ɪ d͡ʒ d
paginate	p æ d͡ʒ ə n e ɪ t
painter	p e ɪ n t ɚ
paintings	p e ɪ n t ɪ ŋ z
pairs	p ɛ ɹ z
palau	p ə l a ʊ
palazzo	p ə l ɑ t s o ʊ
pale	p e ɪ l
palilogy	p ə l ɪ l ə d͡ʒ i
palliard	p æ l ɪ ə d
palliation	p æ l ɪ e ɪ ʃ ə n
palomino	p æ l ə m i n o ʊ
palpate	p æ l p e ɪ t
palsy	p ɔ l z i
palynivore	p ə l ɪ n ə v ɔ ɹ
pam	p æ m
pancuronium	p æ ŋ k j ə ɹ o ʊ n i ə m
pandeistically	p æ n d i ɪ s t ɪ k l i
pander	p æ n d ɚ
panendeism	p æ n ə n d i ɪ z ə m
pangu	p ɑ n ɡ u
panne	p æ n
panoptic	p a n ɔ p t ɪ k
panphilia	p æ n f ɪ l ɪ ə
pansexual	p æ n s ɛ k ʃ u ə l
pantechnicon	p æ n t ɛ k n ə k ə n
pantheism	p æ n θ i ɪ z ə m
pantheists	p æ n t h i ĭ s t s
pantings	p æ n t ɪ ŋ z
pantographer	p æ n t ɔ ɡ ɹ ə f ə ɹ
panyard	p æ n j ɔ d
paper	p e ɪ p ɚ
parable	p æ ɹ ə b ə l
parachronism	p ɚ æ k ɹ ə n ɪ z m
paraclete	p æ ɹ ə k l i t
paradiddle	p æ ɹ ə d ɪ d ə l
paradoxical	p ɛ ɹ ə d ɑ k s ɪ k ə l
paradoxography	p ɛ ɹ ə d ɑ k s ɑ ɡ ɹ ə f i
paraenesis	p ə ɹ i n ɪ s ɪ s
paraenetical	p æ ɹ ə n ɛ d ɪ k ə l
paragraphs	p ɛ ɹ ə ɡ ɹ æ f s
parallel	p æ ɹ ə l ɛ l
paralysant	p æ ɹ ə l a ɪ z ə n t
paralytic	p æ ɹ ə l ɪ t ɪ k
paramour	p æ ɹ ə m ɔ ɹ
paranoia	p ɛ ɹ ə n ɔ ɪ ə
parapet	p æ ɹ ə p ɪ t
paraphilia	p a r ə f ɪ l ɪ ə
parasitic	p ɛ ɹ ə s ɪ t ɪ k
parcel	p ɑ ɹ s ə l
pardon	p ɑ ɹ d n̩
paren	p ə ɹ ɛ n
parfilage	p ɑ ɹ f ɪ l ɑ ʒ
pargeted	p ɑ ɹ d͡ʒ ɪ t ɪ d
parhelion	p ɑ h i l ɪ ə n
paritor	p æ ɹ ɪ t ə ɹ
parka	p ɑ ɹ k ə
parker	p ɑ ɹ k ɚ
parking	p ɑ ɹ k ɪ ŋ
parkour	p ɑ ɹ k ʊ ɹ
parley	p ɑ ɹ l i
parlour	p ɑ ɹ l ɚ
parmigiana	p ɑ ɹ m ə ʒ ɑ n ə
parochial	p ə ɹ o ʊ k i ə l
paroxysmal	p æ ɹ ə k s ɪ z m ə l
parquet	p ɑ ɹ k e ɪ
parry	p æ ɹ i
parse	p ɑ ɹ s
parsimonious	p ɑ ɹ s ɪ m o͡ʊ n i ə s
parthian	p ɑ ɹ θ i ə n
participate	p ɑ ɹ t ɪ s ɪ p e ɪ t
participation	p ɑ ɹ t ɪ s ɪ p e ɪ ʃ ə n
parties	p ɑ ɹ t i z
pash	p æ ʃ
passaic	p ə s e ɪ ɪ k
passata	p ə s ɑ t ə
passively	p æ s ɪ v l i
passless	p æ s l ə s
pasta	p ɑ s t ə
paste	p e ɪ s t
pastern	p æ s t ə ɹ n
pastor	p æ s t ɚ
pasture	p æ s t͡ʃ ɚ
pat	p æ t
patching	p æ t͡ʃ ɪ ŋ
paten	p æ t ə n
paternal	p ə t ɜ ɹ n ə l
paternity	p ə t ɜ ɹ n ɪ t i
paternoster	p ɑ t ə ɹ n ɔ s t ɚ
pathetically	p ə θ ɛ t ɪ k l i
patiently	p e ɪ ʃ ə n t l i
patriality	p e ɪ t ɹ i æ l ɪ t i
patricia	p ə t ɹ ɪ ʃ ə
patrick	p æ t ɹ ɪ k
patriot	p e ɪ t͡ʃ ɹ i ə t
patsy	p æ t s i
patting	p æ t ɪ ŋ
paua	p ɑ w ə
paurometabolous	p ɔ ɹ o ʊ m ɪ t æ b ə l ə s
paved	p e ɪ v d
paver	p e ɪ v ɚ
pavid	p æ v ɪ d
paving	p e ɪ v ɪ ŋ
pawl	p ɔ l
pay	p e ɪ
paying	p e ɪ ɪ ŋ
pays	p e ɪ z
pc	p i s i
peaceful	p i s f ə l
peacefully	p i s f ə l i
peachy	p i t͡ʃ i
peaky	p i k i
peals	p i l z
peas	p i z
peasants	p ɛ z ə n t s
peat	p i t
pebbles	p ɛ b ə l z
peccaminous	p ə k æ m ɪ n ə s
pecked	p ɛ k t
pecker	p ɛ k ə ɹ
pecking	p ɛ k ɪ ŋ
peckings	p ɛ k ɪ ŋ z
pecs	p ɛ k s
peculiarities	p ɪ k j u l i ɛ ɹ ɪ t i z
pecunious	p ɪ k j u n i ə s
ped	p ɛ d
pedagogic	p ɛ d ə ɡ ɑ d͡ʒ ɪ k
pedernales	p ɝ d ɪ n æ l ɪ s
pedication	p ɛ d ɪ k e ɪ ʃ ə n
pedomorphic	p ɛ d ə m ɔ ɹ f ɪ k
peek	p i k
peeks	p i k s
peeped	p i p t
peeves	p i v z
peewah	p i w ɑ
pegging	p ɛ ɡ ɪ ŋ
peggy	p ɛ ɡ i
peke	p i k
pell	p ɛ l
peloponnese	p ɛ l ə p ə n i s
pelvis	p ɛ l v ɪ s
penetrated	p ɛ n ɪ t ɹ e ɪ t ɪ d
penicillanic	p ɛ n ɪ s ɪ l æ n ɪ k
penis	p i n ɪ s
penitentiary	p ɛ n ɪ t ɛ n ʃ ə ɹ i
pennant	p ɛ n ə n t
penne	p ɛ n e ɪ
penned	p ɛ n d
pennies	p ɛ n i z
pennon	p ɛ n ə n
pennsylvanian	p ɛ n s ʊ l v e ɪ̯ n j ɪ n
penny	p ɛ n i
penryn	p ɛ n ɹ ɪ n
pentacle	p ɛ n t ə k l̩
pentamethylenetetrazol	p ɛ n t ə m ɛ θ ɪ l i n t ɛ t ɹ ə z ɔ l
pentecost	p ɛ n t ɪ k ɔ s t
penultimate	p ɪ n ʌ l t ɪ m ə t
penzance	p ɛ n z æ n s
peoples	p i p ə l z
peppery	p ɛ p ə ɹ i
pepsin	p ɛ p s ɪ n
peptic	p ɛ p t ɪ k
peptics	p ɛ p t ɪ k s
pepys	p i p s
pequot	p i k w ɔ t
perc	p ɝ k
perceived	p ɚ s i v d
perceiving	p ɚ s i v ɪ ŋ
percent	p ɚ s ɛ n t
percentage	p ɚ s ɛ n t ɪ d͡ʒ
percolate	p ə ɹ k ə l e ɪ t
percolator	p ɝ k ə l e ɪ t ɚ
perdu	p ɜ ɹ d j u
peregrination	p ɛ ɹ ɪ ɡ ɹ ɪ n e ɪ ʃ ə n
peregrine	p e ɹ ɪ ɡ ɹ ɪ n
perfective	p ə ɹ f ɛ k t ɪ v
perfectly	p ɝ f ɪ k t l i
performed	p ɚ f ɔ ɹ m d
perfunctorily	p ə ɹ f ʌ ŋ k t ə ɹ ɪ l i
periastron	p ɛ ɹ ɪ æ s t ɹ ə n
perihelium	p ɛ ɹ ə h i l ɪ ə m
perimeter	p ə ɹ ɪ m ɪ t ə ɹ
periodical	p ɪ ɹ i ɑ d ɪ k l̩
periphrastic	p ɛ ɹ ə f ɹ æ s t ɪ k
perissology	p ɛ ɹ ɪ s ɔ l ə d͡ʒ i
peristaltic	p ɛ r ə s t ɔ l t ɪ k
perjury	p ɜ ɹ d͡ʒ ə ɹ i
perlection	p ə l ɛ k ʃ ə n
perm	p ɝ m
permablock	p ɜ ɹ m ə b l ɔ k
permafuck	p ɜ ɹ m ə f ʌ k
pernio	p ɝ n i o ʊ
perplexed	p ɚ p l ɛ k s t
perquisite	p ɜ ɹ k w ə z ɪ t
perrisodactyl	p ɛ ɹ ɪ s o ʊ d æ k t ɪ l
perscopate	p ɜ s k ə p e ɪ t
persecute	p ɝ s ə k j u t
perseverate	p ɚ s ɛ v ə ɹ e ɪ t
perseverative	p ɚ s ɛ v ɚ ɹ e ɪ t ɪ v
persimmon	p ə ɹ s ɪ m ə n
persist	p ɚ s ɪ s t
persisted	p ɚ s ɪ s t ɪ d
personable	p ɜ ɹ s ə n ə b ə l
persuade	p ɚ s w e ɪ d
persuasive	p ə ɹ s w e ɪ s ɪ v
pertain	p ɚ t e ɪ n
pertaining	p ɚ t e ɪ n ɪ ŋ
pertinency	p ɜ ɹ t ɪ n ə n s i
perturb	p ɚ t ɝ b
perturbate	p ɜ ɹ t ə ɹ b e ɪ t
pertussis	p ə t ʌ s ɪ s
peruse	p ə ɹ u z
perverter	p ə ɹ v ɜ ɹ t ə ɹ
petalous	p ɛ t ə l ə s
petrichor	p ɛ t ɹ ɪ k ɚ
petrogenetic	p ɛ t ɹ o ʊ d͡ʒ ə n ɛ t ɪ k
petroleum	p ə t ɹ o ʊ l i ə m
petunia	p ə t u n j ə
peyote	p e ɪ j o ʊ t i
phage	f e ɪ d͡ʒ
phallic	f æ l ɪ k
phantasm	f æ n t æ z ə m
pharaonic	f ɛ ɹ e ɪ ɔ n ɪ k
pharisaic	f ɛ ɹ ɪ s e ɪ j ɪ k
pharmaceutical	f ɑ ɹ m ə s j u t ɪ k l̩
pharmacovigilant	f ɑ ɹ m ə k o ʊ v i d͡ʒ i l ə n t
phase	f e ɪ z
phasings	f e ɪ z ɪ ŋ z
phasmid	f æ z m ɪ d
phatic	f æ t ɪ k
pheasant	f ɛ z ə n t
phenobarbital	f i n o ʊ b ɑ ɹ b ə t ɔ l
phenomena	f ɪ n ɑ m ə n ə
phenoxybenzamine	f ɪ n ɑ k s i b ɛ n z ə m i n
phew	f j u
phil	f ɪ l
philadelphia	f ɪ l ə d ɛ l f i ə
philanthrop	f i l a n t ʁ o p
philematology	f ɪ l i m ə t ɑ l ə d͡ʒ i
philippic	f ɪ l ɪ p ɪ k
phillip	f ɪ l ɪ p
philostorgy	f ɪ l ə s t ɔ ɹ d͡ʒ i
phlebitis	f l ɪ b a ɪ t ɪ s
phobic	f o ʊ b ɪ k
phoenix	f i n ɪ k s
phoned	f o ʊ n d
phonetic	f ə n ɛ t ɪ k
phonologize	f ə n ɔ l ə d͡ʒ a ɪ z
phonology	f ə n ɑ l ə d͡ʒ i
photograph	f o ʊ t ə ɡ ɹ æ f
photographic	f o ʊ t ə ɡ ɹ æ f ɪ k
photography	f ə t ɑ ɡ ɹ ə f i
phrase	f ɹ e ɪ z
phrases	f ɹ e ɪ z ɪ z
phrasing	f ɹ e ɪ z ɪ ŋ
phratry	f ɹ æ t ɹ i
phthalic	f θ æ l ɪ k
phuket	p u k ɛ t
phylaxis	f ɪ l æ k s ɪ s
phylogenetics	f a ɪ l ə d͡ʒ ə n ɛ t ɪ k s
physic	f ɪ z ɪ k
physical	f ɪ z ɪ k ə l
physiognomy	f ɪ z i ɑ n ə m i
phytoestrogen	f a ɪ t o ʊ ɛ s t ɹ ə d͡ʒ ə n
phytomenadione	f a ɪ t o ʊ m ɛ n ə d a ɪ o ʊ n
pic	p ɪ k
picaroon	p ɪ k ə ɹ u n
picene	p a ɪ s i n
piceous	p ɪ s i ə s
pickings	p ɪ k ɪ ŋ z
pickling	p ɪ k l ɪ ŋ
picnics	p ɪ k n ɪ k s
picul	p ɪ k ə l
pieces	p i s ɪ z
piedmont	p i d m ɔ n t
piffle	p ɪ f ə l
piggott	p ɪ ɡ ə t
pile	p a ɪ l
piles	p a ɪ l z
pilgrimage	p ɪ l ɡ ɹ ɪ m ɪ d͡ʒ
pillowcase	p ɪ l o ʊ k e ɪ s
pima	p i m ə
pimped	p ɪ m p t
pinax	p ɪ n æ k s
pindar	p ɪ n d ɚ
pine	p a ɪ n
pined	p a ɪ n d
pines	p a ɪ n z
ping	p ɪ ŋ
pingo	p ɪ ŋ ɡ o ʊ
pining	p a ɪ n ɪ ŋ
pinings	p a ɪ n ɪ ŋ z
pinko	p ɪ ŋ k o ʊ
pinna	p ɪ n ə
pinnacle	p ɪ n ə k ə l
pinny	p ɪ n i
pinoy	p i n ɔ ɪ
pint	p a ɪ n t
pintle	p ɪ n t ə l
pioglitazone	p a ɪ ə ɡ l ɪ t ə z o ʊ n
pion	p a ɪ ɔ n
pipeline	p a ɪ p l a ɪ n
pipes	p a ɪ p s
piphilology	p a ɪ f ɪ l ɑ l ə d͡ʒ i
pipings	p a ɪ p ɪ ŋ z
pips	p ɪ p s
piques	p i k s
pirates	p a ɪ ɹ ə t s
pishogue	p ɪ ʃ o ʊ ɡ
pistol	p ɪ s t ə l
pitchpole	p ɪ t͡ʃ p o ʊ l
pitchy	p ɪ t͡ʃ i
pithy	p ɪ θ i
pitiable	p ɪ t i ə b ə l
pittance	p ɪ t ə n s
pixie	p ɪ k s i
placate	p l e ɪ k e ɪ t
placed	p l e ɪ s t
placement	p l e ɪ s m ə n t
placenta	p l ə s ɛ n t ə
places	p l e ɪ s ɪ z
placing	p l e ɪ s ɪ ŋ
plack	p l æ k
placket	p l æ k ɪ t
plagal	p l e ɪ ɡ ə l
plague	p l e ɪ ɡ
plagues	p l e ɪ ɡ z
plan	p l æ n
planar	p l e ɪ n ɚ
planche	p l ɑ n t͡ʃ
plane	p l e ɪ n
planemo	p l æ n ə m o ʊ
planemos	p l æ n ə m o ʊ s
planing	p l e ɪ n ɪ ŋ
planktivore	p l æ ŋ k t ɪ v ɔ ɹ
plans	p l æ n z
plantings	p l æ n t ɪ ŋ z
planular	p l æ n ə l ɚ
plaque	p l æ k
plaster	p l æ s t ɚ
platform	p l æ t f ɔ ɹ m
plays	p l e ɪ z
pleaded	p l i d ə d
pleasantly	p l ɛ z ə n t l i
pleasures	p l ɛ ʒ ɚ z
plectrum	p l ɛ k t ɹ ə m
plenilune	p l i n ɪ l u n
plentifully	p l ɛ n t ɪ f ə l i
plenum	p l i n ə m
plethora	p l ɛ θ ə ɹ ə
plicamycin	p l a ɪ k ə m a ɪ s n̩
plies	p l a ɪ z
plonk	p l ɑ ŋ k
plot	p l ɑ t
pluck	p l ʌ k
pluckings	p l ʌ k ɪ ŋ z
plugged	p l ʌ ɡ d
plugola	p l ʌ ɡ o ʊ l ə
plume	p l u m
plummet	p l ʌ m ə t
plummy	p l ʌ m i
plunging	p l ʌ n d͡ʒ ɪ ŋ
pluot	p l u ɔ t
pluperfect	p l u p ɜ ɹ f ɛ k t
plurisubharmonicity	p l u ɹ ɪ s ʌ b h ɑ ɹ m ə n ɪ s ɪ t i
plush	p l ʌ ʃ
plymouth	p l ɪ m ə θ
pneumonialike	n u m o ʊ n j ə l a ɪ k
po	p o ʊ
poach	p o ʊ t͡ʃ
pococurantism	p o ʊ k o ʊ k j ʊ ɹ æ n t ɪ z ə m
podiatry	p ə d a ɪ ə t ɹ i
podocarpus	p o ʊ d ə k ɑ ɹ p ə s
poikilocytosis	p ɔ ɪ k ə l o ʊ s a ɪ t o ʊ s ɪ s
pointer	p ɔ ɪ n t ə
poison	p ɔ ɪ z ə n
poisoned	p ɔ ɪ z n̩ d
pokes	p o ʊ k s
poking	p o ʊ k ɪ ŋ
pol	p ɑ l
polari	p ə l ɑ r i
polarity	p ə l æ r ɪ t i
polarization	p o ʊ l ə r ɪ z e ɪ ʃ ə n
polhode	p ɔ l h o ʊ d
policy	p ɑ l ə s i
politburo	p ɑ l ə t b j ʊ ɹ o ʊ
politely	p ə l a ɪ t l i
politic	p ɑ l ə t ɪ k
polity	p ɑ l ɪ t i
polled	p o ʊ l d
pollinivore	p ɑ l ɪ n ə v ɔ ɹ
polychoron	p ɔ l i k o ʊ ɹ ɔ n
polygon	p ɑ l i ɡ ɑ n
polymer	p ɑ l ɪ m ɚ
polytech	p ɔ l i t ɛ k
polytheistic	p ɔ l ɪ θ i ɪ s t ɪ k
pom	p ɔ m
pomerania	p ɔ m ə ɹ e ɪ n i ə
pomset	p ɔ m s ɛ t
pomtini	p ɑ m t i n i
pone	p o ʊ n i
ponytail	p o ʊ n i t e ɪ l
ponzi	p ɑ n z i
pooped	p u p t
pooping	p u p ɪ ŋ
poplar	p ɔ p l ə ɹ
poppets	p ɔ p ɪ t s
porphyrin	p ɔ ɹ f ə ɹ ɪ n
porpoise	p ɔ ɹ p ə s
portagee	p ɔ ɹ t ə ɡ i
ported	p ɔ ɹ t ɪ d
portend	p ɔ ɹ t ɛ n d
portent	p ɔ ɹ t ɛ n t
portentously	p ɔ t e n t ə s l i
portoferraio	p ɔ ɹ t o ʊ f ə ɹ a ɪ o ʊ
portrayal	p ɔ ɹ t ɹ e ɪ ə l
posing	p o ʊ z ɪ ŋ
positively	p ɔ z ɪ t ɪ v l i
posology	p ə z ɑ l ə d͡ʒ i
post	p o ʊ s t
posted	p o ʊ s t ɪ d
posterize	p o ʊ s t ə ɹ a ɪ z
posthaste	p o ʊ s t h e ɪ s t
postic	p ɔ s t ɪ k
postings	p o ʊ s t ɪ ŋ z
postpone	p o ʊ s t p o ʊ n
postscript	p o ʊ s t s k ɹ ɪ p t
potocytosis	p o ʊ t o ʊ s a ɪ t o ʊ s ɪ s
potomac	p ə t o ʊ m ə k
pouncing	p a ʊ n s ɪ ŋ
pour	p ɔ ɹ
povitica	p o ʊ v ə t i t s ə
powdered	p a ʊ d ɚ d
powders	p a ʊ d ɚ z
powers	p a ʊ ɚ z
pox	p ɑ k s
pozzy	p ɔ z i
practice	p ɹ æ k t ɪ s
practices	p ɹ æ k t ɪ s ɪ z
practicum	p ɹ æ k t ɪ k ə m
practise	p ɹ æ k t ɪ s
practised	p ɹ æ k t ɪ s t
praemunire	p ɹ i m j ə n ɪ ɹ i
pragmatical	p ɹ æ ɡ m æ t ɪ k ə l
prague	p ɹ ɑ ɡ
praia	p ɹ a ɪ ə
praises	p ɹ e ɪ z ɪ z
praisings	p ɹ e ɪ z ɪ ŋ z
prandial	p ɹ æ n d i ə l
prang	p ɹ æ ŋ
praseodymium	p ɹ e ɪ z i o ʊ d ɪ m i ə m
preacher	p ɹ i t͡ʃ ɚ
preaching	p ɹ i t͡ʃ ɪ ŋ
prebendary	p ɹ ɛ b ə n d ə ɹ i
precautions	p ɹ i k ɔ ʃ ə n z
precedency	p ɹ ɛ s ɪ d ə n s i
preclusive	p ɹ ɛ k l u s ɪ v
precognitive	p ɹ i k ɑ ɡ n ə t ɪ v
predecease	p ɹ i d ə s i s
predilection	p ɹ ɛ d ə l ɛ k ʃ n̩
preengage	p r i ɪ n ɡ e ɪ d͡ʒ
preeternity	p ɹ i ɪ t ɜ ɹ n ɪ t i
preferable	p ɹ ɛ f ə ɹ ə b ə l
preferrable	p ɹ ə f ɜ ɹ ə b ə l
preke	p ɹ i k
premarin	p ɹ ɛ m ə ɹ ɪ n
premier	p ɹ ɪ m ɪ ə ɹ
premise	p ɹ ɛ m ɪ s
prenuptual	p ɹ i n ʌ p t͡ʃ w ə ɫ
preoccupy	p ɹ i ɑ k j u p a ɪ
prep	p ɹ ɛ p
prepaid	p ɹ i p e ɪ d
preparative	p ɹ ə p æ ɹ ə t ɪ v
prepend	p ɹ ɪ p ɛ n d
preprandially	p ɹ i p ɹ æ n d i ə l i
preps	p ɹ ɛ p s
presbyterian	p ɹ e z b ɪ t ɪ ɹ i ə n
prescribed	p ɹ ə s k ɹ a ɪ b d
presentative	p ɹ ə z ɛ n t ə t ɪ v
presidentiable	p ɹ ɛ z ɪ d ɛ n ʃ ə b ə l
presto	p ɹ ɛ s t o ʊ
prestwich	p ɹ ɛ s t w ɪ t͡ʃ
presuit	p ɹ ɪ s j u t
presumably	p ɹ ɪ z u m ə b l i
pretended	p ɹ ɪ t ɛ n d ɪ d
preternatural	p ɹ i t ɚ n æ t͡ʃ ə ɹ ə l
pretzel	p ɹ ɛ t s ə l
prevailing	p ɹ ɪ v e ɪ l ɪ ŋ
prevented	p ɹ ɪ v ɛ n t ɪ d
prevention	p ɹ ɪ v ɛ n ʃ ə n
preventive	p ɹ ɪ v ɛ n t ɪ v
preys	p ɹ e ɪ z
prider	p ɹ a ɪ d ɚ
priding	p ɹ a ɪ d ɪ ŋ
priesthood	p ɹ i s t h ʊ d
priestly	p ɹ i s t l i
priests	p ɹ i s t s
prim	p ɹ ɪ m
primacy	p ɹ a ɪ m ə s i
primal	p ɹ a ɪ m ə l
primate	p ɹ a ɪ m e ɪ t
primitia	p ɹ ɪ m ɪ ʃ ə
primity	p ɹ ɪ m ɪ t i
primordial	p ɹ a ɪ m ɔ ɹ d i ə l
prince	p ɹ ɪ n s
printings	p ɹ ɪ n t ɪ ŋ z
prised	p ɹ a ɪ z d
prism	p ɹ ɪ z ə m
prithee	p ɹ ɪ ð i
privacy	p ɹ a ɪ v ə s i
probability	p ɹ ɑ b ə b ɪ l ɪ ɾ i
probable	p ɹ ɑ b ə b l̩
procacious	p ɹ ə k e ɪ ʃ ə s
procedures	p ɹ ə s i d͡ʒ ɚ s
processor	p ɹ ɑ s ɛ s ə ˞
prochlorperazine	p ɹ o ʊ k l ɔ ɹ p ɛ ɹ ə z i n
proclaim	p ɹ o ʊ k l e ɪ m
procraltruism	p ɹ o ʊ k ɹ ɑ l t ɹ u ɪ s ɪ z ə m̩
prodelision	p ɹ o ʊ d ə l ɪ ʒ n̩
proditor	p ɹ ɑ d ɪ t ɚ
produces	p ɹ ə d u s ɪ z
producing	p ɹ ə d u s ɪ ŋ
productivity	p ɹ o ʊ d ʌ k t ɪ v ə t i
profession	p ɹ ə f ɛ ʃ ə n
profusely	p ɹ ə f j u s l i
prog	p ɹ ɔ ɡ
programming	p ɹ o ʊ ɡ ɹ æ m ɪ ŋ
programs	p ɹ o ʊ ɡ ɹ æ m s
prole	p ɹ o ʊ l
prolepsis	p ɹ o ʊ l ɛ p s ɪ s
proletaire	p ɹ o ʊ l ɪ t ɛ ɹ
proletary	p ɹ o ʊ l ɪ t ɛ ɹ i
prolong	p ɹ o ʊ l ɔ ŋ
prolyl	p ɹ o ʊ l ɪ l
prominent	p ɹ ɑ m ɪ n ə n t
prominently	p ɹ ɑ m ɪ n ə n t l i
promiscuous	p ɹ ə m ɪ s k j u ə s
promises	p ɹ ɑ m ɪ s ɪ z
prompt	p ɹ ɑ m p t
prompted	p ɹ ɑ m p t ɪ d
pronto	p ɹ ɑ n t o ʊ
proofed	p ɹ u f t
proofings	p ɹ u f ɪ ŋ z
propel	p ɹ ə p ɛ l
proper	p ɹ ɑ p ɚ
properties	p ɹ ɑ p ɚ t i z
prophecy	p ɹ ɑ f ə s i
prophesy	p ɹ ɑ f ɪ s a ɪ
proportionality	p ɹ ə p ɔ ɹ ʃ ɪ n æ l ɪ t i
proprioception	p ɹ o ʊ p ɹ i o ʊ s ɛ p ʃ ə n
prosaic	p ɹ o ʊ z e ɪ ɪ k
proscenium	p ɹ o ʊ s i n i ə m
prose	p ɹ o ʊ z
proselyting	p ɹ ɔ s ə l a ɪ t ɪ ŋ
prosewise	p ɹ o ʊ z w a ɪ z
prosit	p ɹ o ʊ z ɪ t
prosperous	p ɹ ɑ s p ə ɹ ə s
prostrate	p ɹ ɑ s t ɹ e ɪ t
protactinium	p ɹ o ʊ t æ k t ɪ n i ə m
protandrogonous	p ɹ o ʊ t æ n d ɹ ɑ ɡ ə n ə s
protaspis	p ɹ ə t æ s p ə s
protectorate	p ɹ ə t ɛ k t ə ɹ ɪ t
protonation	p ɹ o ʊ t ə n e ɪ ʃ ə n
prototypical	p ɹ o ʊ t ə t ɪ p ɪ k ə l
protyle	p ɹ o ʊ t a ɪ l
proudly	p ɹ a ʊ d l i
proustian	p ɹ u s t i ə n
provenance	p ɹ ɑ v ə n ə n s
proverb	p ɹ ɑ v ɝ b
proving	p ɹ u v ɪ ŋ
provocate	p ɹ ə v ɑ k e ɪ t
provocative	p ɹ ə v ɑ k ə t ɪ v
prowl	p ɹ a ʊ l
proxy	p ɹ ɑ k s i
prucalopride	p ɹ u k æ l ə p ɹ a ɪ d
psaki	s ɑ k i
psalmody	s ɑ m ə d i
pschent	s k ɛ n t
psephology	s i f ɑ l ə d͡ʒ i
pseud	s u d
pseudoactive	p s u d o ʊ a k t ɪ v
pseudometeorite	s u d o ʊ m i t i ɚ a ɪ t
psilocybin	s a ɪ l ə s a ɪ b ɪ n
psych	s a ɪ k
psychological	s a ɪ k ə l ɑ d͡ʒ ɪ k l
psychomanteum	s a ɪ k o ʊ m æ n t i ə m
psychopathological	s a ɪ k o ʊ p æ θ ə l ɑ d͡ʒ ɪ k ə l
psychopaths	s a ɪ k o ʊ p æ θ s
psychopomp	s a ɪ k o ʊ p ɑ m p
psychosis	s a ɪ k o ʊ s ɪ s
psychotic	s a ɪ k ɔ t ɪ k
pterion	t ɛ ɹ ɪ ə n
ptolemaic	t ɑ l ə m e ɪ ɪ k
publican	p ʌ b l ɪ k ə n
pubs	p ʌ b z
pucks	p ʌ k s
puddle	p ʌ d ə l
pudeur	p j u d ɝ
pudibund	p j u d ɪ b ʌ n d
puellile	p j u l a ɪ l
puer	p j u ɚ
puff	p ʌ f
puffed	p ʌ f t
pug	p ʌ ɡ
pugh	p j u
puka	p u k ə
puker	p j u k ə ɹ
puketastic	p j u k t æ s t ɪ k
pule	p j u l
pulegone	p j u l ə ɡ o ʊ n
pulley	p ʊ l i
pulsate	p ʌ l s e ɪ t
pumped	p ʌ m p t
pumps	p ʌ m p s
punch	p ʌ n t͡ʃ
pungency	p ʌ n d͡ʒ ə n s i
punishings	p ʌ n ɪ ʃ ɪ ŋ z
punkie	p ʌ ŋ k i
puntilla	p ʊ n t i ə
purblind	p ɜ ɹ b l a ɪ n d
purge	p ɝ d͡ʒ
purify	p j ʊ ə ɹ ɪ f a ɪ
purlieu	p ɝ l j u
purposiveness	p ɜ ɹ p ə s ɪ v n ə s
pushbike	p ʊ ʃ b a ɪ k
pushpin	p ʊ ʃ p ɪ n
putonghua	p u t ɔ ŋ w ɑ
putrid	p j u t ɹ ə d
puts	p ʊ t s
putt	p ʌ t
pygostyle	p a ɪ ɡ ə s t a ɪ l
pyment	p ə m ɛ n t
pyramidoid	p ɪ ɹ æ m ɪ d ɔ ɪ d
pyramis	p ɪ ɹ ə m ɪ s
pyrethrum	p a ɪ ɹ i θ ɹ ə m
pyroballogy	p a ɪ ɹ o ʊ b æ l ə d͡ʒ i
pyrotechnic	p a ɪ ɹ o ʊ t ɛ k n ɪ k
pyroxene	p a ɪ ɹ ɑ k s i n
pythagorize	p ə θ æ ɡ ə ɹ a ɪ z
pythons	p a ɪ θ ɑ n z
qam	k j u e ɪ ɛ m
qantas	k w ɔ n t ə s
qingdao	t͡ʃ ɪ ŋ d a ʊ
quack	k w æ k
quadratus	k w ɑ d r e ɪ t ə s
quadrennial	k w ɑ d ɹ ɛ n i ə l
quadriplegia	k w ɑ d ɹ ɪ p l i d͡ʒ ə
quadriplegic	k w ɑ d ɹ ɪ p l i d͡ʒ ɪ k
quadrivalent	k w ɔ d r ɪ v e ɪ l ə n t
quaestor	k w i s t ɚ
quaker	k w e ɪ k ɚ
qualitative	k w ɑ l ɪ t e ɪ t ɪ v
quantities	k w ɑ n t ɪ t i z
quanzhou	t͡ʃ w ɑ n d͡ʒ o ʊ
quarl	k w ɔ ɹ l
quarrel	k w ɔ ɹ ə l
quarreler	k w ɔ ɹ ə l ɜ ɹ
quarry	k w ɔ ɹ i
quaternary	k w ɑ t ɚ n ɛ ɹ i
queach	k w i t͡ʃ
queachy	k w i t͡ʃ i
quebracho	k ɪ b ɹ ɑ t͡ʃ o ʊ
queensland	k w i n z l ə n d
quentin	k w ɛ n t ɪ n
quesadilla	k e ɪ̯ s ə d i j ə
queso	k e ɪ s o ʊ
questionable	k w ɛ s t͡ʃ ə n ə b l̩
quethe	k w i ð
quid	k w ɪ d
quidditch	k w ɪ d ɪ t͡ʃ
quiddle	k w ɪ d ə l
quiet	k w a ɪ ɪ t
quill	k w ɪ l
quinalbarbitone	k w ɪ n ə l b ɑ b ɪ t o ʊ n
quincuncial	k w ɪ n k ʌ n ʃ ə l
quine	k w a ɪ n
quinkan	k w ɪ ŋ k ə n
quinquangle	k w ɪ ŋ k w æ ŋ ɡ ə l
quinsy	k w ɪ n z i
quintillionth	k w ɪ n t ɪ l i ə n θ
quitted	k w ɪ t ə d
quoin	k ɔ ɪ n
quondam	k w ɔ n d ə m
rabeprazole	ɹ ə b ɛ p ɹ ə z o ʊ l
rabies	ɹ e ɪ b i z
race	ɹ e ɪ s
races	ɹ e ɪ s ɪ z
rach	ɹ e ɪ t͡ʃ
rachis	ɹ e ɪ k ɪ s
rackle	ɹ æ k ə l
radargram	ɹ e ɪ d ɑ ɹ ɡ ɹ æ m
radge	ɹ æ d͡ʒ
radio	ɹ e ɪ d i o ʊ
radipraxy	ɹ æ d ɪ p ɹ æ k s i
rafie	ɹ ɑ ɹ f i
rage	ɹ e ɪ d͡ʒ
railgun	ɹ e ɪ l ɡ ʌ n
rained	ɹ e ɪ n d
rainish	ɹ e ɪ n ɪ ʃ
rains	ɹ e ɪ n z
rainshade	ɹ e ɪ n ʃ e ɪ d
rake	ɹ e ɪ k
rally	ɹ æ l i
ralph	ɹ æ l f
ramekin	ɹ æ m ɪ k ɪ n
rampage	ɹ æ m p e ɪ d͡ʒ
ranch	ɹ æ n t͡ʃ
randall	ɹ æ n d ə l
rando	ɹ æ n d o ʊ
ranger	ɹ e ɪ n d͡ʒ ɚ
rangle	ɹ æ ŋ ɡ l̩
rankle	ɹ æ ŋ k ə l
rannygazoo	ɹ æ n i ɡ ə z u
rantistirion	ɹ æ n t i s t ɪ ɹ i ɑ n
rape	ɹ e ɪ p
raper	ɹ e ɪ p ə ɹ
rapidity	ɹ ə p ɪ d ɪ t i
rapiered	ɹ e ɪ p ɪ ə ɹ d
rapunzel	ɹ ə p ʌ n z ə l
rascal	ɹ æ s k l̩
rash	ɹ æ ʃ
rasher	ɹ æ ʃ ə ɹ
raspy	ɹ æ s p i
rat	ɹ æ t
ratel	ɹ ɑ t ə l
ration	ɹ æ ʃ ə n
rats	ɹ æ t s
raunchy	ɹ ɔ n t͡ʃ i
ravage	ɹ æ v ɪ d͡ʒ
ravel	ɹ æ v ə l
ravening	ɹ æ v ə n ɪ ŋ
raves	ɹ e ɪ v z
reaccess	ɹ i æ k s ɛ s
reaction	ɹ i æ k ʃ ə n
reactionary	ɹ i æ k ʃ ə n ɛ ɹ i
reads	ɹ i d z
reaganauts	ɹ e ɪ ɡ ə n n ɔ t s
reagent	ɹ i e ɪ d͡ʒ ɛ n t
realised	ɹ i ə l a ɪ z d
realistic	ɹ i j ə l ɪ s t ɪ k
realizable	ɹ i ə l a ɪ z ə b l̩
reap	ɹ i p
reaping	ɹ i p ɪ ŋ
rearward	ɹ ɪ ɹ w ɝ d
rebel	ɹ ɛ b ə l
rebellion	ɹ ɪ b ɛ l i ə n
rebukement	ɹ i b j u k m ə n t
recalcitrate	ɹ ɪ k æ l s ɪ t ɹ e ɪ t
recallism	ɹ i k ɔ l ɪ z ə m
recce	ɹ ɛ k i
receivability	ɹ ə s i v ɑ b ɪ l ɪ t i
recency	ɹ i s ə n s i
reckon	ɹ ɛ k ə n
recognized	ɹ ɛ k ə ɡ n a ɪ z d
recommend	ɹ ɛ k ə m ɛ n d
reconduct	ɹ i k ə n d ʌ k t
reconstituting	ɹ i k ɑ n s t ɪ t j u t ɪ ŋ
recoup	ɹ ɪ k u p
recreancy	ɹ ɛ k ɹ i ə n s i
recruit	ɹ ɪ k ɹ u t
recto	ɹ ɛ k t o ʊ
recusal	ɹ ɪ k j u z ə l
recuse	ɹ ɪ k j u z
reddish	ɹ ɛ d ɪ ʃ
reddition	ɹ ə d ɪ ʃ ə n
redex	ɹ i d ɛ k s
redig	ɹ i d ɪ ɡ
redistrict	ɹ i d ɪ s t ɹ ɪ k t
redmond	ɹ ɛ d m ə n d
redone	ɹ i d ʌ n
redowa	ɹ ɛ d ə v ə
reduce	ɹ ɪ d u s
reduction	ɹ ɪ d ʌ k ʃ ə n
reeden	ɹ i d ə n
refer	ɹ ɪ f ɝ
referent	ɹ ɛ f ə ɹ ə n t
refill	ɹ i f ɪ l
refined	ɹ i f a ɪ n d
reflect	ɹ ɪ f l ɛ k t
reflecting	ɹ ɪ f l ɛ k t ɪ ŋ
reflections	ɹ ɪ f l ɛ k ʃ ə n z
reflexible	ɹ ɪ f l ɛ k s ɪ b ə l
reflexive	ɹ ə f l ɛ k s ɪ v
reformation	ɹ ɛ f ɚ m e ɪ ʃ n̩
refuge	ɹ ɛ f j u d͡ʒ
regalement	ɹ ɪ ɡ e ɪ l m ə n t
regarding	ɹ ɪ ɡ ɑ ɹ d ɪ ŋ
regards	ɹ ɪ ɡ ɑ ɹ d z
regenerated	ɹ i d͡ʒ ɛ n ə ɹ e ɪ t ɪ d
regiments	ɹ ɛ d͡ʒ ɪ m ə n t s
regorge	ɹ ɪ ɡ ɔ ɹ d͡ʒ
regression	ɹ i ɡ ɹ ɛ ʃ ə n
regularize	ɹ ɛ ɡ j ə l ɚ a ɪ z
regularly	ɹ ɛ ɡ j ə l ɚ l i
regulate	ɹ ɛ ɡ j ə l e ɪ t
regulated	ɹ ɛ ɡ j ə l e ɪ t ɪ d
regurgitate	ɹ ɪ ɡ ɝ d͡ʒ ə t e ɪ t
rehearsal	ɹ ɪ h ɜ ɹ s ə l
reign	ɹ e ɪ n
reigned	ɹ e ɪ n d
reiver	ɹ i v ə ɹ
rejoiced	ɹ ɪ d͡ʒ ɔ ɪ s t
relais	ɹ ə l e ɪ
relativity	ɹ ɛ l ə t ɪ v i t i
relayed	ɹ i l e ɪ d
relead	ɹ i l ɛ d
released	ɹ ɪ l i s t
relent	ɹ ɪ l ɛ n t
relentless	ɹ ɪ l ɛ n t l ə s
relentlessly	ɹ ɪ l ɛ n t l ə s l i
relexification	ɹ i l ɛ k s ə f ə k e ɪ ʃ n̩
reliced	ɹ ɛ l ɪ k d
religiosity	ɹ ɪ l ɪ d͡ʒ ɪ ɑ s ə t i
reluctant	ɹ ɪ l ʌ k t ə n t
remediless	ɹ ɛ m ə d i l ɪ s
remembered	ɹ ɪ m ɛ m b ɚ d
reminisce	ɹ ɛ m i n ɪ s
remission	ɹ ə m ɪ ʃ ə n
remix	ɹ i m ɪ k s
remonstrate	ɹ ɛ m ə n s t ɹ e ɪ t
remorse	ɹ ɪ m ɔ ɹ s
removing	ɹ ɪ m u v ɪ ŋ
remunerative	ɹ ɪ m j u n ə ɹ ə t ɪ v
renault	ɹ ə n o ʊ
renegade	ɹ ɛ n ɪ ɡ e ɪ d
renitent	ɹ ɛ n ɪ t ə n t
renounce	ɹ ɪ n a ʊ n s
rental	ɹ ɛ n t ə l
rentice	ɹ ɛ n t ɪ s
renverse	ɹ ɪ n v ɜ ɹ s
repaglinide	ɹ ə p æ ɡ l ɪ n a ɪ d
repay	ɹ i p e ɪ
repdigit	ɹ ɛ p d ɪ d͡ʒ ɪ t
repeal	ɹ ə p i l
repel	ɹ ɪ p ɛ l
repellent	ɹ ə p ɛ l ə n t
repine	ɹ ɪ p a ɪ n
replace	ɹ ɪ p l e ɪ s
replevy	ɹ ɪ p l ɛ v i
replicase	ɹ ɛ p l ə k e ɪ s
replication	ɹ ɛ p l ɪ k e ɪ ʃ ə n
replicator	ɹ ɛ p l ɪ k e ɪ t ɚ
reported	ɹ ɪ p ɔ ɹ t ɪ d
repose	ɹ ɪ p o ʊ z
reposit	ɹ ɪ p ɔ z ɪ t
reproduce	ɹ i p ɹ o ʊ d u s
reptitious	ɹ ɛ p t ɪ ʃ ə s
repug	ɹ ə p ə ɡ
repute	ɹ ɪ p j u t
requiem	ɹ ɛ k w i ə m
requisite	ɹ ɛ k w ɪ z ɪ t
reran	ɹ ɪ ɹ æ n
reseat	ɹ i s i t
resembling	ɹ ɪ z ɛ m b l ɪ ŋ
residua	ɹ ɛ z ɪ d j u æ
resigned	ɹ ɪ z a ɪ n d
resin	ɹ ɛ z ɪ n
resinify	ɹ ɛ z i n ɛ f a ɪ
resiquimod	ɹ ə z ɪ k w ɪ m ɔ d
resistance	ɹ ɪ z ɪ s t ə n s
resistlessly	ɹ ə z ɪ s t l ə s l i
resolution	ɹ ɛ z ə l j u ʃ ə n
respected	ɹ ɪ s p ɛ k t ɪ d
respecting	ɹ ɪ s p ɛ k t ɪ ŋ
respectively	ɹ ɪ s p ɛ k t ɪ v l i
responsibility	ɹ ɪ s p ɑ n s ə b ɪ l ɪ ɾ i
responsiveness	ɹ ɪ s p ɔ n s ɪ v n ɪ s
resting	ɹ ɛ s t ɪ ŋ
restore	ɹ ɪ s t ɔ ɹ
restored	ɹ ɪ s t ɔ ɹ d
restrictions	ɹ ɪ s t ɹ ɪ k ʃ ə n z
resulted	ɹ ɪ z ʌ l t ɪ d
resurge	r ɪ s ɜ d͡ʒ
resuscitate	ɹ ɪ s ʌ s ɪ t e ɪ t
retear	ɹ i t ɛ ɹ
retell	ɹ i t ɛ l
retent	ɹ ɪ t ɛ n t
retention	ɹ ɪ t ɛ n ʃ ə n
reteplase	ɹ i t ə p l e ɪ s
reterritorialization	ɹ i t ɛ ɹ ɪ t ɔ ɹ i ə l a ɪ z e ɪ ʃ ə n
rethe	r i ð
retina	ɹ ɛ t i n ə
retinaculum	r ɛ t ɪ n æ k j ʊ l ə m
retokenize	ɹ i t o ʊ k ə n a ɪ z
retort	ɹ ɪ t ɔ ɹ t
retouch	ɹ ɪ t ʌ t͡ʃ
retract	ɹ ə t ɹ æ k t
retractor	ɹ ɪ t ɹ æ k t ɚ
retread	ɹ i t ɹ ɛ d
revanchism	ɹ ə v ɑ n t͡ʃ ɪ z ə m
revealed	ɹ ə v i l d
revictual	ɹ i v ɪ t ə l
revolt	ɹ ɪ v o ʊ l t
rework	ɹ i w ɜ ɹ k
rex	ɹ ɛ k s
rhabdomancy	ɹ æ b d ə m æ n s i
rhebok	ɹ i b ɑ k
rheumy	ɹ u m i
rhine	ɹ a ɪ n
rhodium	ɹ o ʊ d i ə m
rhododendron	ɹ o ʊ d ə d ɛ n d ɹ ə n
rhonchi	ɹ ɔ ŋ k a ɪ
rhonchus	ɹ ɑ ŋ k ə s
riata	ɹ ɪ ɑ t ə
rib	ɹ ɪ b
ribavirin	ɹ a ɪ b ə v a ɪ ɹ ɪ n
ribbing	ɹ ɪ b ɪ ŋ
ribosome	ɹ a ɪ b ə s o ʊ m
ribspare	ɹ ɪ b s p ɛ ɚ
rich	ɹ ɪ t͡ʃ
richter	ɹ ɪ k t ɚ
rick	ɹ ɪ k
rickroll	ɹ ɪ k ɹ o ʊ l
rideau	ɹ i d o ʊ
riding	ɹ a ɪ d ɪ ŋ
ridotto	ɹ ə d o ʊ t o ʊ
rifaldazine	ɹ ɪ f æ l d ə z i n
rifampicin	ɹ ɪ f æ m p ɪ s ɪ n
riffle	ɹ ɪ f ə l
riffraff	ɹ ɪ f ɹ æ f
righteousness	ɹ a ɪ t͡ʃ ə s n ə s
rightist	ɹ a ɪ t ɪ s t
rightly	ɹ a ɪ t l i
rightward	ɹ a ɪ t w ɚ d
rigmarolish	ɹ ɪ ɡ m ə ɹ o ʊ l ɪ ʃ
rillet	ɹ ɪ l ɪ t
rimbaud	r æ m b o ʊ
riptide	ɹ ɪ p t a ɪ d
rising	ɹ a ɪ z ɪ ŋ
risky	ɹ ɪ s k i
rite	ɹ a ɪ t
ritzy	ɹ ɪ t͡s i
rivet	ɹ ɪ v ə t
roadrunner	ɹ o ʊ d ɹ ʌ n ə ɹ
roared	ɹ ɔ ɹ d
roars	ɹ ɔ ɹ z
roast	ɹ o ʊ s t
roastie	ɹ o ʊ s t i
robbed	ɹ ɑ b d
roborate	ɹ ɔ b ə ɹ e ɪ t
robotics	ɹ o ʊ b ɑ t ɪ k s
robust	ɹ o ʊ b ʌ s t
robusta	ɹ o ʊ b ʌ s t ə
roche	ɹ o ʊ ʃ
rockabilly	ɹ ɑ k ə b ɪ l i
rode	ɹ o ʊ d
rodger	ɹ ɔ d͡ʒ ə ɹ
rodman	ɹ ɔ d m ə n
rodney	ɹ ɑ d n i
rohingya	r o ʊ h ɪ ŋ j ə
roil	ɹ ɔ ɪ l
rolleston	ɹ ɔ l ə s t ə n
romajikai	ɹ o ʊ m ə d͡ʒ i k a ɪ
romance	ɹ o ʊ m æ n s
romanesco	ɹ o ʊ m a n ɛ s k o ʊ
romanesque	ɹ o ʊ m ə n ɛ s k
romanichal	ɹ ɑ m ɪ n i t͡ʃ æ l
romans	ɹ o ʊ m ə n z
rondo	ɹ ɔ n d o ʊ
rooibos	ɹ ɔ ɪ b ɔ s
roop	ɹ u p
rooster	ɹ u s t ə ɹ
root	ɹ u t
rosa	ɹ o ʊ z ə
roseate	ɹ o ʊ z i ə t
rosehip	ɹ o ʊ z h ɪ p
roselle	ɹ o ʊ z ɛ l
rosemaler	ɹ o ʊ z ə m ɑ l ɚ
rotarian	ɹ o ʊ t ɛ ɹ i ə n
rottable	ɹ ɔ t ə b ə l
roubaisian	ɹ o ʊ b e ɪ ʒ ə n
rouge	ɹ u ʒ
roughly	ɹ ʌ f l i
rouille	ɹ u i
roun	ɹ a ʊ n
rounding	ɹ a ʊ n d ɪ ŋ
rouse	ɹ a ʊ z
roust	ɹ a ʊ s t
roux	ɹ u
rover	ɹ o ʊ v ə ɹ
rowdy	ɹ a ʊ d i
rub	ɹ ʌ b
rubber	ɹ ʌ b ɚ
rubbers	ɹ ʌ b ɚ z
rubella	ɹ u b ɛ l ə
rubric	ɹ u b ɹ ɪ k
rudely	ɹ u d l i
rudy	ɹ u d i
ruga	ɹ u ɡ ə
ruism	ɹ u ɪ z ə m
ruling	ɹ u l ɪ ŋ
ruly	ɹ u l i
rum	ɹ ʌ m
runaway	ɹ ʌ n ə w e ɪ
runcie	ɹ ʌ n s i
rung	ɹ ʌ ŋ
runner	ɹ ʌ n ɚ
running	ɹ ʌ n ɪ ŋ
runs	ɹ ʌ n z
rupel	ɹ u p ə l
rupellary	ɹ u p ɛ l ə ɹ i
ruption	ɹ ʌ p ʃ ə n
rush	ɹ ʌ ʃ
rusk	ɹ ʌ s k
russel	ɹ ʌ s ə l
russell	ɹ ʌ s ə l
rusto	ɹ ʌ s t o ʊ
rut	ɹ ʌ t
rutilant	ɹ u t ə l ə n t
ryebuck	ɹ a ɪ b ʌ k
saanich	s æ n ɪ t͡ʃ
sabah	s ɑ b ɑ
sabrage	s ə b ɹ ɑ ʒ
sabulous	s æ b j ʊ l ə s
saccharoid	s æ k ə ɹ ɔ ɪ d
sacrament	s æ k ɹ ə m ə n t
sacrificed	s æ k ɹ ɪ f a ɪ s t
sadden	s æ d ə n
saddle	s æ d ə l
sadh	s ɑ d
sadhu	s ɑ d h u
sadistic	s ə d ɪ s t ɪ k
sagebrush	s e ɪ d͡ʒ b ɹ ʌ ʃ
sai	s a ɪ
sailors	s e ɪ l ɚ z
sain	s e ɪ n
saipan	s a ɪ p æ n
sakhalin	s æ k ə l i n
salacious	s ə l e ɪ ʃ ə s
salad	s æ l ə d
salempenta	s æ l ə m p ɛ n t ɚ
salicylic	s æ l ɪ s ɪ l ɪ k
saline	s e ɪ l i n
saliva	s ə l a ɪ v ə
salivary	s æ l ɪ v ɛ ɹ i
salivate	s æ l ɪ v e ɪ t
sallowy	s æ l ɵ w i
salmagundi	s æ l m ə ɡ ʌ n d i
salome	s ə l o ʊ m i
salute	s ə l u t
sam	s æ m
samaritan	s ə m ɛ ɹ ɪ t ə n
sambadrome	s æ m b ə d ɹ o ʊ m
samfie	s æ m f a ɪ
samos	s e ɪ m ɔ s
samsara	s ʌ m s ɑ ɹ ə
samurai	s æ m ə ɹ a ɪ
sancerre	s ɔ̃ n s ɛ ɹ
sand	s æ n d
sandbach	s æ n d b æ t͡ʃ
sandman	s æ n d m æ n
sandy	s æ n d i
sang	s æ ŋ
santonin	s æ n t ə n ɪ n
sappho	s æ f o ʊ
saqqaq	s ɑ k ə k
sarcasmous	s ɑ ɹ k æ z m ə s
sarcophagi	s ɑ ɹ k ɔ f ə ɡ a ɪ
sardine	s ɑ ɹ d i n
sardinia	s ɑ ɹ d ɪ n i ə
sardis	s ɑ d ɪ s
sardonyx	s ɑ ɹ d ɔ n ɪ k s
sarmon	s ɑ ɹ m ə n
sarsen	s ɑ ɹ s ə n
sasswood	s æ s w ʊ d
sate	s e ɪ t
satin	s æ t ɪ n
satire	s æ t a ɪ ɹ
satisfy	s æ t ɪ s f a ɪ
satisfying	s æ t ɪ s f a ɪ ɪ ŋ
saturn	s æ t ɚ n
saucisse	s o ʊ s i s
saul	s ɔ l
savagery	s æ v ɪ d͡ʒ ɹ ɪ
savanna	s ə v æ n ə
save	s e ɪ v
saveloy	s æ v ə l ɔ ɪ
saw	s ɔ
sayonara	s a ɪ ə n ɑ ɹ ə
sazerac	s æ z ə ɹ æ k
scab	s k æ b
scabies	s k e i b i z
scadian	s k e ɪ d i ə n
scalation	s k e ɪ l e ɪ ʃ ə n
scale	s k e ɪ l
scaled	s k e ɪ l d
scales	s k e ɪ l z
scaly	s k e ɪ l i
scampi	s k æ m p i
scandalize	s k æ n d ə l a ɪ z
scandium	s k æ n d i ə m
scanno	s k æ n o ʊ
scant	s k æ n t
scarlet	s k ɑ ɹ l ɪ t
scaup	s k ɔ p
sceat	ʃ æ t
scenery	s i n ə ɹ i
scenester	s i n s t ɚ
scent	s ɛ n t
schediaphilia	s k ɛ d i ə f ɪ l i ə
schefflera	ʃ ɛ f l ə ɹ ə
scheldt	ʃ ɛ l t
scheme	s k i m
schizophrenic	s k ɪ t s ə f ɹ ɛ n ɪ k
schizophyte	s k ɪ t s o ʊ f a ɪ t
schizotypal	s k ɪ t s o ʊ t a ɪ p ə l
schlamperei	ʃ l ɑ m p ə ɹ a ɪ
schlepps	ʃ l ɛ p s
schlubby	ʃ l ʌ b i
schnapper	ʃ n æ p ɚ
scholarship	s k ɑ l ə ɹ ʃ ɪ p
schoolery	s k u l ə ɹ i
schoolish	s k u l ɪ ʃ
schwag	ʃ w æ ɡ
scientist	s a ɪ ə n t ɪ s t
scintillator	s ɪ n t ə l e ɪ t ə ɹ
sciophyte	s a ɪ ə f a ɪ t
scleronomic	s k l ə ɹ ə n ɑ m ɪ k
sclerotic	s k l ɪ ɹ ɔ t ɪ k
scobberlotcher	s k ɔ b ə l ɔ t͡ʃ ə
scorse	s k ɔ ɹ s
scotland	s k ɑ t l ə n d
scott	s k ɔ t
scouthouse	s k a ʊ t h a ʊ s
scramble	s k ɹ æ m b l̩
scrape	s k ɹ e ɪ p
scratchy	s k ɹ æ t͡ʃ i
screeve	s k ɹ i v
screwy	s k ɹ u i
scrimmage	s k ɹ ɪ m ə d͡ʒ
scrimshaw	s k ɹ ɪ m ʃ ɔ
script	s k ɹ ɪ p t
scripting	s k ɹ ɪ p t ɪ ŋ
scripture	s k ɹ ɪ p t͡ʃ ɚ
scrod	s k ɹ ɑ d
scrofula	s k ɹ ɔ f j ə l ə
scrooge	s k ɹ u d͡ʒ
scrota	s k ɹ o ʊ t ə
scrotum	s k ɹ o ʊ t ə m
scrounge	s k ɹ a ʊ n d͡ʒ
scruff	s k ɹ ʌ f
scrunt	s k ɹ ʌ n t
scull	s k ʌ l
scupper	s k ʌ p ɚ
scylla	s ɪ l ə
sdi	ɛ s d i a ɪ
seagull	s i ɡ ʌ l
sealine	s i l a ɪ n
sean	ʃ ɔ n
search	s ɝ t͡ʃ
seashore	s i ʃ ɔ ɹ
seasick	s i s ɪ k
seatainer	s i t e ɪ n ə
sebastion	s ə b æ s t͡ʃ ə n
sebelius	s ɪ b i l i ə s
secern	s ə s ɜ ɹ n
secrecy	s i k ɹ ə s i
secs	s ɛ k s
section	s ɛ k ʃ ə n
secularism	s ɛ k j ʊ l ə ɹ ɪ z ə m
sedate	s ə d e ɪ t
sedge	s ɛ d͡ʒ
seduction	s ɪ d ʌ k ʃ n̩
seeing	s i ɪ ŋ
seemer	s i m ə ɹ
seemly	s i m l i
sefira	s ə f ɪ ɹ ə
sega	s e ɪ ɡ ə
segovia	s ɪ ɡ o ʊ v i ə
seigneur	s ɛ n j ɝ
seigniory	s i n j ə ɹ i
seismic	s a ɪ z m ɪ k
seismology	s a ɪ z m ɑ l ə d͡ʒ i
sejm	s e ɪ m
selcouth	s ɛ l k u θ
selectable	s ə l ɛ k t ə b l̩
seleucidan	s ɪ l j u s ɪ d ə n
selfish	s ɛ l f ɪ ʃ
selkirk	s ɛ l k ɪ ɹ k
seltzer	s ɛ l t s ɚ
semic	s i m ɪ k
seminary	s ɛ m ə n ɛ ɹ i
semiotic	s ɛ m i ɔ t ɪ k
semipermeable	s ɛ m i p ɜ ɹ m i ə b ə l
semite	s ɛ m a ɪ t
sender	s ɛ n d ɚ
senesce	s ə n ɛ s
sensations	s ɛ n s e ɪ ʃ ə n z
sense	s ɛ n s
sensitivity	s ɛ n s ɪ t ɪ v ɪ t i
sentences	s ɛ n t ə n s ɪ z
sentiment	s ɛ n t ɪ m ə n t
seo	s ʌ
seoul	s o ʊ l
sephira	s ə f ɪ ɹ ə
sept	s ɛ p t
septagon	s ɛ p t ə ɡ ɔ n
septembers	s ɛ p t ɛ m b ɚ z
septendecillion	s ɛ p t ə n d ə s ɪ l i ə n
septimation	s ɛ p t ə m e ɪ ʃ ə n
sequence	s i k w ə n s
sequestrate	s i k w ə s t ɹ e ɪ t
sequin	s i k w ɪ n
serbian	s ɜ ɹ b i ə n
serf	s ɝ f
sertaconazole	s ɝ t ə k ɑ n ə z o ʊ l
serviced	s ɝ v ɪ s t
services	s ɝ v ɪ s ɪ z
servitude	s ɝ v ɪ t u d
setswana	s ɛ t s w ɑ n ə
settled	s ɛ t l̩ d
sexly	s ɛ k s l i
sextant	s ɛ k s t ə n t
sexual	s ɛ k ʃ u ə l
shadowban	ʃ æ d o ʊ b æ n
shadows	ʃ æ d o ʊ z
shaft	ʃ æ f t
shaggy	ʃ æ ɡ i
shaheen	ʃ ə h i n
shakespeare	ʃ e ɪ k s p ɪ ɹ
shambling	ʃ æ m b l ɪ ŋ
shameful	ʃ e ɪ m f ə l
shamefully	ʃ e ɪ m f ə l i
shamisen	ʃ æ m ɪ s ɛ n
shank	ʃ æ ŋ k
shapes	ʃ e ɪ p s
shapeshifter	ʃ e ɪ p ʃ ɪ f t ɚ
share	ʃ ɛ ɹ
shares	ʃ ɛ ɹ z
shark	ʃ ɑ ɹ k
sharpen	ʃ ɑ ɹ p i n
sharply	ʃ ɑ ɹ p l i
sharrow	ʃ æ ɹ o ʊ
shed	ʃ ɛ d
sheedy	ʃ i d i
sheen	ʃ i n
sheeny	ʃ i n i
sheepish	ʃ i p ɪ ʃ
sheers	ʃ ɪ ɹ z
sheets	ʃ i t s
shekel	ʃ ɛ k ə l
shelbyville	ʃ ɛ l b i v ɪ l
shelf	ʃ ɛ l f
shell	ʃ ɛ l
sheltered	ʃ ɛ l t ɚ d
shelton	ʃ ɛ l t ə n
shemaiah	ʃ ɛ m ɛ j ɑ
shepherd	ʃ ɛ p ɚ d
shepherds	ʃ ɛ p ɚ d z
shergottite	ʃ ɚ ɡ ə t a ɪ t
sherlock	ʃ ɜ ɹ l ɔ k
sherman	ʃ ɜ ɹ m ə n
sheugh	ʃ ʌ x
shibasaki	ʃ i b ə s ɑ k i
shigella	ʃ i ɡ e l ə
shiksa	ʃ ɪ k s ə
shiner	ʃ a ɪ n ə ɹ
shinto	ʃ ɪ n t o ʊ
shipshape	ʃ ɪ p ʃ e ɪ p
shipwrecky	ʃ ɪ p ɹ ɛ k i
shirley	ʃ ɜ r l i
shithole	ʃ ɪ t h o ʊ l
shitlib	ʃ ɪ t l ɪ b
shitton	ʃ ɪ t t ʌ n
shkotzim	ʃ k ɑ t s ɪ m
shlep	ʃ l ɛ p
shock	ʃ ɑ k
shoogle	ʃ ʊ ɡ ə l
shortener	ʃ ɔ ɹ t ə n ɚ
shortly	ʃ ɔ ɹ t l i
shot	ʃ ɑ t
shouldna	ʃ ʊ d n ə
shout	ʃ a ʊ t
shove	ʃ ʌ v
shovelware	ʃ ʌ v ə l w ɛ ɚ
showbusiness	ʃ o ʊ b ɪ z n ɪ s
showcase	ʃ o ʊ k e ɪ s
showing	ʃ o ʊ ɪ ŋ
showrunner	ʃ o ʊ ɹ ʌ n ɚ
shrapnel	ʃ ɹ æ p n ə l
shrining	ʃ ɹ a ɪ n ɪ ŋ
shrink	ʃ ɹ ɪ ŋ k
shrithe	ʃ ɹ a ɪ ð
shroudie	ʃ ɹ a ʊ d i
shrubby	ʃ ɹ ʌ b i
shrugged	ʃ ɹ ʌ ɡ d
shrugs	ʃ ɹ ʌ ɡ z
shtetl	ʃ t ɛ t ə l
shucked	ʃ ʌ k t
shucks	ʃ ʌ k s
shuns	ʃ ʌ n z
shuswap	ʃ u ʃ w ɑ p
shuts	ʃ ʌ t s
shutting	ʃ ʌ t ɪ ŋ
shvitz	ʃ v ɪ t s
sialoquent	s a ɪ æ l ə k w ə n t
sib	s ɪ b
sibilancy	s ɪ b ɪ l ə n s i
sibilant	s ɪ b ɪ l ə n t
sibilantly	s ɪ b ɪ l ə n t l i
sicily	s ɪ s i l i
sick	s ɪ k
sickbed	s ɪ k b ɛ d
sicko	s ɪ k o ʊ
siddur	s ɪ d ʊ ə
side	s a ɪ d
sideburns	s a ɪ d b ɚ n z
sides	s a ɪ d z
sidewalk	s a ɪ d w ɔ k
sideways	s a ɪ d w e ɪ z
siege	s i d͡ʒ
sierra	s i ɛ ɹ ə
sievish	s ɪ v ɪ ʃ
sight	s a ɪ t
sigma	s ɪ ɡ m ə
significative	s ɪ ɡ n ɪ f ɪ k e ɪ t ɪ v
signifies	s ɪ ɡ n ɪ f a ɪ z
signor	s i n j ɔ
sike	s a ɪ k
sikhye	ʃ i k j e ɪ
silipide	s ɪ l ɪ p a ɪ d
silken	s ɪ l k ə n
silky	s ɪ l k i
sim	s ɪ m
similarly	s ɪ m ə l ɚ l i
simon	s a ɪ m ə n
simple	s ɪ m p ə l
simplification	s ɪ m p l ə f ə k e ɪ ʃ ə n
simvastatin	s ɪ m v ə s t æ t n̩
sincere	s ɪ n s ɪ ə ɹ
sindhi	s ɪ n d i
sinemet	s ɪ n ə m ɛ t
sinewy	s ɪ n j u i
singaporizes	s ɪ ŋ ə p ɔ ɹ a ɪ z ə z
singaporizing	s ɪ ŋ ə p ɔ ɹ a ɪ z ɪ ŋ
singh	s ɪ ŋ
singhalese	s ɪ ŋ ɡ ə l i z
singing	s ɪ ŋ ɪ ŋ
singlet	s ɪ ŋ ɡ l ɪ t
sinology	s a ɪ n ɔ l ə d͡ʒ i
sinophobia	s a ɪ n ə f o ʊ b i ə
siouan	s u ə n
sioux	s u
sipe	s a ɪ p
siren	s a ɪ ɹ ə n
sirenomelia	s a ɪ ɹ ə n o ʊ m i l i ə
sirkar	s ɜ k ɑ
sirtuin	s ɚ t u ɪ n
sis	s ɪ s
sisyphus	s ɪ s ɪ f ə s
sit	s ɪ t
sitwell	s ɪ t w ɛ l
sixt	s ɪ k s t
ska	s k ɑ
skat	s k æ t
skates	s k e ɪ t s
skeezicks	s k i z ɪ k s
skeg	s k ɛ ɡ
sketchy	s k ɛ t͡ʃ i
skiffy	s k ɪ f i
skilled	s k ɪ l d
skills	s k ɪ l z
skimping	s k ɪ m p ɪ ŋ
skimpy	s k ɪ m p i
skinhead	s k ɪ n h ɛ d
skip	s k ɪ p
skirl	s k ɜ l
skirling	s k ɝ l ɪ ŋ
skittish	s k ɪ t ɪ ʃ
skittle	s k ɪ t ə l
skopje	s k ɔ p j ɛ
skullcap	s k ʌ l k æ p
skute	s k u t
skyclad	s k a ɪ k l æ d
skydive	s k a ɪ d a ɪ v
skyglow	s k a ɪ ɡ l o ʊ
skysill	s k a ɪ s ɪ l
skywalker	s k a ɪ w ɔ k ə ɹ
slack	s l æ k
slane	s l e ɪ n
slanting	s l æ n t ɪ ŋ
slapper	s l æ p ɚ
slash	s l æ ʃ
slashy	s l æ ʃ i
slat	s l æ t
slavi	s l ɑ v i
slavish	s l e ɪ v ɪ ʃ
slc	ɛ s ɛ l s i
sleazy	s l i z i
sledge	s l ɛ d͡ʒ
sleekly	s l i k l i
slept	s l ɛ p t
sleuth	s l u θ
slightest	s l a ɪ t ɪ s t
slime	s l a ɪ m
slinky	s l ɪ ŋ k i
slipshod	s l ɪ p ʃ ɑ d
sloan	s l o ʊ n
slogan	s l o ʊ ɡ ə n
sloop	s l u p
sloth	s l ɔ θ
slovio	s l o ʊ̯ v i o ʊ̯
slowworm	s l o ʊ w ɜ ɹ m
sluff	s l ʌ f
slump	s l ʌ m p
slush	s l ʌ ʃ
slushy	s l ʌ ʃ i
sly	s l a ɪ
smack	s m æ k
smallcap	s m ɔ l k æ p
smalls	s m ɔ l z
smattering	s m æ ɾ ɹ̩ ɪ ŋ
smeg	s m ɛ ɡ
smelt	s m ɛ l t
smew	s m j u
smicker	s m ɪ k ə ɹ
smiddy	s m ɪ d i
smiled	s m a ɪ l d
smiley	s m a ɪ l i
smiling	s m a ɪ l ɪ ŋ
smite	s m a ɪ t
smith	s m ɪ θ
smithereen	s m i ð ə ɹ i n
smocking	s m ɑ k ɪ ŋ
smoked	s m o ʊ k t
smoker	s m o ʊ k ɚ
smokes	s m o ʊ k s
smollett	s m ɑ l ə t
smooth	s m u ð
smoothen	s m u ð ə n
smorc	s m ɔ ɹ k
smore	s m ɔ ɹ
smsa	ɛ s ɛ m ɛ s e ɪ
smudge	s m ʌ d͡ʒ
smuthound	s m ʌ t h a ʊ n d
snaking	s n e ɪ k ɪ ŋ
snapdragon	s n æ p d ɹ æ ɡ ə n
snapin	s n æ p ɪ n
snapless	s n æ p l ə s
snark	s n ɑ ɹ k
snarktastic	s n ɑ k t æ s t ɪ k
snatched	s n æ t͡ʃ t
snatching	s n æ t͡ʃ ɪ ŋ
sneaker	s n i k ɚ
sneck	s n ɛ k
sneed	s n i d
sneer	s n ɪ ə̯ ɹ
snelly	s n ɛ l i
snet	s n ɛ t
snider	s n a ɪ d ɚ
snip	s n ɪ p
snips	s n ɪ p s
snive	s n a ɪ v
snivel	s n ɪ v ə l
snooze	s n u z
snough	s n ɔ f
snow	s n o ʊ
snowing	s n o ʊ ɪ ŋ
snowman	s n o ʊ m æ n
snowstorm	s n o ʊ s t ɔ m
soccer	s ɑ k ɚ
sociable	s o ʊ ʃ ə b ə l
sociolinguistics	s o ʊ s i o ʊ l ɪ ŋ ɡ w ɪ s t ɪ k s
socle	s o ʊ k ə l
sod	s ɔ d
sodden	s ɑ d ə n
sodomitically	s ɑ d ə m ɪ t ɪ k l i
softly	s ɔ f t l i
sog	s ɔ ɡ
sogs	s ɔ ɡ z
soil	s ɔ ɪ l
soju	s o ʊ d͡ʒ u
solanaceous	s ɔ l ə n e ɪ ʃ ə s
solarium	s ə l ɛ ɹ i ə m
soldier	s o ʊ l d͡ʒ ɚ
sole	s o ʊ l
solent	s o ʊ l ə n t
solid	s ɑ l ɪ d
soliloquy	s ə l ɪ l ə k w i
solomon	s ɑ l ə m ə n
somerton	s ʌ m ə ɹ t ə n
sometime	s ʌ m t a ɪ m
somewhat	s ʌ m w ʌ t
somitogenesis	s o ʊ m a ɪ d ə d͡ʒ ɛ n ə s ɪ s
somnolent	s ɑ m n ə l ə n t
songbun	s ɔ ŋ b u n
songcraft	s ɔ ŋ k ɹ æ f t
soon	s u n
sophont	s o ʊ f ɑ n t
soprano	s ə p ɹ æ n o ʊ
sororate	s ə ɹ ɔ ɹ ə t
sorrow	s ɑ ɹ o ʊ
soulish	s o ʊ l ɪ ʃ
sound	s a ʊ n d
sounder	s a ʊ n d ə ɹ
soundscape	s a ʊ n d s k e ɪ p
sourball	s a ʊ ɚ b ɑ l
southwark	s ʌ ð ə ɹ k
sovereigns	s ɑ v ə ɹ ɪ n z
soya	s ɔ ɪ ə
spac	s p æ k
spaceman	s p e ɪ s m æ n
spagyric	s p ə d͡ʒ ɪ ɹ ɪ k
spall	s p ɔ l
spang	s p æ ŋ
spangled	s p æ ŋ ɡ ə l d
spaniard	s p æ n j ɚ d
spanky	s p æ ŋ k i
spark	s p ɑ ɹ k
sparkle	s p ɑ ɹ k ə l
spasmodic	s p æ z m ɑ d ɪ k
spathe	s p e ɪ ð
spaz	s p æ z
spean	s p i n
spec	s p ɛ k
specialize	s p ɛ ʃ ə l a ɪ z
specially	s p ɛ ʃ ə l i
specie	s p i ʃ i
specified	s p ɛ s ɪ f a ɪ d
specifier	s p ɛ s ə f a ɪ ɚ
speckle	s p ɛ k ə l
spectrogram	s p ɛ k t ɹ ə ɡ ɹ æ m
spectrum	s p ɛ k t͡ʃ ɹ ə m
speculation	s p ɛ k j ə l e ɪ ʃ ə n
speedboat	s p i d b o ʊ t
speight	s p e ɪ t
spendthrift	s p ɛ n d θ ɹ ɪ f t
spesh	s p ɛ ʃ
sphene	s f i n
spic	s p ɪ k
spice	s p a ɪ s
spiculum	s p ɪ k j ʊ l ə m
spidey	s p a ɪ d i
spiedie	s p i d i
spills	s p ɪ l z
spilt	s p ɪ l t
spindles	s p ɪ n d ə l z
spinner	s p ɪ n ɚ
spinsterishness	s p ɪ n s t ə ɹ ɪ ʃ n ə s
spintrian	s p ɪ n t ɹ ɪ ə n
spinward	s p ɪ n w ɜ ɹ d
spirits	s p ɪ ɹ ɪ t s
spitting	s p ɪ t ɪ ŋ
spiv	s p ɪ v
splanchnology	s p l æ ŋ k n ɔ l ə d͡ʒ i
spleen	s p l i n
splendiferous	s p l ɛ n d ɪ f ə ɹ ə s
splooge	s p l u d͡ʒ
splurge	s p l ɝ d͡ʒ
splutter	s p l ʌ t ɚ
spoilsport	s p ɔ ɪ l s p ɔ ɹ t
spontaneously	s p ɑ n t e ɪ n i ə s l i
spook	s p u k
sporty	s p ɔ ɹ t i
sposhy	s p ɔ ʃ i
spots	s p ɑ t s
spotted	s p ɑ t ɪ̈ d
spotter	s p ɑ t ɚ
sprayed	s p ɹ e ɪ d
sprays	s p ɹ e ɪ z
spread	s p ɹ ɛ d
springing	s p ɹ ɪ ŋ ɪ ŋ
spry	s p ɹ a ɪ
sputter	s p ʌ t ɚ
squab	s k w ɑ b
square	s k w ɛ ɚ
squarish	s k w ɛ ɹ ɪ ʃ
squatter	s k w ɑ t ə ɹ
squawks	s k w ɔ k s
squeegee	s k w i d͡ʒ i
squinch	s k w ɪ n t͡ʃ
squirm	s k w ɝ m
squirt	s k w ɜ ɹ t
squishiness	s k w ɪ ʃ i n ə s
squishy	s k w ɪ ʃ i
squizz	s k w ɪ z
squoosh	s k w ʊ ʃ
srebrenica	s ɹ e b ɹ ə n i t s ə
srinagar	s ɹ i n ɑ ɡ ə ɹ
stab	s t æ b
stability	s t ə b ɪ l ɪ t i
stache	s t æ ʃ
staffless	s t æ f l ə s
stafford	s t æ f ə ɹ d
staid	s t e ɪ d
staired	s t ɛ ɹ d
stairs	s t ɛ ɹ z
stampede	s t æ m p i d
stan	s t æ n
stanislaus	s t æ n ɪ s l ɔ s
stannous	s t æ n ə s
stanza	s t æ n z ə
stapes	s t e ɪ p i z
staring	s t ɛ ɹ ɪ ŋ
stark	s t ɑ ɹ k
starling	s t ɑ ɹ l ɪ ŋ
starry	s t ɑ ɹ i
startled	s t ɑ ɹ t l̩ d
starving	s t ɑ ɹ v ɪ ŋ
statesman	s t e ɪ t s m ə n
stationed	s t ɛ ɪ ʃ ə n d
statistical	s t ə t ɪ s t ɪ k ə l
statistics	s t ə t ɪ s t ɪ k s
statuary	s t æ t͡ʃ u ɛ ɹ i
stature	s t æ t͡ʃ ɚ
statutory	s t æ t͡ʃ ə t ɔ ɹ i
staunch	s t ɔ n t͡ʃ
stave	s t e ɪ v
stayed	s t e ɪ d
staying	s t e ɪ ɪ ŋ
stead	s t ɛ d
steaks	s t e ɪ k s
steals	s t i l z
stealth	s t ɛ l θ
steamboat	s t i m b o ʊ t
steen	s t i n
steenbok	s t i n b ɔ k
steep	s t i p
steerer	s t ɪ ə ɹ ə ɹ
stef	s t ɛ f
stegosaur	s t e ɡ ə s ɔ ɹ
stela	s t i l ə
stellify	s t ɛ l ɪ f a ɪ
stem	s t ɛ m
stenographer	s t ə n ɑ ɡ ɹ ə f ə ɹ
stenoses	s t ɛ n o ʊ s i z
stentorian	s t ɛ n t ɔ ɹ i ə n
stephanie	s t ɛ f ə n i
stepping	s t ɛ p ɪ ŋ
stereo	s t ɛ ɹ i o ʊ
sterns	s t ɜ ɹ n z
stertorously	s t ɝ t ɚ ə s l i
stet	s t ɛ t
stew	s t u
stf	s t ɛ f
sthenic	s θ ɛ n ɪ k
stheno	s θ ɛ n o ʊ
stich	s t ɪ k
sticker	s t ɪ k ə r
sticky	s t ɪ k i
stiffy	s t ɪ f i
stifle	s t a ɪ f ə l
stigmatize	s t ɪ ɡ m ə t a ɪ z
stiletto	s t ə l ɛ t o ʊ
stillicide	s t ɪ l ɪ s ʌ ɪ d
stilt	s t ɪ l t
stimmy	s t ɪ m i
stimulated	s t ɪ m j ʊ l e ɪ t ɪ d
stimulus	s t ɪ m j ə l ə s
sting	s t ɪ ŋ
stingo	s t ɪ ŋ ɡ o ʊ
stingray	s t ɪ ŋ ɹ e ɪ
stink	s t ɪ ŋ k
stint	s t ɪ n t
stipulative	s t ɪ p j ə l ə t ɪ v
stipule	s t ɪ p j u l
stitching	s t ɪ t͡ʃ ɪ ŋ
stockholder	s t ɔ k h o ʊ ɫ d ɚ
stockpile	s t ɔ k p a ɪ l
stocks	s t ɑ k s
stoicism	s t o ʊ ɪ s ɪ z ə m
stoker	s t o ʊ k ə ɹ
stolen	s t o ʊ l ə n
stollen	s t ɔ l ə n
stompie	s t ɔ m p i
stonewall	s t o ʊ n w ɔ l
stooge	s t u d͡ʒ
stoor	s t ɔ ɚ
stopped	s t ɑ p t
stout	s t a ʊ t
stovec	s t o ʊ v ɛ k
stradivarius	s t ɹ æ d ə v ɛ ɹ i ə s
strain	s t ɹ e ɪ̯ n
strainer	s t ɹ e ɪ n ɚ
strake	s t ɹ e ɪ k
stramash	s t ɹ ə m æ ʃ
strandflat	s t ɹ æ n d f l æ t
strangle	s t ɹ æ ŋ ɡ ə l
strangles	s t ɹ æ ŋ ɡ ə l z
strass	s t ɹ a s
strategize	s t ɹ æ t ə d͡ʒ a ɪ z
strauss	s t ɹ a ʊ s
streel	s t ɹ i l
stretched	s t ɹ ɛ t͡ʃ t
stretches	s t ɹ ɛ t͡ʃ ɪ z
stria	s t ɹ a ɪ ə
stridulous	s t ɹ ɪ d j ʊ l ə s
striker	s t ɹ a ɪ k ə ɹ
stringer	s t ɹ ɪ ŋ ɚ
strip	s t ɹ ɪ p
stripling	s t ɹ ɪ p l ɪ ŋ
stripper	s t ɹ ɪ p ə ɹ
striving	s t ɹ a ɪ v ɪ ŋ
stroll	s t ɹ o ʊ l
strombus	s t ɹ ɑ m b ə s
strongest	s t ɹ ɔ ŋ ɡ ə s t
stroot	s t ɹ u t
strummel	s t ɹ ʌ m ə l
strumpet	s t ɹ ʌ m p ɪ t
stuck	s t ʌ k
studdery	s t ʌ d ə ɹ i
stuff	s t ʌ f
stumpy	s t ʌ m p i
stunk	s t ʌ ŋ k
stupa	s t u p ə
stupend	s t j u p ɛ n d
sturdy	s t ɜ r d i
stygian	s t ɪ d͡ʒ i ə n
subduct	s ʌ b d ʌ k t
subitize	s ʌ b i t a ɪ z
subjugation	s ʌ b d͡ʒ ə ɡ e ɪ ʃ ə n
sublimatory	s ʌ b l ɪ m e ɪ t ə ɹ i
submissive	s ə b m ɪ s ɪ v
subnect	s ʌ b n ɛ k t
subperiosteal	s ʌ b p ɛ ɹ i ɔ s t ɪ ə l
subscribe	s ə b s k ɹ a ɪ b
substance	s ʌ b s t ə n s
substandard	s ʌ b s t æ n d ɚ d
substantiate	s ə b s t a n ʃ ɪ e ɪ t
subsume	s ə b s u m
subtlety	s ʌ t ə l t i
subtract	s ə b t ɹ æ k t
suburbs	s ʌ b ɝ b z
subversive	s ə b v ɜ ɹ s ɪ v
succeeding	s ə k s i d ɪ ŋ
successive	s ə k s ɛ s ɪ v
succour	s ʌ k ɚ
succulent	s ʌ k j ə l ə n t
sucralfate	s u k ɹ æ l f e ɪ t
sudden	s ʌ d ə n
suddenly	s ʌ d n̩ l i
suds	s ʌ d z
suffocate	s ʌ f ə k e ɪ t
sugar	ʃ ʊ ɡ ɚ
suggestions	s ə ɡ d͡ʒ ɛ s t͡ʃ ə n z
suifenhe	s w e ɪ f ʌ n h ʌ
suited	s u t ɪ d
sulfadiazine	s ʌ l f ə d a ɪ ə z i n
sull	s ʌ l
sulliage	s ʌ l i ə d͡ʒ
sultry	s ʌ l t ɹ i
summon	s ʌ m ə n
summons	s ʌ m ə n z
sumptuous	s ʌ m p t͡ʃ u ə s
sums	s ʌ m z
sunflower	s ʌ n f l a ʊ ɚ
sung	s ʌ ŋ
sunlight	s ʌ n l a ɪ t
sunlit	s ʌ n l ɪ t
sunrise	s ʌ n ɹ a ɪ z
sunset	s ʌ n s ɛ t
sunup	s ʌ n ʌ p
suona	s w o ʊ n ɑ
superannuate	s u p ə ɹ æ n j u e ɪ t
superannuated	s u p ɚ æ n j u e ɪ t ɪ d
supercalifragilisticexpialidocious	s u p ɚ k æ l ɪ̈ f ɹ æ d͡ʒ ɪ̈ l ɪ s t ɪ k ɛ k s p i æ l ɪ̈ d o ʊ ʃ ə s
superconsequence	s u p ə ɹ k ɔ n s ɪ k w ə n s
supereminent	s u p ə ɹ ɛ m ɪ n ə n t
superflux	s u p ə ɹ f l ʌ k s
supernormal	s u p ə ɹ n ɔ ɹ m ə l
supine	s u p a ɪ n
supple	s ʌ p ə l
supplier	s ə p l a ɪ ə
supplying	s ə p l a ɪ ɪ ŋ
support	s ə p ɔ ɹ t
supported	s ə p ɔ ɹ t ɪ d
supposititious	s ə p ɑ z ə t ɪ ʃ ə s
suppository	s ə p ɑ z ɪ t ɔ ɹ i
suppress	s ə p ɹ ɛ s
suppressed	s ə p ɹ ɛ s t
suppurate	s ʌ p j ə r e ɪ t
supremacy	s u p ɹ ɛ m ə s i
surcingle	s ə ɹ s ɪ ŋ ɡ ɫ̩
surge	s ɝ d͡ʒ
surgeon	s ɝ d͡ʒ ə n
surname	s ɝ n e ɪ m
surroundings	s ə ɹ a ʊ n d ɪ ŋ z
surveillance	s ə ɹ v e ɪ l ə n s
survive	s ɚ v a ɪ v
suspire	s ə s p a ɪ ə ɹ
suss	s ʌ s
suxamethonium	s ʌ k s ə m ə θ o ʊ n i ə m
swabby	s w ɔ b i
swabia	s w e ɪ b i ə
swam	s w æ m
swang	s w æ ŋ
swarded	s w ɔ ɹ d ɪ d
swartzite	s w ɔ ɹ t s a ɪ t
swedish	s w i d ɪ ʃ
sweepback	s w i p b æ k
sweet	s w i t
sweetbread	s w i t b ɹ ɛ d
swelt	s w ɛ l t
swill	s w ɪ l
swipe	s w a ɪ p
switched	s w ɪ t͡ʃ t
swither	s w ɪ ð ə
swot	s w ɑ t
sybarite	s ɪ b ə ɹ a ɪ t
sybaritic	s ɪ b ə ɹ ɪ t ɪ k
sycamore	s ɪ k ə m ɔ ɹ
sydney	s ɪ d n i
sylloge	s ɪ l ə d͡ʒ i
sylvester	s ɪ l v ɛ s t ɚ
sympathy	s ɪ m p ə θ i
symploce	s ɪ m p l o ʊ s i
symptoms	s ɪ m p t ə m z
synagogue	s ɪ n ə ɡ ɑ ɡ
synangium	s ɪ n æ n d͡ʒ i ə m
synaptonemal	s ɪ n æ p t o ʊ n i m l̩
synchronic	s ɪ ŋ k ɹ ɑ n ɪ k
syncranterian	s ɪ ŋ k ɹ æ n t ɪ ɹ i ə n
synergy	s ɪ n ɚ d͡ʒ i
synoecism	s ɪ n i s ɪ z ə m
syntactic	s ɪ n t æ k t ɪ k
syntagm	s ɪ n t æ m
syntax	s ɪ n t æ k s
synthesizer	s ɪ n θ ə s a ɪ z ɚ
syphilis	s ɪ f ɪ l ɪ s
syringa	s ɪ ɹ ɪ ŋ ɡ ə
systematize	s ɪ s t ə m ə t a ɪ z
systems	s ɪ s t ə m z
tabitha	t æ b ɪ θ ə
tacey	t e ɪ s i
tache	t æ ʃ
tachometer	t ə k ɔ m ə t ə ɹ
tachycardia	t æ k ɪ k ɑ ɹ d i ə
tachygraphy	t æ k ɪ ɡ ɹ ə f i
tacit	t æ s ɪ t
tacitus	t æ s ɪ t ʊ s
tack	t æ k
taco	t ɑ k o ʊ
tadalafil	t ə d æ l ə f ɪ l
tafe	t e ɪ f
taffety	t æ f ə t i
tag	t æ ɡ
taggart	t æ ɡ ɚ t
tahdig	t aː d i ɡ
taihape	t ʌ ɪ h a p i
tail	t e ɪ l
taille	t a ɪ
tailor	t e ɪ l ɚ
taino	t a ɪ n o ʊ
taipei	t a ɪ p e ɪ
taiwanese	t a ɪ w ɑ n i z
taken	t e ɪ k ə n
takri	ʈ ɑ k ə ɾ i
talarozole	t ə l æ ɹ ə z o ʊ l
talc	t æ l k
talents	t æ l ə n t s
taliesin	t æ l i ɛ s i n
tall	t ɔ l
tallest	t ɔ l ɪ s t
tallies	t a l i s
tambourine	t æ m b ə ɹ i n
tamworth	t æ m w ə ɹ θ
tan	t æ n
tanager	t æ n ə d͡ʒ ə ɹ
tanakh	t ɑ n ɑ x
tancred	t æ ŋ k ɹ ɪ d
tanist	t æ n ɪ s t
tankard	t æ ŋ k ɚ d
tannenbaum	t æ n ə n b a ʊ̯ m
tanner	t æ n ɚ
tantrum	t æ n t ɹ ə m
tanzanite	t æ n z ə n a ɪ t
taper	t e ɪ p ɚ
tapist	t e ɪ p ɪ s t
taqueria	t ɑ k ə ɹ i ə
tar	t ɑ ɹ
tare	t ɛ ɚ
target	t ɑ ɹ ɡ ɪ t
tariff	t ɛ ɹ ɪ f
tarkanian	t ɑ ɹ k e ɪ̯ n i ə n
tarp	t ɑ ɹ p
tarre	t ɑ ɹ
tarsand	t ɑ ɹ s æ n d
tase	t e ɪ z
tasmania	t æ z m e ɪ n i ə
tasting	t e ɪ s t ɪ ŋ
tatty	t æ t i
teacher	t i t͡ʃ ɚ
teachers	t i t͡ʃ ɚ z
teal	t i l
tearsome	t ɪ ɚ s ə m
tearstain	t ɪ ə s t e ɪ n
tebuconazole	t ɛ b j u k ɔ n ə z o ʊ l
technacy	t ɛ k n ə s i
technetium	t ɛ k n i ʃ i ə m
technicality	t ɛ k n ɪ k æ l ɪ t i
technocracy	t ɛ k n ɔ k ɹ ə s i
technology	t ɛ k n ɑ l ə d͡ʒ i
ted	t ɛ d
teep	t i p
teetotal	t i t o ʊ t ə l
teetotaling	t i t o ʊ t ə l ɪ ŋ
teignmouth	t ɪ n m ə θ
teint	t e ɪ n t
telangiectatic	t ɛ l æ n d͡ʒ i ɛ k t æ t ɪ k
telekung	t ə l ə k u ŋ
telemachus	t ə l ɛ m ə k ə s
telepathetic	t ɛ l ə p ə t h ɛ t ɪ k
telepathic	t ɛ l ɪ p æ θ ɪ k
telithromycin	t ə l ɪ θ ɹ o ʊ m a ɪ s n̩
tellurian	t ɛ l j ʊ ɹ i ə n
tellurion	t ɛ l j ʊ ɹ i ə n
tempeh	t ɛ m p e ɪ
tempest	t ɛ m p ə s t
tempos	t ɛ m p o ʊ z
tempted	t ɛ m p t ɪ d
tempting	t ɛ m p t ɪ ŋ
tended	t ɛ n d ɪ d
tendentious	t ɛ n d ɛ n ʃ ə s
tenebrosity	t ɛ n ɪ b ɹ ɑ s ə d i
tenecteplase	t ə n ɛ k t ə p l e ɪ s
tennyson	t ɛ n ɪ s n̩
tensile	t ɛ n s a ɪ ə l
tentacular	t ɛ n t æ k j u l ə ɹ
tentiginous	t ɛ n t ɪ d͡ʒ ɪ n ə s
tenure	t ɛ n j ɚ
tephra	t ɛ f ɹ ə
tepid	t ɛ p ɪ d
terazosin	t ə ɹ e ɪ z ə s ɪ n
terbium	t ɜ ɹ b i ə m
terbutaline	t ɚ b j u t ə l i n
terebrant	t ɛ ɹ ə b ɹ ə n t
terf	t ɝ f
teriyaki	t ɛ ɹ i j ɑ k i
term	t ɝ m
termed	t ɝ m d
terminate	t ɝ m ɪ n e ɪ t
termination	t ɚ m ɪ n e ɪ ʃ ə n
termine	t ɜ ɹ m ɪ n
termini	t ɜ ɹ m ə n a ɪ
terpenoid	t ɝ p ə n ɔ ɪ d
terracotta	t ɛ ɹ ə k ɔ t ə
terribler	t ɛ ɹ ɪ b ə l ə ɹ
terribly	t ɛ ɹ ɪ b l i
terroir	t ɛ ɹ w ɑ ɹ
tertullian	t ə ɹ t ʌ l i ə n
tessellation	t ɛ s ə l e ɪ ʃ ə n
tessitura	t ɛ s ɪ t ʊ ə ɹ ə
testaceous	t ɛ s t e ɪ ʃ ə s
testification	t ɛ s t ɪ f ɪ k e ɪ ʃ ə n
testosterone	t ɛ s t ɑ s t ə ɹ o ʊ n
tetracaine	t ɛ t ɹ ə k e ɪ n
tetraethylammonium	t ɛ t ɹ ə ɛ θ ə l ə m o ʊ n i ə m
tetrahedron	t ɛ t ɹ ə h i d ɹ ə n
tetrahydrogestrinone	t ɛ t ɹ ə h a ɪ d ɹ ə d͡ʒ ɛ s t ɹ ɪ n o ʊ n
tetraoxanes	t ɛ t ɹ ə ɔ k s e ɪ n z
tetrylammonium	t ɛ t ɹ ə l ə m o ʊ n i ə m
tetter	t ɛ t ɚ
texed	t ɛ k s t
textbook	t ɛ k s t b ʊ k
textspeak	t ɛ k s t s p i k
thack	θ æ k
thalia	θ ə l a ɪ ə
thalidomide	θ ə l ɪ d ə m a ɪ d
thallium	θ æ l i ə m
thanatos	θ æ n ə t ɔ s
thank	θ æ ŋ k
thanked	θ æ ŋ k t
thanks	θ æ ŋ k s
thatcherite	θ æ t͡ʃ ə ɹ a ɪ t
thede	θ i d
thelium	θ i l ɪ ə m
them	ð ʌ m
thence	ð ɛ n s
theo	θ i o ʊ
theocracies	θ i ɑ k ɹ ə s i z
theocratical	θ i ə k ɹ æ t ɪ k ə l
theologian	θ i ə l o ʊ d͡ʒ ə n
thereafter	ð ɛ ɹ æ f t ɚ
therefor	ð ɛ ɹ f ɔ ɹ
thereof	ð ɛ ɹ ʌ v
thereout	ð ɛ ɹ a ʊ t
therianthropy	θ ɛ ɹ i æ n θ ɹ ə p i
thermopylae	θ ɚ m ɑ p ɪ l i
thermos	θ ɝ m ə s
theropoda	θ ɪ ɹ ə p ɑ d a
theses	θ i s i z
theseus	θ i s i ə s
thessaloniki	θ ɛ s ə l ə n i k i
thiazide	θ a ɪ ə z a ɪ d
thief	θ i f
thigh	θ a ɪ
think	θ ɪ ŋ k
thinnest	θ ɪ n ə s t
thioguanine	θ a ɪ o ʊ ɡ w ɑ n i n
thiol	θ a ɪ ɔ l
thioridazine	θ a ɪ ə ɹ ɪ d ə z i n
thirdly	θ ɚ d l i
thirsty	θ ɜ ɹ s t i
thlipsis	θ l ɪ p s ɪ s
thomsen	t ɔ m s ə n
thorax	θ ɔ ɹ æ k s
thought	θ ɔ t
thousand	θ a ʊ z ə n d
thousands	θ a ʊ z n̩ d z
thralldom	θ ɹ ɔ l d ə m
threatened	θ ɹ ɛ t n̩ d
threats	θ ɹ ɛ t s
threnody	θ ɹ ɛ n ə d i
threshold	θ ɹ ɛ ʃ h o ʊ l d
thrid	θ ɹ ɪ d
thrilled	θ ɹ ɪ l d
thrillmance	θ ɹ ɪ l m æ n s
thrombin	θ ɹ ɔ m b ɪ n
throstle	θ ɹ ɔ s ə l
throttle	θ ɹ a t ə l
thrush	θ ɹ ʌ ʃ
thrust	θ ɹ ʌ s t
thrusts	θ ɹ ʌ s t s
thuja	θ u d͡ʒ ə
thunder	θ ʌ n d ɚ
thunderbolt	θ ʌ n d ə ɹ b o ʊ l t
thunderdome	θ ʌ n d ɚ d o ʊ m
thunderous	θ ʌ n d ə ɹ ə s
thurrock	θ ʌ ɹ ə k
thus	ð ʌ s
thusly	ð ʌ s l i
thyroid	θ a ɪ̯ ɹ ɔ ɪ̯ d
thyself	ð a ɪ s ɛ l f
tiber	t a ɪ b ə ɹ
tickable	t ɪ k ə b ə l
tied	t a ɪ d
tiffed	t ɪ f t
tijuana	t i w ɑ n ə
tiktaalik	t ɪ k t ɑ l ɪ k
till	t ɪ l
timber	t ɪ m b ɚ
timetable	t a ɪ m t e ɪ b ə l
timonism	t a ɪ m ə n ɪ z ə m
timonist	t a ɪ m ə n ɪ s t
timothy	t ɪ m ə θ i
tincture	t ɪ ŋ k t͡ʃ ɚ
tine	t a ɪ n
tingle	t ɪ ŋ ɡ ə l
tinkering	t ɪ ŋ k ɚ ɪ ŋ
tint	t ɪ n t
tintype	t ɪ n t a ɪ p
tiny	t a ɪ n i
tioguanine	t a ɪ o ʊ ɡ w ɑ n i n
tiotropium	t a ɪ o ʊ t ɹ o ʊ p i ə m
tipsy	t ɪ p s i
tired	t a ɪ ɚ d
tires	t a ɪ̯ ɚ z
tissue	t ɪ ʃ u
titan	t a ɪ t ə n
titer	t a ɪ t ɚ
titianesque	t ɪ ʃ ə n ɛ s k
titty	t ɪ t i
tivoization	t i v o ʊ a ɪ z e ɪ ʃ ə n
tlaloc	t l ə l o ʊ k
toews	t e ɪ v z
tokelau	t o ʊ k ə l a ʊ
tolerable	t ɑ l ə ɹ ə b l̩
toloache	t ɔ l w æ t͡ʃ i
tomalley	t ə m ɑ l i
tomb	t u m
tombolo	t ɔ m b o ʊ l o ʊ
toning	t o ʊ n ɪ ŋ
tonsillitis	t ɔ n s ə l a ɪ t ɪ s
took	t ʊ k
tooter	t u t ə r
toothpick	t u θ p ɪ k
toothy	t u θ i
topepo	t ə p ɛ p o ʊ
topful	t ɔ p f ʊ l
topi	t o ʊ p i
topoisomerase	t ɑ p o ʊ a ɪ s ɑ m ə ɹ e ɪ s
topology	t ə p ɑ l ə d͡ʒ i
topos	t ɔ p ɔ s
topotaxy	t ɔ p ə t æ k s i
topple	t ɑ p l̩
toque	t o ʊ k
torah	t ɔ ɹ ɑ
torn	t ɔ ɹ n
torpedo	t ɔ ɹ p i d o ʊ
torquay	t ɔ ɹ k i
torrefy	t ɔ ɹ ɪ f a ɪ
tossed	t ɔ s t
totalness	t o ʊ t ə l n ə s
totear	t ə t ɛ ɚ
touchdown	t ʌ t͡ʃ d a ʊ n
touchedness	t ʌ t͡ʃ ɪ d n ɪ s
tough	t ʌ f
towkay	t a ʊ k e ɪ
town	t a ʊ n
toxicomania	t ɑ k s ɪ k o ʊ m e ɪ n i ə
toxin	t ɑ k s ɪ n
toy	t ɔ ɪ
toys	t ɔ ɪ z
tracer	t ɹ e ɪ s ɚ
tracing	t ɹ e ɪ s ɪ ŋ
tracks	t ɹ æ k s
traction	t ɹ æ k ʃ ə n
trade	t ɹ e ɪ d
traditionally	t ɹ ə d ɪ ʃ ə n ə l i
tragicize	t ɹ æ d͡ʒ ɪ s a ɪ z
trails	t ɹ e ɪ l z
trained	t ɹ e ɪ n d
trainiac	t ɹ e ɪ n i æ k
traitor	t ɹ e ɪ t ɚ
traitorous	t ɹ e ɪ t ə ɹ ə s
tralineate	t ɹ ə l ɪ n i e ɪ t
tramadol	t ɹ æ m ə d ɔ l
tramline	t ɹ æ m l a ɪ n
trammel	t r æ m ə l
tramps	t ɹ æ m p s
tranquil	t ɹ æ ŋ k w ɪ l
transcend	t ɹ æ n t s ɛ n d
transcendence	t ɹ æ n t s ɛ n d ə n s
transcription	t ɹ æ n s k ɹ ɪ p ʃ ə n
transfinite	t ɹ æ n s f a ɪ n a ɪ t
transgression	t ɹ æ n s ɡ ɹ ɛ ʃ ə n
transliterate	t ɹ æ n z l ɪ t ə ɹ e ɪ t
transnistria	t ɹ æ n z n ɪ s t ɹ i ə
transphonologisation	t r æ n s f ə n ɔ l ə d͡ʒ a ɪ z e ɪ ʃ ə n
transversal	t ɹ æ n s v ɝ s ə l
transwell	t ɹ æ n z w ɛ l
trapezoid	t ɹ æ p ə z ɔ ɪ d
trass	t ɹ æ s
traumatic	t ɹ ɔ m æ t ɪ k
trav	t ɹ æ v
travellers	t ɹ æ v ə l ɚ z
tray	t ɹ e ɪ
tread	t ɹ ɛ d
treadmill	t ɹ ɛ d m ɪ l
treasurer	t ɹ ɛ ʒ ə ɹ ə ɹ
treehouse	t ɹ i h a ʊ s
treen	t ɹ i n
treey	t ɹ i i
trembling	t ɹ ɛ m b l ɪ ŋ
tremellose	t ɹ ɛ m ɛ ɹ l o ʊ z
trend	t ɹ ɛ n d
trepanning	t ɹ ɪ p æ n ɪ ŋ
trepidation	t ɹ ɛ p ɪ d e ɪ ʃ ə n
trevor	t ɹ ɛ v ɚ
trewin	t ɹ u ɪ n
triad	t ɹ a ɪ æ d
triage	t ɹ i ɑ ʒ
triamcinolone	t ɹ a ɪ æ m s ɪ n ə l o ʊ n
triamterene	t ɹ a ɪ æ m t ə ɹ i n
tribalism	t r a ɪ b ə l ɪ z ə m
tributary	t ɹ ɪ b j ʊ t ə ɹ i
tricycle	t ɹ a ɪ s ɪ k ə l
tridem	t ɹ a ɪ d ə m
tried	t ɹ a ɪ d
trigamy	t ɹ ɪ ɡ ə m i
trilithon	t ɹ a ɪ l ɪ θ ɔ n
trilogy	t ɹ ɪ l ə d͡ʒ i
trinidadian	t ɹ ɪ n ɪ d æ d i ə n
trinketry	t ɹ ɪ ŋ k ɪ t ɹ i
tripura	t ɹ ɪ p u ɹ ɑ
triquetra	t ɹ a ɪ k w ɛ t ɹ ə
trisyllabic	t ɹ a ɪ s ɪ l æ b ɪ k
tritone	t͡ʃ ɹ a ɪ t o ʊ n
tritrophic	t ɹ a ɪ t ɹ o ʊ f ɪ k
triturated	t ɹ ɪ t j ʊ ɹ e ɪ t ɪ d
triviality	t ɹ ɪ v i æ l ə t i
troak	t ɹ o ʊ k
trochaic	t ɹ o ʊ k e ɪ ɪ k
trochlea	t ɹ ɔ k l ɪ ə
troika	t ɹ ɔ ɪ k ə
trometamol	t ɹ o ʊ m ɛ t ə m ɔ l
troop	t ɹ u p
tropable	t ɹ o ʊ p ə b ə l
troper	t ɹ o ʊ p ɚ
trophoplast	t ɹ ɑ f o ʊ p l æ s t
tropicamide	t ɹ ə p ɪ k ə m a ɪ d
tropicbird	t ɹ ɔ p ɪ k b ɜ ɹ d
troubleshoot	t ɹ ʌ b l̩ ʃ u t
troupe	t ɹ u p
trowel	t ɹ a ʊ ə l
truage	t ɹ u ɪ d͡ʒ
trucked	t ɹ ʌ k t
truckle	t ɹ ʌ k ə l
trudeau	t ɹ u d o ʊ
trufan	t ɹ u f æ n
trump	t ɹ ʌ m p
trumpeter	t ɹ ʌ m p ɪ t ɚ
trunnion	t ɹ ʌ n j ə n
truthful	t ɹ u θ f ə l
trying	t ɹ a ɪ ɪ ŋ
tryna	t͡ʃ ɹ a ɪ n ə
tryptophyl	t ɹ ɪ p t ə f ɪ l
tschinke	t͡ʃ ɪ ŋ k ə
tube	t j u b
tucson	t u s ɔ n
tudigong	t u d i ɡ ʊ ŋ
tugboat	t ʌ ɡ b o ʊ t
tugs	t ʌ ɡ z
tui	t u i
tulsa	t ʌ l s ə
tulwar	t ʌ l w ɑ ɹ
tumbler	t ʌ m b l ɚ
tumbrel	t ʌ m b ɹ ə l
tumbril	t ʌ m b ɹ ɪ l
tumxuk	t ʌ m ʃ ʊ k
tundra	t ʌ n d ɹ ə
tunes	t j ʉː n s
tungstenic	t ʌ ŋ s t ɛ n ɪ k
tunisia	t u n i ʒ ə
tuoba	t w o ʊ b ɑ
tupiniquim	t u p ɪ n ɪ k w ɪ m
turbid	t ɜ ɹ b ɪ d
turbulent	t ɝ b j ə l ə n t
turf	t ɝ f
turkey	t ɝ k i
turkish	t ɝ k ɪ ʃ
turkman	t ɜ ɹ k m ə n
turnery	t ɜ ɹ n ə ɹ i
turron	t ə ɹ ɔ n
turtle	t ɝ t ə l
tushie	t ʊ ʃ i
tuvaluan	t u v ɑ l u ə n
tux	t ʌ k s
tv	t i v i
tweeze	t w i z
twerp	t w ɝ p
twincest	t w ɪ n s ɛ s t
twinge	t w ɪ n d͡ʒ
twinkle	t w ɪ ŋ k l̩
twinkling	t w ɪ ŋ k l ɪ ŋ
twitchy	t w ɪ t͡ʃ i
twite	t w a ɪ t
twixt	t w ɪ k s t
twp	t ʊ p
tyke	t a ɪ k
tylenol	t a ɪ l ə n ɑ l
tyler	t a ɪ l ɚ
tyng	t ɪ ŋ
type	t a ɪ p
typing	t a ɪ p ɪ ŋ
typings	t ʌ ɪ p ɪ ŋ s
typology	t a ɪ p ɔ l ə d͡ʒ i
tyrannic	t ɪ ɹ æ n ɪ k
tyrant	t a ɪ ɹ ə n t
tyres	t a ɪ ə ɹ z
tzatziki	t s ɑ t s i k i
tzigane	t s ɪ ɡ ɑ n
ubac	j u b æ k
ubiquarian	j u b ɪ k w ɛ ɹ i ə n
udder	ʌ d ɚ
udo	u d o ʊ
uey	j u i
uffish	ʌ f ɪ ʃ
uggo	ʌ ɡ o ʊ
uglish	j u ɡ l ɪ ʃ
ugsome	ʌ ɡ s ə m
ukraine	j u k ɹ e ɪ n
ultramarine	ʌ l t ɹ ə m ə ɹ i n
unakas	j u n e ɪ k ə s
unanimous	j u n æ n ə m ə s
unascertained	ʌ n æ s ɚ t e ɪ n d
unbecoming	ʌ n b ɪ k ʌ m ɪ ŋ
unbeknownst	ʌ n b ɪ n o ʊ n s t
unbelievable	ʌ n b ə l i v ə b l̩
unbind	ʌ n b a ɪ n d
unbosom	ʌ n b ʊ z ə m
unbound	ʌ n b a ʊ n d
uncaged	ʌ n k e ɪ d͡ʒ d
uncalendared	ʌ n k æ l ə n d ɚ d
uncannily	ʌ ŋ k æ n ɪ l i
uncanny	ʌ n k æ n i
uncap	ʌ n k æ p
uncertainly	ʌ n s ɝ t n̩ l i
uncertainty	ʌ n s ɝ t ə n t i
uncomplimentary	ʌ n k ɑ m p l ɪ̈ m ɛ n t ə ɹ i
unconstructive	ʌ n k ə n s t ɹ ʌ k t ɪ v
uncountability	ʌ n k a ʊ n t ə b ɪ l ɪ t i
uncountable	ʌ n k a ʊ n t ə b ə l
uncover	ʌ n k ʌ v ɚ
uncovered	ʌ n k ʌ v ɚ d
und	ʌ n d
undead	ʌ n d ɛ d
underpin	ʌ n d ɚ p ɪ n
understanding	ʌ n d ɚ s t æ n d ɪ ŋ
undevil	ʌ n d ɛ v ɪ l
undinism	ʌ n d i n ɪ z ə m
uneasy	ʌ n i z i
uneconomicalness	ʌ n ɛ k ə n ɑ m ɪ k ə l n ə s
unenthusiastic	ʌ n ɛ n θ j u z i æ s t ɪ k
unequivocal	ʌ n ɪ̈ k w ɪ v ə k ə l
unergatives	ʌ n ɜ ɹ ɡ ə t ɪ v z
unfannish	ʌ n f æ n ɪ ʃ
unfetter	ʌ n f ɛ t ɚ
unfit	ʌ n f ɪ t
ungodly	ʌ n ɡ ɑ d l i
ungrab	ʌ n ɡ ɹ æ b
unguentarium	ʌ ŋ ɡ w ə n t ɛ r i ə m
unguligrade	ʌ ŋ ɡ j u l ə ɡ ɹ e ɪ d
unhelpful	ʌ n h ɛ l p f ə l
unidirectional	j u n ɪ̈ d ɪ̈ ɹ ɛ k ʃ ə n ə l
unimportant	ʌ n ɪ m p ɔ ɹ t ə n t
universal	j u n ɪ v ɝ s l̩
unjust	ʌ n d͡ʒ ʌ s t
unknown	ʌ n n o ʊ n
unlicensed	ʌ n l a ɪ s n̩ s t
unlike	ʌ n l a ɪ k
unmask	ʌ n m æ s k
unmight	ʌ n m a ɪ t
unobtainium	ʌ n ə b t e ɪ n i ə m
unpaid	ʌ n p e ɪ d
unpinked	ʌ n p ɪ ŋ k t
unpleasantness	ʌ n p l e z n t n ə s
unpossible	ʌ n p ɔ s ɪ b ə l
unpretentious	ʌ n p ɹ ə t ɛ n ʃ ə s
unread	ʌ n ɹ ɛ d
unreal	ʌ n ɹ i ə l
unspecified	ʌ n s p ɛ s ɪ f a ɪ d
unspell	ʌ n s p ɛ l
unstable	ʌ n s t e ɪ b ə ɫ
unstate	ʌ n s t e ɪ t
unstinted	ʌ n s t ɪ n t ɪ d
unsub	ʌ n s ʌ b
unsudden	ʌ n s ʌ d n
unsung	ʌ n s ʌ ŋ
untainted	ʌ n t e ɪ n t ɪ d
unthinkable	ʌ n θ ɪ ŋ k ə b ə l
unuttered	ʌ n ʌ t ɚ d
unveil	ʌ n v e ɪ l
unvitiated	ʌ n v ɪ ʃ i e ɪ t ɪ d
unvoiced	ʌ n v ɔ ɪ s t
unwilling	ʌ n w ɪ l ɪ ŋ
upbind	ʌ p b a ɪ n d
upend	ʌ p ɛ n d
uphold	ʌ p h o l d
uprightness	ʌ p ɹ a ɪ t n ə s
uproot	ʌ p ɹ u t
upside	ʌ p s a ɪ d
upstage	ʌ p s t e ɪ d͡ʒ
uptill	ʌ p t ɪ l
uranist	j ʊ ə ɹ ə n ɪ s t
urartu	ʊ ɹ ɑ ɹ t u
urban	ɝ b ə n
urn	ɝ n
ursula	ɝ s ə l ə
urus	j ʊ ə ɹ ə s
usability	j u z ə b ɪ l ɪ t i
user	j u z ɚ
usie	ʌ s i
ussr	j u ɛ s ɛ s ɑ ɹ
usta	j u s t ə
utility	j u t ɪ l ɪ t i
utopia	j u t o ʊ p i ə
utopographer	j u t o ʊ p ɔ ɡ ɹ ə f ə
uvular	j u v j ʊ l ə ɹ
uxoricide	ʌ k s ɔ ɹ ɪ s a ɪ d
vacay	v e ɪ k e ɪ
vaccinate	v æ k s ɪ n e ɪ t
vacillation	v æ s ɪ l e ɪ ʃ ə n
vacs	v æ k s
vacuolation	v æ k j ʊ ə l e ɪ ʃ ə n
vacuolations	v æ k j ʊ ə l e ɪ ʃ ə n z
vade	v e ɪ d
vaduz	v ə d u t s
vagient	v e ɪ d͡ʒ i ə n t
valais	v æ l e ɪ
valencian	v ə l ɛ n s i ə n
valency	v e ɪ l ə n s i
valiant	v æ l j ə n t
validate	v æ l ə d e ɪ t
valletta	v ə l ɛ t ə
valley	v æ l i
values	v æ l j u z
vampiroid	v æ m p a ɪ ə ɹ ɔ ɪ d
vancomycin	v æ ŋ k ə m a ɪ s ɪ n
vanes	v e ɪ n z
vanessa	v ə n ɛ s ə
vanguard	v æ n ɡ ɑ ɹ d
variably	v ɛ ɹ i ə b l i
variations	v ɛ ɹ ɪ e ɪ ʃ ə n z
varietal	v ə ɹ a ɪ ə t ə l
varroid	v æ ɹ ɔ ɪ d
varronian	v æ ɹ o ʊ n i ə n
varve	v ɑ ɹ v
varying	v ɛ ɹ i ɪ ŋ
vasculature	v æ s k j ʊ l ə t͡ʃ ə ɹ
vasquez	v æ s k ɛ z
vaticination	v ə t ɪ s ɪ n e ɪ ʃ ə n
vaughan	v ɔ n
vecuronium	v ɛ k j ə ɹ o ʊ n i ə m
vega	v e ɪ ɡ ə
vegeburger	v ɛ d͡ʒ i b ɜ ɹ ɡ ə ɹ
vegetal	v ɛ d͡ʒ ɪ̈ t l̩
vegete	v ɛ d͡ʒ i t
vehement	v i ə m ə n t
velocipede	v ɪ l ɔ s ɪ p i d
velvet	v ɛ l v ə t
venda	v ɛ n d ə
veneficious	v ɛ n ɪ f ɪ ʃ ə s
vengeance	v ɛ n d͡ʒ ə n s
verb	v ɝ b
verdant	v ɝ d ə n t
veridical	v ə ɹ ɪ d ɪ k ə l
vermiculation	v ɚ m ɪ k j u l e ɪ ʃ ə n
vermiparous	v ɜ ɹ m ɪ p ə ɹ ə s
vermouth	v ɚ m u θ
vernon	v ɝ n ə n
veroboard	v ɪ ə ɹ o ʊ b ɔ ɹ d
verse	v ɝ s
verstehen	v ə ɹ ʃ t e ɪ ə n
vert	v ɝ t
vertebrate	v ɛ ɹ t ɪ b ɹ e ɪ t
vertical	v ɝ t ɪ k ə l
vertically	v ɜ t ɪ k l i
vesicocele	v ɛ s i k o ʊ s i l
vesta	v ɛ s t ə
vestige	v ɛ s t ɪ d͡ʒ
veto	v i t o ʊ
veurne	v ɜ ɹ n ə
vexation	v ɛ k s e ɪ ʃ ə n
vexillation	v ɛ k s ɪ l e ɪ ʃ ə n
vic	v ɪ k
vicenarian	v ɪ s ə n ɛ ɹ i ə n
viceregency	v a ɪ s ɹ i d͡ʒ ə n t s i
victoria	v ɪ k t ɔ ɹ i ə
victories	v ɪ k t ə ɹ i z
victorious	v ɪ k t ɔ r i ə s
victual	v ɪ t l̩
vie	v a ɪ
viewed	v j u d
vig	v ɪ ɡ
vigneron	v i n j ə ɹ ɔ̃
vila	v i l ə
vilipend	v ɪ l ə p ɛ n d
vill	v ɪ l
viminal	v ɪ m ɪ n ə l
vince	v ɪ n s
vinculum	v ɪ ŋ k j ə l ə m
vindicable	v ɪ n d ɪ k ə b l̩
vinetree	v a ɪ n t ɹ i
vino	v i n o ʊ
vintner	v ɪ n t n ɚ
violin	v a ɪ ə l ɪ n
virgule	v ɝ ɡ j u l
virtual	v ɝ t͡ʃ u ə l
virtuous	v ɝ t͡ʃ u ə s
viscerotonic	v ɪ s ə ɹ o ʊ t ɔ n ɪ k
vise	v a ɪ s
visions	v ɪ ʒ ə n z
visto	v ɪ s t o ʊ
vitamin	v a ɪ t ə m ɪ n
vitellointestinal	v ɪ t ɛ l o ʊ ɪ n t ɛ s t ɪ n ə l
vitiate	v ɪ ʃ i e ɪ t
vitreous	v ɪ t ɹ i ə s
vitriol	v ɪ t ɹ i ə l
vivacity	v ɪ v æ s ɪ t i
vive	v a ɪ v
vivid	v ɪ v ɪ d
vivify	v ɪ v ɪ f ʌ ɪ
vivifying	v ɪ v ɪ f ʌ ɪ ŋ
vltava	v ə l t ɑ v ə
vocab	v o k æ b
vocalist	v o ʊ k ə l ɪ s t
vocation	v o ʊ k e ɪ ʃ ə n
vocoid	v o ʊ k ɔ ɪ d
vogue	v o ʊ ɡ
voices	v ɔ ɪ s ɪ z
volitation	v ɑ l ɪ t e ɪ ʃ ə n
volition	v o ʊ l ɪ ʃ ə n
volplane	v ɔ l p l e ɪ n
voltaic	v ɔ l t e ɪ ɪ k
voluble	v ɑ l j ə b ə l
volumes	v ɑ l j u m z
voluminous	v ə l u m ə n ə s
voluntourist	v ɑ l ə n t ʊ ə ɹ ɪ s t
vongole	v ɑ ŋ ɡ ə l e ɪ
vorozole	v ɔ ɹ ə z o ʊ l
votive	v o ʊ t ɪ v
vouch	v a ʊ t͡ʃ
voucher	v a ʊ t͡ʃ ə ɹ
vowel	v a ʊ ə l
vulcanize	v ʌ l k ə n a ɪ z
vulgarian	v ʌ l ɡ ɛ ɹ i ə n
vulnerary	v ʌ l n ɚ ɛ ɹ i
waco	w e ɪ k o ʊ
wafers	w e ɪ f ɚ z
wai	w a ɪ
waiouru	w ʌ ɪ u ɹ u
waist	w e ɪ s t
waistband	w e ɪ s t b æ n d
waisted	w e ɪ s t ɪ d
wait	w e ɪ t
waive	w e ɪ v
waken	w e ɪ k ə n
wale	w e ɪ l
wali	w ɑ l i
walkway	w ɔ k w e ɪ
wallaby	w ɑ l ə b i
walmartian	w ɔ l m ɑ ɹ ʃ ə n
walter	w ɔ l t ɚ
waltz	w ɔ l t s
wandering	w ɑ n d ə ɹ ɪ ŋ
wane	w e ɪ n
waning	w e ɪ n ɪ ŋ
wanker	w æ ŋ k ə ɹ
wantcha	w ʌ n t͡ʃ ə
wapanese	w æ p ə n i z
wapentake	w ɔ p ə n t e ɪ k
war	w ɔ ɹ
warbler	w ɔ ɹ b l ə ɹ
warden	w ɔ ɹ d ə n
wardress	w ɔ ɹ d ɹ ɪ s
warmer	w ɔ ɹ m ɚ
warmongery	w ɔ ɹ m ə ŋ ɡ ə ɹ i
warning	w ɔ ɹ n ɪ ŋ
warranty	w ɔ ɹ ə n t i
wary	w ɛ ɹ i
wasp	w ɑ s p
wastegate	w e ɪ s t ɡ e ɪ t
wat	w æ t
watcher	w ɑ t͡ʃ ɚ
watchword	w ɔ t͡ʃ w ɜ ɹ d
watershed	w ɔ t ɚ ʃ ɛ d
wavelength	w e ɪ v l ɛ ŋ k θ
waving	w e ɪ v ɪ ŋ
waw	w ɔ
wayfare	w e ɪ f ɛ ɹ
wayne	w e ɪ n
waywode	w e ɪ w o ʊ d
weapon	w ɛ p ə n
weaponize	w ɛ p ə n a ɪ z
wears	w ɛ ɹ z
webhook	w ɛ b h ʊ k
wechat	w i t͡ʃ æ t
weck	w ɛ k
wedding	w ɛ d ɪ ŋ
wednesbury	w ɛ n z b ə ɹ i
weepy	w i p i
weer	w i ɚ
wefie	w i f i
weh	w ɛ
weigher	w e ɪ ɚ
weldment	w ɛ l d m ə n t
welkin	w ɛ l k ə n
welshpool	w ɛ l ʃ p u l
weltanschauung	v ɛ l t ɑ n ʃ a ʊ ʊ ŋ
weltanschauungs	v ɛ l t ɑ n ʃ a ʊ ʊ ŋ z
wen	w ɛ n
wend	w ɛ n d
weskit	w ɛ s k ə t
wetness	w ɛ t n ə s
weymouth	w e ɪ m ə θ
wgwag	w ɪ ɡ w æ ɡ
whacks	w æ k s
whakapapa	f a k a p a p a
whasian	w e ɪ ʒ ə n
whataboutery	w ɔ t ə b a ʊ t ə ɹ i
wheaty	w i t i
wheelie	w i l i
whenuapai	f ɛ n u ə p a ɪ
whereof	w ɛ ɹ ʌ v
wheresoeer	w ɝ s o ʊ ɛ ɹ
whinge	w ɪ n d͡ʒ
whippoorwill	w ɪ p ɚ w ɪ l
whirling	w ɝ l ɪ ŋ
whiskey	w ɪ s k i
whispering	w ɪ s p ə ɹ ɪ ŋ
whitsun	w ɪ t s ə n
wholesome	h o ʊ l s ə m
whom	h u m
whomst	h u m s t
whore	h ɔ ɹ
whorish	h ɔ ɹ ɪ ʃ
whosit	h u z ɪ t
widely	w a ɪ d l i
wife	w a ɪ f
wight	w a ɪ t
wild	w a ɪ l d
wildly	w a ɪ l d l i
wiley	w a ɪ l i
will	w ɪ l
willingly	w ɪ l ɪ ŋ l i
willow	w ɪ l o ʊ
winch	w ɪ n t͡ʃ
winchcombe	w ɪ n t͡ʃ k ə m
windage	w ɪ n d ɪ d͡ʒ
windboard	w ɪ n d b ɔ ɹ d
windfall	w ɪ n d f ɔ l
windflaw	w ɪ n d f l ɔ
windfucker	w ɪ n d f ʌ k ə ɹ
windhoek	w ɪ n d h ʊ k
windle	w ɪ n d ə l
windsurf	w ɪ n d s ɜ ɹ f
winner	w ɪ n ɚ
winnie	w ɪ n i
winwick	w ɪ n ɪ k
wiper	w a ɪ p ɚ
wirra	w ɪ ɹ ə
wise	w a ɪ z
wiseass	w a ɪ z æ s
wisecrack	w a ɪ z k ɹ æ k
wishing	w ɪ ʃ ɪ ŋ
wishlist	w ɪ ʃ l ɪ s t
wisp	w ɪ s p
wistful	w ɪ s t f ə l
wit	w ɪ t
witan	w ɪ t ə n
withdrawal	w ɪ ð d ɹ ɔ ə l
wither	w ɪ ð ɚ
witting	w ɪ t ɪ ŋ
wiv	w ɪ v
wives	w a ɪ v z
wizardly	w ɪ z ɚ d l i
wlan	d ʌ b ə l j u l æ n
woaden	w o ʊ d ə n
wog	w ɔ ɡ
wolve	w ʊ l v
womannap	w ʊ m ə n æ p
wonder	w ʌ n d ɚ
wondrous	w ʌ n d ɹ ə s
wood	w ʊ d
woodend	w ʊ d ɛ n d
woodman	w ʊ d m ə n
wooer	w u ɚ
woolfish	w ʊ l f i ʃ
woolily	w ʊ l ɪ l i
woolly	w ʊ l i
worcester	w ʊ s t ɚ
worcesterberry	w ʊ s t ə ɹ b ɛ ɹ i
wore	w ɔ ɹ
worshiped	w ɝ ʃ ɪ p t
worth	w ɝ θ
worthful	w ɚ θ f ɫ̩
wotcher	w ɔ t͡ʃ ə
wouldna	w ʊ d n ə
wowzer	w a ʊ z ə ɹ
wraith	ɹ e ɪ θ
wrake	ɹ e ɪ k
wrapped	ɹ æ p t
wreck	ɹ ɛ k
wrench	ɹ ɛ n t͡ʃ̩̩
wrenches	ɹ ɛ n t͡ʃ ɪ s
wrength	ɹ ɛ ŋ θ
wrestle	ɹ ɛ s ə l
wretchedness	ɹ ɛ t͡ʃ ɪ d n ə s
wriggle	ɹ ɪ ɡ ə l
wright	ɹ a ɪ t
wrigley	ɹ ɪ ɡ l i
wrongly	ɹ ɔ ŋ l i
wryly	ɹ a ɪ l i
wujiaqu	w u d͡ʒ i ɑ t͡ʃ u
wushu	w u ʃ u
wut	w ʌ t
wuv	w ʌ v
wuzu	w u z u
wynkernel	w ɪ ŋ k ə ɹ n ə l
wynn	w ɪ n
wyoming	w a ɪ o ʊ m ɪ ŋ
xanthochroic	z æ n θ ə k ɹ o ʊ ɪ k
xenobacteriology	z ɛ n ə b æ k t ɪ ə ɹ ɪ ɔ l ə d͡ʒ i
xenocytology	z ɛ n ə s a ɪ t ɑ l ə d͡ʒ i
xenogeny	z ɛ n ɔ d͡ʒ ə n i
xenohistory	z ɛ n ə h ɪ s t ə ɹ i
xenomythology	z ɛ n ə m ɪ θ ɔ l ə d͡ʒ i
xenophobia	z i n ə f o ʊ b i ə
xenopsychology	z ɛ n ə ɛ θ s a ɪ k ɑ l ə d͡ʒ i
xerophyte	z ɪ ə ɹ o ʊ f a ɪ t
xerxes	z ɝ k s i z
xianggang	ʃ j ɑ ŋ ɡ ɑ ŋ
xoanon	z o ʊ ə n ɑ n
xuanxue	ʃ w æ n ʃ w e ɪ
xylene	z a ɪ l i n
xyr	z ɪ ɹ
xysma	z ɪ z m ə
yabby	j æ b i
yahweh	j ɑ w e ɪ
yaks	j æ k s
yaldabaoth	j ɑ l d ə b e ɪ ɔ θ
yamaguchi	j ɑ m ə ɡ u t͡ʃ i
yamoussoukro	j ɑ m u s u k ɹ o ʊ
yankee	j æ ŋ k i
yanker	j æ ŋ k ɚ
yantra	j ə n t ɹ ə
yap	j æ p
yard	j ɑ ɹ d
yardbird	j ɑ ɹ d b ɝ d
yarrum	j æ ɹ ə m
yatta	j ɑ t ɑ
yawl	j ɔ l
yayo	j e ɪ o ʊ
yeading	j ɛ d ɪ ŋ
yearn	j ɝ n
yee	j i
yen	j ɛ n
yeoman	j o ʊ m ə n
yeovil	j o ʊ v ɪ l
yerevan	j e ɹ ə v ɑ n
yeses	j ɛ s ɪ z
yeshiva	j ə ʃ i v ə
yesses	j ɛ s ɪ z
yif	j ɪ f
yift	j ɪ f t
ylem	i l ɛ m
yngling	ɪ ŋ l ɪ ŋ
yodel	j o ʊ d ə l
yoga	j o ʊ ɡ ə
yokeag	j o ʊ k i ɡ
yonic	j o ʊ n ɪ k
yore	j ɔ ɹ
yorkie	j ɔ ɹ k i
yoruba	j ɔ ɹ ə b ə
yoshiko	j o ʊ ʃ i k o ʊ
youghal	j ɔ l
youngling	j ʌ ŋ l ɪ ŋ
youngster	j ʌ ŋ s t ɚ
yowzah	j a ʊ z ə
yrneh	ɝ n i
ytterbic	ɪ t ɜ ɹ b ɪ k
ytterbium	ɪ t ɝ b i ə m
yuge	j u d͡ʒ
yuletide	j u l t a ɪ d
yum	j ʌ m
yummy	j ʌ m i
yuppie	j ʌ p i
zacks	z æ k s
zadruga	z æ d ɹ u ɡ ə
zagreb	z ɑ ɡ ɹ ɛ b
zaibatsu	z a ɪ b æ t s u
zakynthos	z ɑ k ɪ n θ ɔ s
zaleplon	z æ l ə p l ɑ n
zamrock	z æ m ɹ ɑ k
zanamivir	z ə n æ m ɪ v ɪ ɹ
zante	z æ n t i
zantedeschia	z æ n t i d ɛ s k i ə
zap	z æ p
zapping	z æ p ɪ ŋ
zax	z æ k s
zeke	z i k
zelensky	z ɪ l ɛ n s k i
zelus	z i l ə s
zenana	z ə n ɑ n ə
zeniths	z ɛ n ɪ θ s
zephyr	z ɛ f ɚ
zerbert	z ɜ ɹ b ə ɹ t
zeus	z u s
zeuxis	z j u k s ɪ s
zhe	ʒ i
zigzag	z ɪ ɡ z æ ɡ
zikr	z i k ɹ
zileuton	z a ɪ l u t n̩
zoetrope	z o ʊ ɪ t ɹ o ʊ p
zolian	z o ʊ l ɪ ə n
zombie	z ɑ m b i
zonal	z o ʊ n ə l
zoomy	z u m i
zoop	z u p
zooplasty	z o ʊ ə p l æ s t i
zoot	z u t
zorro	z ɑ ɹ o ʊ
zotarolimus	z o ʊ t ə ɹ o ʊ l ɪ m ə s
zowerswopped	z a ʊ ɚ s w ɑ p t
zucc	z ʌ k
zulu	z u l u
zygapophysis	z a ɪ ɡ ə p ɔ f ɪ s ɪ s
zygomatic	z a ɪ ɡ ə m æ t ɪ k
zyme	z a ɪ m
