balairung	b a . l a i̯ . r ʊ ŋ
gen	ɡ ɛ n
kapas	k a . p a s
eceran	ɛ t͡ʃ ɛ r a n
nasabah	n a s a b a h
emas	ə m a s
vokal	v o . k a l
bobot	b o . b ɔ t̚
peremajaan	p ə . r ə . m a . d͡ʒ a . a n
instrumental	ɪ n . s t r u . m ɛ n . t a l
mu	m u
bajing	b a . d͡ʒ ɪ ŋ
tenge	t e ŋ e
senter	s ɛ n t ə r
juag	d͡ʒ u a k̚
arit	a . r i t
lajak	l a d͡ʒ a k̚
rahayu	r a h a j u
gatal	ɡ a . t a l
antarpemain	a n t a r p ə m a ɪ n
pleidoi	p l e i . d o i̯
administratur	a t̚ m i n ɪ s t r a t ʊ r
agar	a ɡ a r
pendarahan	p ə n . d a . r a h . a n
pameget	p a . m ə . ɡ ə t
ancai	a n t͡ʃ a i̯
akil	a . k ɪ l
angai	a ŋ a i̯
sentralistis	s ɛ n t r a l ɪ s t ɪ s
hadirat	h a d i r a t̚
negeri	n ə ɡ ə r i
pronomina	p r o . n o . m i . n a
perjaka	p ə r . d͡ʒ a . k a
lansia	l a n s i a
wasana	w a s a n a
pengawasan	p ə ŋ a w a s a n
dolfin	d ɔ l . f i n
pekerti	p ə k ə r t i
bersedia	a b o n ə m ɛ n
vetsin	v ɛ t . ʃ i n
anehe	a n e h e
masyarakat	m a ʃ a r a k a t̚
selalu	s ə l a l u
keadilan	k ə a d ɪ l a n
abilah	a b i l a h
pengungsi	p ə ŋ . ʊ ŋ . s i
eco	e . t͡ʃ o
kempis	k ə m p ɪ s
sandung	s a n d ʊ ŋ
amo	a m o
ustaz	ʊ s t a z
anggrang	a ŋ . ɡ r a ŋ
malem	m a . l ə m
dansa	d a n . s a
amonga	a m o ŋ a
nyiur	ɲ j u r
lengah	l ɛ ŋ a h
amfibi	a m f i b i
tahap	t a . h a p
awur	a w ʊ r
deduksi	d e d ʊ k s i
bam	b a m
perak	p e . r a k
tegap	t ə ɡ a p̚
wudu	w u . d u
reanimasi	r e a n i m a s i
sembrono	s ə m . b ə̆ r o . n o
damkar	d a m . k a r
peka	p e . k a
amah	a m a h
voli	v o . l i
obesitas	o b ɛ . s i . t a s
pinta	p i n t a
meninggali	m ə n i ŋ . ɡ a l i
laher	l a . h ə r
polen	p o l ə n
kegiatan	k ə . ɡ i . a t . a n
riba	r i b a
berbahasa	b ə r b a h a s a
mengalir	m ə ŋ . a . l ɪ r
lelang	l ɛ l a ŋ
kumico	k u . m i . t͡ʃ o
kehidupan	k ə . h i . d ʊ p . a n
membunuh	m ə m b u n ʊ h
padri	p a d r i
sijil	s i d͡ʒ ɪ l
masjid	m a s d͡ʒ ɪ t̚
pencitraan	p ə ŋ t͡ʃ i t r a a n
lengkung	l ə ŋ . k ʊ ŋ
tindas	t ɪ n d a s
perengkahan	p ə . r ə ŋ . k a h . a n
suci	s u . t͡ʃ i
bodok	b o d ɔ k̚
antigen	a n . t i . ɡ ɛ n
elektrode	ɛ . l ɛ k . t r o . d e
audite	a u̯ . d i . t e
defile	d e f i l e
kuil	k u ɪ l
puri	p u . r i
burung	b u . r ʊ ŋ
balur	b a l ʊ r
azan	a z a n
paleontologi	p a . l e . ɔ n . t o . l o . ɡ i
kultivar	k ʊ l . t i . v a r
kerosin	k e r o s ɪ n
makan	m a . k a n
bangsa	b a ŋ . s a
romo	r o m o
galer	ɡ a . l e r
banyak	b a ɲ a k
deplesi	d e p l e s i
tipu	t i . p u
itu	i t u
kenceng	k ə n . t͡ʃ ə ŋ
pulut	p u l ʊ t̚
imam	i . m a m
kopi	k o . p i
hantu	h a n . t u
menganiayai	m ə ŋ a n i a j a i
derita	d ə . r i . t a
torsi	t o r . s i
beradab	b ə r a d a p̚
pembangkang	p ə m b a ŋ k a ŋ
mama	m a m a
hemisfer	h e m i . s f ɛ r
kruk	k r ʊ k
bapak	b a p a ʔ
oligarkis	o . l i . ɡ a r . k ɪ s
stasioner	s t a s i o n ɛ r
batur	b a t ʊ r
langka	l a ŋ k a
penanggalan	p ə n a ŋ ɡ a l a n
stasi	s t a s i
lintasan	l ɪ n . t a s . a n
amali	a . m a . l i
pendukung	p ə n d u k ʊ ŋ
awat	a . w a t
siram	s i . r a m
perut	p ə . r ʊ t̚
yakin	j a k ɪ n
materai	m a . t ə . r a i
videografer	v i d e o ɡ r a f ə r
babango	b a . b a . ŋ o
solidaritas	s o . l i . d a . r i . t a s
ancumcum	a n t͡ʃ ʊ m t͡ʃ ʊ m
makaroni	m a . k a . r o . n i
pengguna	p ə ŋ ɡ u n a
abur	a b ʊ r
gakari	ɡ a . k a . r i
kuliah	k u l i a h
contoh	t͡ʃ ɔ n t ɔ h
e	e
amau	a b u
bisban	b ɪ s b a n
telur	t ə l u r
poros	p ɔ . r ɔ s
pembinaan	p ə m b i n a a n
dinamis	d i n a m ɪ s
dargah	d a r ɡ a h
spesies	s p ɛ . s i . ɛ s
resistansi	r e s ɪ s t a n s i
risalah	r i s a l a h
hembus	h ə m b u s
veteriner	v ɛ . t ə . r i . n ɛ r
anghun	a ŋ . h u n
teh	t ɛ h
ekskursi	ɛ k s k ʊ r s i
kastanya	k a s . t a . ɲ a
imperialisme	ɪ m p ɛ r i a l ɪ s m ə
bangku	b ä ŋ . k u
mengamankan	m ə ŋ a m a n k a n
taaruf	t a a r u f
L	ɛ l
pemda	p ə m d a
alawatae	a l a m ɛ t e
mager	m a ɡ ə r
pengelasan	p ə ŋ ə l a s a n
kor	k ɔ r
menghasilkan	m ə ŋ h a s i l k a n
lateral	l a . t ə . r a l
urita	u r i t a
sepeda	s ə p ɛ . d a
baiduri	b a i̯ . d u . r i
laki	l a k i
Injil	ɪ n . d͡ʒ ɪ l
abir	a b ɪ r
apanase	a p a n a s ə
segitiga	s ə . ɡ i . t i . ɡ a
semak	s ə m a ʔ
bacot	b a c o t
pemberontakan	p ə m b ə r ɔ n t a k a n
sensitivitas	s ɛ n s i t i v i t a s
orangtua	o . r a ŋ . t u . a
kapitan	k a p i t a n
faring	f ä . r i ŋ
tagih	t a ɡ ɪ h
antimikroba	a n t i m i k r o b a
obrol	ɔ b r ɔ l
aanwijzing	a n . w ɛ i . z ɪ ŋ
terjemahan	t ə r d͡ʒ ə m a h a n
terwelu	t ə r w ɛ . l u
ramalan	r a . m a l . a n
parang	p a r a ŋ
adenoma	a . d e . n o . m a
sabi	s a . b i
semir	s ə m i r
kardiolog	k a r . d i . o . l ɔ k
memberi	m ə m b ə r i
kardiogram	k a r . d i . o . ɡ r a m
berus	b ə r ʊ s
halia	h a l i a
antofilia	a n . t o . f i . l i . a
fantastis	f a n t a s t ɪ s
bumi	b u m i
keramat	k ə r a m a t̚
ortu	o r . t u
jarum	d͡ʒ a r u m
hiperaktivitas	h i . p ə r . a k . t i . v i . t a s
kandelir	k a n . d ə . l ɪ r
alfa	a l . f a
plak	p l a k
DIY	d e i j e
petik	p ə . t ɪ k
mendung	m ə n d u ŋ
engkau	ə ŋ k a u̯
subyek	s u b . j ɛ k
tua	t u . a
membata	m ə m b a t a
waktu	w a k . t u
makmum	m a ʔ m ʊ m
hakam	h a . k a m
harimau	h a r i m a u̯
sudut	s u . d ʊ t
nalam	n a l a m
cantik	t͡ʃ a n . t i k
pemulangan	p ə . m u . l a ŋ . a n
suara	s u . w ä . r ä
eksponen	ɛ k s . p o . n ɛ n
autotrof	a u̯ . t o . t r o f
anting	a n t i ŋ
pajanan	p a . d͡ʒ a n . a n
berbicara	b ə r b i t͡ʃ a r a
anua	a . n u . a
degenerasi	d e ɡ e n ə r a s i
korporal	k ɔ r . p o . r a l
bersihan	b ə r . s ɪ h . a n
perjanjian	p ə r . d͡ʒ a n . d͡ʒ i . a n
determinisme	d e . t ɛ r . m ɪ n . ɪ s . m ə
alat	a l a t
kuartal	k u a r t a l
tempat	t ə m p a t
tabal	t a . b a l
penanda	p ə n a n d a
prioritas	p r i o r i t a s
pelumas	p ə l u m a s
malik	m a . l ɪ ʔ
telaah	t ə . l a . ʔ a h
anyam	a ɲ a m
tempel	t ɛ m p ɛ l
ampilalas	a m p i l a l a s
sutra	s u . t r a
langcia	l a ŋ . t͡ʃ i a̯
gelora	ɡ ə l o r a
gergasi	ɡ ə r . ɡ a . s i
mana	m a . n a
alir	a . l ɪ r
Sarawak	s a r a w a ʔ
cowok	t ʃ o . w o ʔ
sempoa	s ə m p o a
bak	b a k
warsa	w a r . s a
sinse	s i n . s e
konsumerisme	k ɔ n s u m ɛ r ɪ s m ə
membawa	m ə m b a w a
mudah	m u d a h
jangan	d͡ʒ a ŋ a n
antor	a n t ɔ r
monsun	m u n s o n
kandung	k a n d ʊ ŋ
sendratari	s ə n . d r a . t a . r i
sendawa	s ə n . d a . w a
enzim	ɛ n . z ɪ m
abam	a b a m
menjaga	m ə n d͡ʒ a ɡ a
berak	b ɛ . r a k
termin	t ə r m ɪ n
wasabi	w a s a b i
kumpulan	k ʊ m p ʊ l a n
selada	s a l a d a
amerta	a m ə r . t a
parlemen	p a r l ə m ɛ n
heterogenitas	h e . t e . r o . ɡ e . n i . t a s
altitudo	a l t i t u d o
persada	p ə r . s a . d a
kawanan	k a w a n a n
nabi	n a b i
handasah	h a n d a s a h
alpa	a l . p a
permukaan	p ə r . m u . k a . a n
cendana	t͡ʃ ə n . d a . n a
kumpul	k ʊ m p ʊ l
tsuru	ʃ u . r u
lantama	l a n t a m a
mulai	m u . l a i̯
pasraman	p a s . r a . m a n
magang	m a . ɡ a ŋ
takraw	t a k̚ . r a w
bencong	b ɛ n . t͡ʃ o ŋ
perasaan	p ə r a s a a n
amoa	a m o a̯
Allah	ɑ l l ɑ h
tir	t ɪ r
kau	k a u̯
karunia	k a r u n i a̯
siomai	s i o m a j
konjungtiva	k ɔ n d͡ʒ ʊ ŋ t i v a
tempura	t ə m . p u . r a
akrilamida	a k r i l a m i d a
tebang	t ə . b a ŋ
bhayangkara	b a . j a ŋ . k a . r a
tamadun	t a . m a . d ʊ n
kesukaran	k ə . s u . k a r . a n
kaji	k a d͡ʒ i
hedonisme	h e . d o . n i s . m ə
reduksionisme	r e . d ʊ k . s i . o . n ɪ s . m ə
arhir	a r . h ɪ r
bibit	b i b ɪ t̚
Nyepi	ɲ ə p i
target	t a r ɡ ɛ t̚
ambyur	a m bʲ ʊ r
ulam	u . l a m
kabur	k a . b ʊ r
pulau	p u l a u̯
lomba	l ɔ m b a
kesenjangan	k ə . s ə n . d͡ʒ a ŋ . a n
bayang	b a . j a ŋ
papir	p a p ɪ r
Anda	a n d a
bengkel	b ɛ ŋ k ɛ l
andalas	a n . d a . l a s
provos	p r o v ɔ s
tempeleng	t ə m . p e . l ɛ ŋ
lupa	l u . p a
permutasi	p ə r m u t a s i
belanjaan	b ə l a n . d͡ʒ a ʔ a n
ana	a n a
gletser	ɡ l ɛ t s ə r
margarin	m a r ɡ a r ɪ n
lengkuas	l ə ŋ . k u . a s
tepat	t ə . p a t
fatwa	f a t . w a
babu	b a b u
alami	a l a m i
selaka	s ə . l a . k a
mendengar	m ə n . d ə . ŋ a r
pantat	p a n t a t̚
babo	b a . b o
aliah	a l i a h
adiafora	a d i a f o r a
taat	t a . ʔ a t̚
standardisasi	s t a n . d a r . d i . s a . s i
afsun	a f s ʊ n
saudara	s a u̯ d a r a
Naufal	n a u . f a l
sumuran	s u m u r a n
biara	b i . a . r a
tantangan	t a n t a ŋ a n
bahwa	b a h . w a
mengemban	m ə ŋ ə m b a n
molekuler	m o . l ə . k u . l ɛ r
persen	p ə r s ɛ n
prabu	p r a . b u
dakwaan	d a ʔ w a a n
berat	b ə r a t
menemukan	m ə n ə m u k a n
prasangka	p r a s a ŋ k a
empiris	ɛ m p i r ɪ s
ketinggalan	k ə t i ŋ . ɡ a . l a n
ponsel	p o n s ɛ l
handuk	h a n d ʊ k̚
dayah	d a j a h
lampak	l a m p a k̚
amleng	a m . l ə ŋ
amben	a m b ə n
isama	i s a m a
bogi	b o . ɡ i
wadah	w a . d a h
soba	s o . b a
slogan	s ə̆ l o . ɡ a n
gagal	ɡ a . ɡ a l
kartun	k a r t u n
celaan	t͡ʃ ə l a a n
JPU	d͡ʒ e p e u
laskar	l a s k a r
sabun	s a b ʊ n
cenderasa	t͡ʃ ə n . d ə . r a . s a
C	t͡ʃ e
kredo	k r e . d o
peluk	p ə l ʊ k
membulat	m ə m b u l a t
amporo	a m p o r o
berambang	b ə . r a m . b a ŋ
difusi	d i f u s i
warak	w a . r a k
ergonomi	e r ɡ o n o m i
diberhentikan	d i b ə r h ə n t i k a n
anjing	a n d͡ʒ i ŋ
romusa	r o . m u . s a
ayo	a j o
praktek	p r a k̚ t ɛ k̚
nira	n i . r a
tirani	t i . r a . n i
katun	k a t u n
grahita	ɡ r a . h i . t a
impresum	ɪ m p r ɛ s ʊ m
maktub	m a k t u b
asonisoni	a . s o . n i . s o . n i
reputasi	r e p u t a s i
Januari	d͡ʒ a . n u . a . r i
toko	t o . k o
pecut	p ə . t͡ʃ ʊ t
gempita	ɡ ə m . p i . t a
cecer	t͡ʃ e . t͡ʃ ɛ r
peres	p ɛ . r ɛ s
sambilan	s a m . b ɪ l . a n
himpunan	h ɪ m p ʊ n a n
terpanjang	t ə r p a n d͡ʒ a ŋ
cabul	t͡ʃ a . b ʊ l
fonem	f o n ɛ m
usul	u s ʊ l
kenyataan	k ə . ɲ a . t a . a n
demang	d ə m a ŋ
hambatan	h a m b a t a n
waja	w a d͡ʒ a
ri	r i
pintu	p ɪ n t u
ahin	a h ɪ n
Rabu	r a . b u
pengusaha	p ə ŋ u s a h a
toto	t o t o
apakah	a p a . k a h
timbang	t ɪ m . b a ŋ
tuwung	t ʊ w ʊ ŋ
menatapi	m ə . n a . t a p . i
waralaba	w a r a l a b a
penguatan	p ə ŋ u a t̚ a n
keruh	k ə r ʊ h
aktivitas	a k̚ t i v i t a s
prasada	p r a . s a . d a
granat	ɡ r a . n a t̚
taun	t a . ʊ n
asuhan	a . s ʊ h . a n
Yogyakarta	j o ɡ j a k a r t a
anjul	a n d͡ʒ ʊ l
kegagalan	k ə . ɡ a . ɡ a l . a n
biro	b i . r o
tertinggal	t ə r t ɪ ŋ ɡ a l
parut	p a . r ʊ t
banua	b a n u a̯
kucing	k u t͡ʃ ɪ ŋ
mantan	m a n t a n
halusinasi	h a l u s i n a s i
informatif	ɪ n f ɔ r m a t ɪ f
tentu	t ə n t u
avtur	a f t ʊ r
folklor	f ɔ l ʔ . l ɔ r
lama	l a . m a
hama	h a m a
Indo	ɪ n d o
staf	s t a f
sandang	s a n d a ŋ
uskup	u s . k ʊ p
mengurutkan	m ə ŋ u r u t k a n
anjiman	a n d͡ʒ i m a n
soleh	s o . l ɛ h
tahi	t a . h i
swasta	s w a s t a
Callista	k a l i s t a
baki	b a k i
lapang	l a p a ŋ
asinkronus	a . s ɪ n . k r ɔ n . ʊ s
menyiarkan	m ə ɲ i a r k a n
bangau	b a ŋ a u̯
mantri	m a n t ə r i
kanstin	k a n . s t ɪ n
prakiraan	p r a . k i . r a . a n
diperkeruh	d i p ə r k ə r ʊ h
ancut	a n . t͡ʃ ʊ t
pemompaan	p ə m ɔ m p a a n
Finlandia	f ɪ n l a n d i a̯
penuntut	p ə . n u n . t ʊ t
ameto	a . m e . t o
loper	l o . p ə r
pemeriksaan	p ə m ə r ɪ k s a a n
memperburuk	m ə m p ə r b u r ʊ k̚
juta	d͡ʒ u t a
tahun	t a . h ʊ n
argo	a r . ɡ o
infeksius	ɪ n . f ɛ k . s i . ʊ s
mendam	m ə n . d a m
daidanco	d a i . d a n . t͡ʃ o
reforestasi	r e f o r ɛ s t a s i
aruna	a r u n a
asat	a s a t̚
ketentuan	k ə t ə n t u a n
kebo	k ə b o
sanggul	s a ŋ . ɡ ʊ l
balo	b a l o
bahaya	b a h a j a
PM	p e ɛ m
rumput	r ʊ m p ʊ t̚
adaptif	a d a p . t ɪ f
beri	b ə r i
benduan	b ə n . d u . a n
fluida	f l u i d a
calon	t͡ʃ a . l o n
nahas	n a h a s
inventaris	ɪ n . v ɛ n . t a . r ɪ s
audiometer	a u̯ . d i . o . m e . t ə r
altar	a l t a r
kardiovaskular	k a r d i o v a s k u l a r
teokrasi	t e o k r a s i
celapa	t͡ʃ ə . l a . p a
amahatua	a m a h a t u a̯
tirta	t i r . t a
sangat	s a . ŋ a t
perintah	p ə r ɪ n t a h
asalamualaikum	a s . s a . ˌl a m . m u . a . l a j k u m
kring	k r ɪ ŋ
riadat	r i a d a t̚
ribu	r i b u
asin	a s ɪ n
eksplikatif	ɛ k s p l i k a t ɪ f
kompet	k ɔ m p ɛ t̚
memasak	m ə m a s a k̚
qanun	q a n u n
patahan	p a t a h a n
dosin	d o . s i n
agresi	a ɡ . r ɛ . s i
Belarusia	b e l a r u s i a̯
pelembapan	p ə . l ə m . b a p . a n
instrumentasi	ɪ n . s t r u . m ɛ n . t a . s i
marhabanan	m a r h a b a n a n
semangka	s ə . m a ŋ . k a
frekwensi	f r e k . w ɛ n . s i
alumpa	a l ʊ m p a
kopitiam	k o p i t i a m
satwa	s a t̚ w a
persenyawaan	p ə r s ə ɲ a w a a n
saputangan	s ä p u ˌt ä ŋ a n
lestari	l ə s . t a . r i
wajah	w a . d͡ʒ a h
lihat	l i h a t̚
tukul	t u . k ʊ l
arjer	a r . d͡ʒ ɛ r
chindo	t͡ʃ i n d o
m	ɛ m
aborigin	a . b o . r i . ɡ ɪ n
alanggaya	a l a ŋ ɡ a j a
dramatis	d r a m a t ɪ s
Denmark	d ɛ n m a r k
salpeter	s a l . p ɛ . t ə r
yubileum	j u b i l e ʊ m
bendahari	b ə n . d a . h a . r i
skalar	s k a . l a r
samudra	s a m u d r a
litigasi	l i . t i . ɡ a . s i
hadiah	h a d i j a h
epos	e . p ɔ s
BNN	b e ɛ n ɛ n
arbor	a r b ɔ r
mengabadi	m ə ŋ . a . b a . d i
zakar	z a k a r
awet	a . w ɛ t
berangkat	b ə . r a ŋ . k a t
eklips	ɛ k . l i p s
nyanyi	ɲ a ɲ i
maju	m a . d͡ʒ u
baftah	b a f t a h
kenan	k ə . n a n
rusak	r u . s a k̚
tamat	t a m a t̚
komplementer	k ɔ m . p l ə . m ɛ n . t ɛ r
sedang	s ə d a ŋ
ideologi	i d e o l o ɡ i
paro	p a r o
luwes	l u w ə s
puputan	p u . p ʊ t . a n
ipar	i p a r
turunan	t u r u n a n
investor	ɪ n . v ɛ s . t ɔ r
antariksawan	a n t a r ɪ k s a w a n
KHS	k a h a ɛ s
mizab	m i z a p̚
alas	a . l a s
Skotlandia	s k ɔ t l a n d i a̯
jenasah	d͡ʒ ə n a s a h
aporia	a . p o . r i . a
hipernim	h i p ə r n ɪ m
kastil	k a s . t ɪ l
aslosin	a s . l o . s ɪ n
syahbandar	ʃ a h . b a n . d a r
jurang	d͡ʒ u . r a ŋ
tiri	t i r i
TPS	t e . p e . ɛ s
cabai	t͡ʃ a b a j
anggara	a ŋ ɡ a r a
kait	k a ɪ t̚
anido	a n i d o
mertua	m ə r t u a̯
balugut	b a l u ɡ ʊ t̚
anau	a n a u̯
kembang	k ə m b a ŋ
sentosa	s ə n . t o . s a
resep	r ə s ɛ p
kilap	k i l a p̚
analitis	a n a l i t ɪ s
datu	d a t u
digdaya	d i ɡ . d a . j a
arloji	a r l o d͡ʒ i
patriarkat	p a . t r i . a r . k a t̚
darma	d a r . m a
apologia	a p o l o ɡ i a̯
duta	d u . t a
laknat	l a k n a t̚
inflasi	ɪ n . f l a . s i
pap	p a p
ekstrinsik	ɛ k s . t r ɪ n . s ɪ k
eksplorasi	ɛ k s p l o r a s i
ayeuh	a j ɤ h
ansambel	a n s a m b ə l
mengabsen	m ə ŋ . a p . s e n
bausastra	b a . u . s a s . t r a
anyir	a ɲ ɪ r
terpal	t ə r p a l
mayit	m a j i t̚
tatap	t a . t a p̚
darah	d a r a h
angsongar	a ŋ s o ŋ a r
sekali	s ə . k a . l i
belajar	b ə . l a . d͡ʒ a r
aviditas	a . v i . d i . t a s
romansa	r o m a n s a
komisi	k o m i . s i
digali	d i . ɡ a l i
sabo	s a . b o
atan	a t a n
nila	n i . l a
koneksi	k o n ɛ k s i
tar	t a r
diode	d i o d ə
marhaban	m a r h a b a n
lanca	l a n . t͡ʃ a
pengen	p ɛ . ŋ ɛ n
perkataan	p ə r . k a . t a . a n
kakak	k a . k a ʔ
zalir	z a l i r
anuhuai	a . n u . h u . a i̯
erotis	ɛ r o t ɪ s
amar	a m a r
kurung	k u . r ʊ ŋ
paru	p ä . r u
sapa	s a . p a
satori	s a . t o . r i
faktor	f a k̚ t ɔ r
siomay	s j o m a j
vulkanologi	f u l k a n o l o ɡ i
swafoto	s w a . f o . t o
sarung	s a r ʊ ŋ
puas	p u a s
dedak	d ə . d a k
rantau	r a n . t a u̯
perhatian	p ə r . h a . t i . a n
pahala	p a . h a . l a
angpao	a ŋ . p a o
mengingat	m ə ŋ ɪ ŋ a t̚
pekerjaan	p ə . k ə r . d ʒ a . ʔ a n
endap	ə n . d a p
pangkal	p a ŋ k a l
diferensial	d i . f e . r ɛ n . s i . a l
rokok	r o k o ʔ
gravitasi	ɡ r a v i t a s i
hilang	h i l a ŋ
inset	i n s ɛ t
taksaka	t a k s a k a
belum	b ə l ʊ m
yen	j ɛ n
panduan	p a n . d u . a n
mencium	m ə ɲ t͡ʃ i u m
lalat	l a . l a t̚
gelita	ɡ ə l i t a
kusta	k ʊ s t a
observasi	ɔ p̚ . s ə r . v a . s i
pengumuman	p ə ŋ u m ʊ m a n
mengendalikan	m ə . ŋ ə n . d a . l i . k a n
dana	d a . n a
berlibur	b ə r l i b ʊ r
magis	m a . ɡ ɪ s
cara	t͡ʃ a . r a
peradilan	p ə r . a . d ɪ l . a n
sponsor	s p ɔ n . s ɔ r
gravir	ɡ r a . v ɪ r
persatuan	p ə r s a t u a n
abiseka	a b i . s e . k a
alasan	a l a s a n
andurabian	a n d u r a b i a n
kernet	k ə r n ɛ t̚
Waruna	w a . r u . n a
alewar	a l e w a r
Belarus	b e l a r ʊ s
unta	ʊ n t a
seudati	s ɘ d a t i
ꦲꦤ	ɔ n ɔ
tempur	t ə m p ʊ r
terowongan	t ə r o w ɔ ŋ a n
penghulu	p ə ŋ . h u . l u
gada	ɡ a d a
semalem	s ə . m a . l ə m
KPR	k a . p e . ɛ r
amanra	a m a n r o
cagar	t͡ʃ a . ɡ a r
anumerta	a n u . m ə r . t a
turus	t u . r ʊ s
gunseikan	ɡ u n . s e i . k a n
algoritmik	a l ɡ o r ɪ t̚ m ɪ k̚
timbal	t ɪ m b a l
prei	p r e i
kamuflase	k a m u f l a s ə
dunia	d u . n i . a
andir	a n d ɪ r
peringatan	p ə r ɪ ŋ a t̚ a n
tenggeret	t ə ŋ ɡ ɛ r ɛ t
antunga	a n . t u . ŋ a
mangkat	m a ŋ k a t̚
lokalisir	l o k a l i s ɪ r
laksana	l a k s a n a
anggong	a ŋ ɡ ɔ ŋ
iklan	ɪ k l a n
sarasehan	s a . r a . s ɛ h . a n
meritokratis	m e . r i . t o . k r a . t ɪ s
bea	b e a̯
antesis	a n t e s ɪ s
abu	a b u
penganggaran	p e ŋ . a ŋ . ɡ a r . a n
antidotum	a n . t i d o . t ʊ m
bendel	b ə n d ə l
ikhlas	i x l a s
hasad	h a s a t̚
aksara	a k . s a . r a
pejagalan	p ə . d͡ʒ a . ɡ a l . a n
margin	m a r . ɡ ɪ n
ambataron	a m b a t a r ɔ n
ompol	o m . p o l
bakpau	b a k . p a ʊ̯
bina	b i n a
menampilkan	m ə n a m p i l k a n
balik	b a l ɪ k̚
deaminasi	d e a m i n a s i
vibrasi	v i . b r a . s i
simak	s i m a ʔ
pemrograman	p ɛ m r o ɡ r a m a n
uban	u . b a n
arif	a r ɪ f
evaluasi	ɛ v a l u a s i
menyerahkan	m ə ɲ ə r a h k a n
lakon	l a k ɔ n
vasodilatasi	v a s o d i l a t a s i
vasokonstriksi	v a s o k ɔ n s t r ɪ k s i
makasih	m a . k a . s ɪ h
autokrasi	a u t o k r a s i
aci	a t͡ʃ i
flop	f l ɔ p̚
iktibar	ɪ ʔ t i b a r
merusak	m ə r u s a ʔ
bahtera	b a h . t ə . r a
harga	h a r . ɡ a
turun	t u . r ʊ n
semenanjung	s ə m ə n a n d͡ʒ ʊ ŋ
gempa	ɡ ə m p a
dorongan	d ɔ r ɔ ŋ a n
dawet	d a . w ə t
ankanan	a n k a n a n
tato	t a t o
apsara	a p . s a . r a
aliran	a . l ɪ r . a n
ampot	a m p ɔ t̚
terburuk	t ə r b u r ʊ k̚
angkrok	a ŋ k r ɔ k̚
apoking	a . p o . k ɪ ŋ
pramulansia	p r a . m u . l a n . s i a
antardesa	a n t a r d ɛ s a
sekat	s ə . k a t̚
akatopi	a k a t o p i
istibra	ɪ s t ɪ p r a ʔ
publikasi	p u b l i k a s i
busana	b u . s a . n a
kardiologis	k a r . d i . o . l o . ɡ ɪ s
angkasawan	a ŋ k a s a w a n
penerimaan	p ə . n ə . r i . m a . a n
karak	k a . r a k
kasar	k a . s a r
sakelar	s a . k ə . l a r
wewenang	w ə . w ə . n a ŋ
aksiomatik	a k . s i . o . m a . t ɪ k
mengumpamakan	m ə ŋ u m p a m a k a n
tandang	t a n . d a ŋ
lapis	l a . p ɪ s
lipur	l i . p ʊ r
lebar	l e b a r
kenek	k ə n ɛ k
wangsa	w a ŋ . s a
adat	a . d a t
mungkir	m u ŋ k i r
maestro	m a . ɛ s . t r o
ponpes	p ɔ n p ə s
Surabaya	s u r a b a j a
pelacur	p ə . l a . t͡ʃ ʊ r
dasar	d a s a r
guna	ɡ u n a
roman	r o . m a n
kelahiran	k ə . l a . h ɪ r . a n
gangsa	ɡ a ŋ . s a
aniaya	a n i . a . j a
bohong	b o . h o ŋ
teraniaya	t ə r a n i a j a
lempira	l e m p i r a
penyesuaian	p ə ɲ ə s u a i̯ a n
ampul	a m . p ʊ l
adpis	a t̚ p ɪ s
erti	ə r . t i
wizurai	w i z u r a i̯
kurawa	k u r a w a
ekor	ɛ . k o r
daerah	d a ɛ r a h
kutang	k u . t a ŋ
suami	s u a̯ . m i
kafilah	k a f i l a h
AS	a . ɛ s
kebugaran	k ə . b u . ɡ a r . a n
bahu	b ä . h u
mawas	m a w a s
sa	s a
henti	h ə n̪ . t̪ i
seko	s e . k o
tegak	t ə ɡ a k̚
joli	d͡ʒ o l i
monarki	m o n a r k i
resmi	r ə s . m i
zalim	z a l ɪ m
takal	t a . k a l
takut	t a . k u t
ajaran	a d͡ʒ a r a n
cangklek	t͡ʃ a ŋ k l e k̚
dikti	d ɪ k̚ t i
sri	s ə r i
amudi	a m u d i
d	d e
bakwan	b a ʔ w a n
butana	b u . t a . n a
idap	ɪ d a p̚
pelarian	p ə . l a . r i . a n
surga	s ʊ r ɡ a
kelembapan	k ə . l ə m . b a p . a n
utara	u t a r a
rames	r a . m ə s
ovum	ɔ v ʊ m
sana	s a n a
menayangkan	m ə n a j a ŋ k a n
pekan	p ə k a n
Habil	h a b ɪ l
Shinto	ʃ i n . t o
heng	h ɛ ŋ
pelepasan	p ə l ə p a s a n
jang	j a ŋ
KTP	k a t ɛ p ɛ
kelar	k ə . l a r
Mbojo	m b o j o
serundeng	s ə . r ʊ n . d ɛ ŋ
penganiaya	p ə ŋ a n i a j a
kuilu	k u i . l u
krans	k r a n s
anangkolaki	a n a ŋ k o l a k i
tabu	t a b u
arti	a r . t i
kebakaran	k ə b a . k a r a n
elang	ə l a ŋ
lapuk	l a p u k
peranti	p ə r a n t i
intonasi	ɪ n t o n a s i
ketahanan	k ə t a h a n a n
kokoh	k o k ɔ h
Batam	b a t a m
gap	ɡ a p
kewajiban	k ə w a d͡ʒ i b a n
amputan	a m p ʊ t a n
kardiovaskuler	k a r d i o v a s k u l ɛ r
metana	m ɛ . t a . n a
kofte	k ɔ f t e
antok	a n t ɔ k̚
mengenai	m ə ŋ ə n a i
fatamorgana	f a t a m ɔ r ɡ a n a
belom	b ə . l o m
sake	s a . k e
bersama	b ə r s a m a
luang	l u a ŋ
askese	a s k e s ə
s'lalu	s l a . l u
anamolepo	a n a m o l e p o
dawat	d a w a t̚
BNPT	b e ɛ n p e t e
belantara	b ə . l a n . t a . r a
amati	a . m a . t i
mayat	m a j a t̚
bumbung	b u m b u ŋ
paha	p a h a
angin	a ŋ i n
kitas	k i . t a s
anak	a . n a k
apen	a p ə n
pelepah	p ə . l ə . p a h
ider	i d ə r
amiug	a m i ʊ k̚
suket	s u k ə t̚
proklamasi	p r o k l a m a s i
A	a
benih	b ə n ɪ h
indekos	i n d ə k ɔ s
parsimoni	p a r . s i . m o . n i
Anatolia	a . n a . t o . l i . a
bobrok	b o . b r ɔ k
advisor	a t . v i . s ɔ r
hidrogen	h i d r o ɡ ɛ n
unggul	u ŋ ɡ ʊ l
jeneng	d͡ʒ ɛ . n ɛ ŋ
keibodan	k e i . b o . d a n
l	ɛ l
seremoni	s e . r e . m o . n i
kelambu	k ə l a m b u
hijrah	h i d͡ʒ r a h
tutorial	t u . t o . r i . a l
kajur	k a d͡ʒ u r
peraturan	p ə r a t u r a n
estafet	ɛ s . t a . f ɛ t
angsang	a ŋ s a ŋ
mempengaruhi	m ə m . p ə . ŋ a . r u h . i
doyo	d o . j o
silet	s i l ɛ t̚
beruang	b ə r u a̯ ŋ
tamatan	t a m a t̚ a n
mag	m ɑ h
membantah	m ə m . b a n . t a h
babaun	b a . b a . ʊ n
sertifikat	s e r t i f i k a t
bilateral	b i . l a . t ə . r a l
bidan	b i . d a n
sulfur	s ʊ l . f ʊ r
afiliator	a f i l i a t ɔ r
awaagama	a . w a . a . ɡ a . m a
Oktober	ɔ k̚ . t o . b ə r
lokalisasi	l o k a l i s a s i
Jatim	d͡ʒ a t i m
cakalang	t͡ʃ a . k a . l a ŋ
kers	k ɛ r s
Ahad	a h a t̚
anfal	a n . f a l
serong	s ɛ r ɔ ŋ
November	n o . v ɛ m . b ə r
gaz	ɡ a z
wihara	w i . h a . r a
argiria	a r ɡ i r i a̯
sekong	s e . k o ŋ
romusya	r o . m u . ʃ a
sanggah	s a ŋ ɡ a h
sipil	s i p ɪ l
lulusan	l u l ʊ s a n
datuk	d a t ʊ k̚
meraja	m ə r a d͡ʒ a
biwara	b i . w a . r a
layang	l a . j a ŋ
propana	p r o . p a . n a
udon	u . d o n
polah	p o l a h
pelanggar	p ə . l a ŋ . ɡ a r
timah	t i m a h
karateka	k a . r a . t e . k a
dosa	d o s a
arababu	a r a b a b u
kesegarisan	k ə . s ə . ɡ a . r ɪ s . a n
bunting	b ʊ n . t ɪ ŋ
awota	a w o . t a
timpang	t ɪ m . p a ŋ
geng	ɡ ɛ ŋ
perdata	p ə r d a t a
abortus	a b ɔ r t̪ ʊ s
Antartika	a n t a r t i k a
ganti	ɡ a n . t i
tenggelam	t ə ŋ ɡ ə l a m
hayat	h a . j a t̚
D	d e
majelis	m a d͡ʒ ə l ɪ s
resleting	r e s . l ɛ . t i ŋ
merubah	m ə r u b a h
rembesan	r ə m b ə s a n
radius	r a d i ʊ s
redundansi	r e . d ʊ n . d a n . s i
meninggal	m ə n ɪ ŋ ɡ a l
garuda	ɡ a r u d a
berketombe	b ə r k ə t ɔ m b e
terorisme	t e . r ɔ r . ɪ s . m ə
adorasi	a . d o . r a . s i
piktogram	p ɪ k . t o . ɡ r a m
cam	t͡ʃ a m
sasana	s a . s a . n a
pelan	p ə l a n
andem	a n d ə m
huruf	h u r ʊ f
budi	b u . d i
falak	f a l a k̚
toksin	t ɔ k . s ɪ n
termoregulasi	t ɛ r . m o . r e . ɡ u . l a . s i
idealisme	i . d e . a l . ɪ s . m ə
wol	w o l
bersih	b ə r s ɪ h
khawatir	x a w a t ɪ r
bendahara	b ə n . d a . h a . r a
lang	l a ŋ
gita	ɡ i . t a
rembes	r ɛ m b ɛ s
candra	t͡ʃ a n . d r a
kiai	k i a i̯
y	j e
bajaj	b a . d ʒ a i̯
tunang	t u . n a ŋ
dorong	d o r o ŋ
menggarisi	m ə ŋ . ɡ a . r i s . i
oase	o a s ə
kapanewon	k a . p a . n e . w ɔ n
pelatih	p ə l a t ɪ h
brahmana	b r a h m a n a
asesmen	a s ɛ s m ə n
pembakuan	p ə m . b a . k u . a n
Turki	t u r k i
dong	d ɔ ŋ
awak	a w a k
sayur	s a j u r
giro	ɡ i r o
ditangkap	d i t a ŋ k a p̚
tenggorok	t̪ ə ŋ . ɡ o . r o k̚
tiris	t i r i s
lensa	l ɛ n s a
publisitas	p u b l i s i t a s
kepada	k ə p a d a
letjend	l ə t d͡ʒ ə n d
binawah	b i n a w a h
mampu	m a m p u
berantas	b ə r a n t a s
penyederhanaan	p ə . ɲ ə . d ə r . h a . n a . a n
tadah	t a d a h
farsakh	f a r s a x
kaf	k a f
kaftan	k a f t a n
eling	e . l ɪ ŋ
perunggu	p ə . r ʊ ŋ . ɡ u
bibi	b i b i
duka	d u . k a
badare	b a . d a . r ə
pelapukan	p ə . l a . p ʊ k . a n
sensei	s e n . s e i
kwasiorkor	k w a s i ɔ r k ɔ r
persneling	p ə r . s n e . l i ŋ
impuls	ɪ m . p ʊ l s
membeli	m ə m . b e . l i
tindakan	t ɪ n . d a . k a n
lima	l i . m ä
industri	ɪ n . d ʊ s . t r i
hechting	h ɛ k̚ t ɪ ŋ
mangkuk	m a ŋ k ʊ k̚
gula	ɡ u . l a
honje	h ɔ n d͡ʒ e
kemanusiaan	k ə m a n u s i a̯ a n
mastautin	m a s t a u̯ t ɪ n
sosialisme	s o s i a l ɪ s m ə
goban	ɡ o . b a n
kelab	k ə l a b
KTT	k a . t e . t e
manti	m a n t i
linier	l i n i ɛ r
tajin	t a . d͡ʒ ɪ n
limit	l i m ɪ t̚
kitab	k i . t a p̚
arapota	a . r a . p o . t a
Bibel	b i . b ə l
puja	p u . d͡ʒ a
taksir	t a k̚ s ɪ r
parah	p a r a h
seterika	s ə . t ə . r i . k a
rakyat	r a k j a t
harmonisasi	h a r . m o . n i . s a . s i
wicara	w i . t͡ʃ a . r a
itas	i t a s
balikan	b a l i k a n
kimus	k i m ʊ s
o	o
riol	r i . ɔ l
gejala	ɡ ə . d͡ʒ a . l a
jasuke	d͡ʒ a s u k e
mahram	m a h r a m
baya	b a . j a
KTSP	k a t e ɛ s p e
penerapan	p ə . n ə . r a p . a n
indra	i n . d r a
spesifik	s p ɛ s i f ɪ k̚
teriyaki	t ɛ . r i . j a . k i
ambu	a m b u
efektif	ɛ f ɛ k̚ t ɪ f
apokdim	a . p ɔ ʔ . d ɪ m
paroki	p a . r o . k i
instrumen	ɪ n . s t r u . m ɛ n
finansial	f i n a n s i a l
apek	a . p ɛ k
apa	a p a
Khairunnisa	x a i r u n i s a
anggi	a ŋ ɡ i
ken	k ɛ n
simpangan	s ɪ m . p a ŋ . a n
memimpin	m ə m ɪ m p ɪ n
akselerasi	a k s e l ə r a s i
baronsai	b a . r o n . s a i̯
populasi	p o p u l a s i
nyonya	ɲ o ɲ a
bad	b a t̚
atur	a t ʊ r
PHBS	p e h a b e ɛ s
badek	b a . d ə k
muda	m u . d a
intipan	ɪ n t ɪ p̚ a n
anoda	a . n o . d a
lusin	l u s i n
kelapa	k ə l a p a
benar	b e . n a r
serdadu	s ə r d a d u
eigendom	e i . ɡ ə n . d o m
kekasih	k ə k a s ɪ h
hibah	h i b a h
letak	l ə t a ʔ
berkap	b ə r k a p̚
kebupatian	k ə b u p a t i a n
adempauze	a d ə m . p a u̯ . z ə
kuwu	k u . w u
jurnalisme	d͡ʒ ʊ r . n a . l ɪ s . m ə
artropoda	a r t r o p o d a
dingin	d i ŋ ɪ n
gading	ɡ a . d i ŋ
bantahan	b a n t a h a n
perpanjangan	p ə r p a n d͡ʒ a ŋ a n
a	a
syabas	ʃ a . b a s
gereja	ɡ ə r ɛ d͡ʒ a
makanan	m a k a . n a n
Bengkulu	b ə ŋ k u l u
perdarahan	p ə r . d a . r a h . a n
dijelaskan	d i d͡ʒ ə l a s k a n
deforestasi	d e . f o . r ə s . t a . s i
seperti	s ə p ə r t i
kencana	k ə n . t͡ʃ a . n a
amanat	a m a n a t̚
auban	a u . b a n
terima	t ə r i m a
adodui	a d o d u i̯
terung	t ə . r ʊ ŋ
simposium	s ɪ m . p o . s i . ʊ m
tangguh	t a ŋ ɡ ʊ h
baktau	b a k . t a ʊ̯
telepon	t e l e p ɔ n
setempat	s ə t ə m p a t̚
ijazah	ɪ d͡ʒ a z a h
bazar	b a . z a r
aplaus	a p . l a . u s
fasakh	f a s a ʔ
blumbak	b l ʊ m b a k̚
rumus	r u m ʊ s
ancala	a n t͡ʃ a l a
Nyonya	ɲ o ɲ a
ḍiri	a b o n ə m ɛ n
lobang	l o b a ŋ
canggih	t͡ʃ a ŋ . ɡ i h
toksikologi	t ɔ k . s i . k o . l o . ɡ i
performer	p ə r f ɔ r m ə r
nirkarat	n i r k a r a t
pirus	p i r ʊ s
jelita	d͡ʒ ə l i t a
syahadat	ʃ a h a . d a t̚
kumulatif	k u m u l a t ɪ f
nafiri	n a f i r i
arbei	a r . b e i̯
perasat	p ə . r a . s a t
verano	v e r a n o
handal	h a n d a l
polimer	p o . l i . m ɛ r
sehat	s ɛ h a t̚
x	ɛ k s
bruder	b r u d ə r
teokratis	t e o k r a t ɪ s
musang	m u s a ŋ
ranjang	r a n . d͡ʒ a ŋ
sanak	s a . n a ʔ
terbit	t ə r b ɪ t̚
tensi	t ɛ n s i
ibukota	i . b u . k o . t a
sarkas	s a r k a s
ditemukan	d i t ə m u k a n
transparansi	t r a n s p a r a n s i
coker	t͡ʃ o k ə r
iktidal	ɪ ʔ t i d a l
ampal	a m p a l
punya	p u ɲ a
biliun	b i l i ʊ n
kebut	k ə b ʊ t̚
disposisi	d i s . p o . s i . s i
seka	s ɛ k a
maklumat	m a ʔ l u m a t̚
kompi	k ɔ m p i
adenopati	a . d ə . n o . p a . t i
ambekpati	a m b ə k̚ p a t i
onderdil	o n . d ə r . d i l
angsana	a ŋ s a n a
I	i
sabit	s a b ɪ t̚
pangkat	p a ŋ k a t̚
ayun	a j ʊ n
umbi	ʊ m . b i
perbani	p ə r . b a . n i
akademi	a k a . d e . m i
cuitan	t͡ʃ u ɪ t̚ a n
raba	r a b a
madrasah	m a d r a s a h
lues	l u . e s
sabar	s a b a r
bawang	b a w a ŋ
Saka	s a k a
defleksi	d e . f l ɛ k . s i
inspirasi	ɪ n s p i r a s i
aib	aʲ i b
jala	d͡ʒ a l a
penjahat	p ə n d͡ʒ a h a t̚
etik	ɛ t ɪ k
panekuk	p a . n ə . k u k
biologis	b i o l o ɡ ɪ s
averoisme	a . v e . r o . ɪ s . m ə
mengoplos	m ə ŋ . o p . l o s
sumbu	s ʊ m . b u
voucer	v o u̯ t͡ʃ ə r
Jumat	d͡ʒ ʊ m . ʔ a t
heiho	h e i . h o
ibadah	i . b a . d a h
ambulralra	a m b ʊ l r a l r a
delesi	d e . l e . s i
anglung	a ŋ . l u ŋ
ananim	a n a n ɪ m
dongkrak	d ɔ ŋ k r a k̚
berubah	b ə r ʊ b a h
nirharapan	n i r h a r a p a n
keik	k ɛ . i k
suiseki	s u i . s e . k i
akeo	a k e o
genderuwo	ɡ ə n . d ə . r u . w o
acar	a t͡ʃ a r
malam	m a l a m
magfirah	m a ʔ f i r a h
tepar	t ɛ p a r
borgol	b ɔ r ɡ ɔ l
gagak	ɡ a . ɡ a ʔ
planologi	p l a n o l o ɡ i
titinada	t i . t i . n a . d a
klub	k l u p
begawan	b ə . ɡ a . w a n
cuat	t͡ʃ u . a t
paus	p a ʊ s
ancak	a n t͡ʃ a k̚
GGL	ɡ e . ɡ e . ɛ l
penghancuran	p ə ŋ h a n t͡ʃ ʊ r a n
herbarium	h ɛ r . b a . r i . ʊ m
aeropolis	a e r o p o l ɪ s
ragu	r a ɡ u
deflasi	d e f l a s i
keripik	k ə r i p ɪ k̚
raga	r a . ɡ a
karnivora	k a r n i v o r a
devisa	d e . v i . s a
gastrointestinal	ɡ a s . t r o . ɪ n . t ɛ s . t i . n a l
PDIP	p ɛ d ɛ i p ɛ
samsek	s a m . s ə k
jauhar	d͡ʒ a u̯ h a r
mendasar	m ə n d a s a r
watas	w a t a s
kewartawanan	k ə . w a r . t a . w a n . a n
indoktrinasi	ɪ n . d ɔ k . t r i . n a . s i
eter	ɛ t ə r
sungkit	s ʊ ŋ k ɪ t
deselerasi	d e s ɛ l ə r a s i
zakat	z a k a t̚
angko	a ŋ k o
kuantum	k u a n t ʊ m
eksperimen	ɛ k s p ɛ r i m ɛ n
momentum	m o . m ɛ n . t ʊ m
Bali	b a l i
tinggal	t ɪ ŋ ɡ a l
galak	ɡ a . l a k
segel	s ɛ ɡ ə l
watak	w a . t a ʔ
tenggorokan	t̪ ə ŋ . ɡ o . r o . k ä n
singgasana	s i ŋ . ɡ a . s a . n a
visus	v i s ʊ s
mengecam	m ə . ŋ ə . t͡ʃ a m
nuansa	n u a n s a
mitos	m i t o s
duit	d u . i t
humanisme	h u . m a . n ɪ s . m ə
palang	p a l a ŋ
inventarisasi	ɪ n . v ɛ n . t a . r i . s a . s i
sublimasi	s ʊ p l i m a s i
karsa	k a r s a
padus	p a . d u s
biku	b i . k u
suplai	s ʊ p l a i̯
etude	e t u d ɛ
mendiamkan	m ə n d i a m k a n
terlalu	t ə r l a l u
bancak	b a n t͡ʃ a ʔ
ketan	k ə t a n
iga	ɪ ɡ a
taju	t a d͡ʒ u
kandela	k a n . d e . l a
penyelenggaraan	p ə . ɲ ə . l ə ŋ . ɡ a . r a . a n
debu	d ə b u
rogol	r ɔ . ɡ ɔ l
awetan	a . w ɛ t . a n
angkutan	a ŋ k ʊ t a n
ragil	r a . ɡ ɪ l
kanonis	k a n o n ɪ s
menara	m ə n a r a
adiwastra	a d i w a s t r a
samurai	s a . m u . r a i
parak	p a . r a ʔ
gapura	ɡ a p u r a
bukan	b u k a n
judogi	d͡ʒ u . d o . ɡ i
gelak	ɡ ə l a k
perkara	p ə r . k a . r a
Ibrani	i b r a n i
hara	h a . r a
tentang	t ə n t a ŋ
Betawi	b ə t a w i
gagang	ɡ a . ɡ a ŋ
Jepang	d͡ʒ ə p a ŋ
bakcang	b a ʔ . t͡ʃ a ŋ
PSK	p ɛ ɛ s k a
Natal	n a . t a l
berapa	b ə . r a . p a
bekintangon	b ɛ k ɪ n t a ŋ ɔ n
ia	i a̯
lajur	l a d͡ʒ u r
rujak	r u d͡ʒ a ʔ
lekong	l e . k o ŋ
beledu	b ə l ə d u
dokumentografi	d o k u m ɛ n t o ɡ r a f i
ambyang	a m bʲ a ŋ
kuat	k u a t̚
takar	t a k a r
bujangga	b u . d͡ʒ a ŋ . ɡ a
Senin	s ə . n ɪ n
jamur	d͡ʒ a . m ʊ r
mantul	m a n t ʊ l
otot	ɔ t ɔ t
reksa	r ə k . s a
anaria	a . n a . r i . a
H	h a
pemilik	p ə m i l ɪ ʔ̚
toilet	t o i̯ . l ɛ t̚
bubuk	b u b u k
palisade	p a l i s a d ə
kuntit	k ʊ n t ɪ t̚
cucu	t͡ʃ u . t͡ʃ u
kadi	k a . d i
handelar	h a n d ə l a r
cemani	t͡ʃ ə . m a . n i
ensiklik	e n s i k l i k
awo	a w o
kepatuhan	k ə . p a . t ʊ h . a n
matkul	m a t . k ʊ l
fajar	f a d͡ʒ a r
insidental	ɪ n . s i . d ɛ n . t a l
sepatu	s ə . p a . t u
hedon	h e . d o n
kehausan	k ə . h a ʊ s . a n
ampor	a m p ɔ r
estetis	ɛ s t ɛ t ɪ s
grup	ɡ r ʊ p̚
mukjizat	m ʊ ʔ d͡ʒ i z a t̚
duli	d u l i
punca	p ʊ n . t͡ʃ a
keponakan	k ə p o n a k a n
pedupaan	p ə d u p a a n
lasik	l a . s i k
watan	w a . t a n
guru	ɡ u . r u
jernih	d͡ʒ ə r n i h
kanguru	k a ŋ u r u
amuk	a m ʊ k̚
ngab	ŋ a b
penelitian	p ə . n ə . l i . t i . a n
penganiayaan	p ə ŋ a n i a j a a n
dom	d ɔ m
pacu	p a . t͡ʃ u
apotek	a p o . t e k
Iduladha	i d u l a d a
bugil	b u ɡ ɪ l
etana	e . t a . n a
resistor	r e s ɪ s t ɔ r
yudikatif	j u d i k a t ɪ f
kahar	k a h a r
muwakil	m u w a k i l
mandraguna	m a n . d r a . ɡ u . n a
degeneratif	d e ɡ e n ə r a t ɪ f
ageisme	a ɡ e ɪ s m ə
ekonomis	ɛ k o n o m ɪ s
tangga	t a ŋ ɡ a
ambong	a m b ɔ ŋ
sprei	s ə p . r e i
gagah	ɡ a . ɡ a h
instruksional	ɪ n . s t r ʊ k . s i . o . n a l
suf	s ʊ f
ꦢꦺꦱ	d e . s ɔ
tautan	t a ʊ t a n
stoples	s t ɔ p l ɛ s
merupakan	m ə r u p a k a n
edaran	e . d a r . a n
kelengkiak	k ə l ə ŋ k i a k̚
pahlawan	p a h l a w a n
independen	i n . d ə . p ɛ n . d ə n
loket	a b o n ə m ɛ n
atmosferis	a t m ɔ s f ɛ r ɪ s
kidal	k i d a l
perhentian	p ə r h ə n t j a n
jerami	d͡ʒ ə r a m i
surat	s u . r a t
papan	p a p a n
hipotenusa	h i p o t ə n u s a
tebusan	t ə . b u . s a n
frekuensi	f r e k u ɛ n s i
ligamen	l i ɡ a m ɛ n
stereotipe	s t e r e o t i p ə
taraf	t a . r a f
lisan	l i . s a n
ayam	a . j a m
cogan	t͡ʃ o . ɡ a n
seprai	s ə p . r a i
dicatat	d i t͡ʃ a t a t̚
galat	ɡ a l a t̚
komplot	k o m p l o t
Malingsia	m ä l ɪ ŋ . s i a
hadirin	h a d i r ɪ n
pendekatan	p ə ŋ . d ə . k a t . a n
nisbah	n ɪ s b a h
absolusi	a b s o l u s i
rahmat	r a h m a t
Surakarta	s u r a k a r t a
gugur	ɡ u . ɡ ʊ r
defekasi	d e f e k a s i
mual	m u a l
gelis	ɡ ə . l ɪ s
perban	p ə r . b a n
cerana	t͡ʃ ə . r a . n a
nepotisme	n e p ɔ t̚ ɪ s m ə
kendala	k ə n d a l a
betonase	b ə t o n a s ə
lapangan	l a p a ŋ a n
epitel	ɛ p i t ɛ l
cerca	t͡ʃ ə r . t͡ʃ a
beleran	b ɛ l ɛ r aː n
moci	m o t͡ʃ i
kek	k ɛ ʔ
tentara	t ə n t a r a
tahu	t a u
satah	s a t a h
jawab	d͡ʒ a . w a p̚
biadab	b i a d a p̚
pesumo	p ə . s u . m o
BBLR	b e b e ɛ l ɛ r
blek	b l ɛ k
tanah	t a . n a h
beli	b ə l i
bapao	b a . p a o
bagian	b a ɡ iʲ a n
mari	m a . r i
kelarutan	k ə . l a . r u . t a n
undangan	ʊ n . d a ŋ . a n
agul	a ɡ ʊ l
empal	ə m . p a l
dewa	d ɛ . w a
tengkujuh	t ə ŋ k u d͡ʒ ʊ h
berjibaku	b ə r . d͡ʒ i . b a . k u
zen	z ɛ n
Petrus	p ɛ t r ʊ s
perdikan	p ə r d i k a n
selak	s e . l a k
afirmasi	a f ɪ r m a s i
lahir	l a . h ɪ r
aforestasi	a f o r ɛ s t a s i
agih	a ɡ ɪ h
bodo	b o . d o
sela	s e . l a
weker	w ɛ . k ə r
PR	p ɛ . ɛ r
pengadaan	p ə ŋ . a d a . a n
badi	b a d i
Indonesia	i n . d o . n ɛ . s ɪ . j a
petrus	p ə t r ʊ s
kabus	k a b ʊ s
adiksimba	a d ɪ k s ɪ m b a
mol	m ɔ l
lompat	l ɔ m p a t̚
kamikaze	k a m i k a z e
aliansi	a l i a n s i
keasaman	k ə a s a m a n
sujud	s u d͡ʒ ʊ t̚
alamete	a l a m ɛ t e
memberikan	m ə m b ə r i k a n
ahuh	a h ʊ h
berdarah	b ə r d a r a h
cilik	t͡ʃ i . l ɪ k
jentera	d͡ʒ ə n t ə r a
losin	l o . s i n
honji	h o n . d͡ʒ i
dimakan	d i . m a k a n
bukti	b u k . t i
dekomposisi	d e k ɔ m p o s i s i
situasional	s i t u a s i o n a l
spaning	s p a . n i ŋ
kacung	k a t͡ʃ ʊ ŋ
fantasi	f a n t a s i
herbisida	h ɛ r b i s i d a
piama	p i a m a
astana	a s . t a . n a
giling	ɡ i l ɪ ŋ
perserikatan	p ə r . s ə . r i . k a t . a n
amplokan	a m p l o k a n
kanit	k a . n i t
jadwal	d͡ʒ a t̚ w a l
berpulang	b ə r p u l a ŋ
afdeling	a f . d e . l i ŋ
ambekdarma	a m b ə k̚ d a r m a
Bapa	b a p a
kuadran	k u a̯ d r a n
versi	v ɛ r s i
unik	u n i k
interferensi	ɪ n t ə r f ə r ɛ n s i
rongga	r ɔ ŋ . ɡ ä
Sabrina	s a b r i n a
sembuh	s ə m b ʊ h
sulit	s u l ɪ t̚
hidayah	h i d a j a h
takeyari	t a . k e . y a . r i
pasokan	p a s ɔ k a n
adik	a . d ɪ k
syah	ʃ a h
anakompo	a n a k ɔ m p o
protein	p r o t e ɪ n
hidrokarbon	h i . d r o . k a r . b ɔ n
anglo	a ŋ . l o
diri	d i . r i
segara	s ə ɡ a r a
kandil	k a n . d ɪ l
jawi	d͡ʒ a . w i
helikopter	h e . l i . k ɔ p . t ə r
panas	p a . n a s
alokai	a l o k a i̯
membilah	m ə m b i l a h
soang	s o a̯ ŋ
bozah	b o z a h
hikmah	h i k m a h
nasi	n a s i
riskan	r i s . k a n
margasatwa	m a r . ɡ a . s a t . w a
rambut	r ä m . b u t̪̚
bijak	b i . d͡ʒ a k
orang	o . r a ŋ
asidulan	a s i . d u . l a n
tukar	t u k a r
radikalisasi	r a d i k a l ɪ s a s i
menggempita	m ə ŋ . ɡ ə m . p i . t a
cerpelai	t͡ʃ ə r p ə l a j
Sunda	s ʊ n d a
alpukat	a l p u k a t
kersen	k ɛ r s ə n
sarapan	s a r a p̚ a n
Aceh	a t͡ʃ e h
empati	ɛ m p a t i
klasikal	k l a s ɪ k . a l
penderita	p ə n d ə r i t a
aritmetika	a . r i t . m ɛ . t i . k a
datang	d a t a ŋ
panko	p a n . k o
telefon	t e l e f ɔ n
titrasi	t i t r a s i
ufuk	u f ʊ k
akselerator	a k . s e . l ə . r a . t ɔ r
basmi	b a s . m i
asumsi	a s ʊ m s i
gaharu	ɡ a h a r u
uduk	u . d ʊ k
terkait	t ə r k a ɪ t̚
seminar	s ə m i n a r
ubin	u b i n
koroner	k o r o . n ɛ r
kustar	k ʊ s t a r
penegakan	p ə . n ə . ɡ a k . a n
hewani	h e w a n i
proses	p r o s ɛ s
puntung	p ʊ n t ʊ ŋ
psikologis	p ə s i k o l o ɡ ɪ s
benda	b ə n . d a
ansai	a n . s a i̯
kecam	k ə . t͡ʃ a m
kohesi	k o h e s i
dilah	d i l a h
antik	a n . t i k
bilang	b i l a ŋ
dengar	d ə . ŋ a r
gudang	ɡ u d a ŋ
literasi	l i t ə r a s i
asmara	a s . m a . r a
astronaut	a s t r o n a u̯ t̚
saja	s a d͡ʒ a
batik	b a t ɪ k
aktivasi	a k̚ t i v a s i
pura	p u . r a
tablig	t a b l ɪ k̚
kolektivisme	k o l ɛ k t i v ɪ s m ə
konpers	k ɔ n p ɛ r s
wajib	w a d͡ʒ ɪ p
peradaban	p ə r a d a p a n
balumba	b a l ʊ m b a
teorema	t e o r ɛ m a
lateks	l a . t ɛ k s
sepur	s ə p u r
wuku	w u . k u
tinta	t i n . t a
jamu	d͡ʒ a m u
pelopor	p ə l o p ɔ r
spesifisitas	s p e s i f i s i t a s
ingin	i . ŋ i n
tukang	t u . k a ŋ
syal	ʃ a l
q	k
tudung	t u . d ʊ ŋ
argentum	a r . ɡ ɛ n . t ʊ m
uber	u b ə r
dojo	d o . d͡ʒ o
semong	s ə m ɔ ŋ
meong	m e . o ŋ
sopir	s o p ɪ r
perolehan	p ə r o l ɛ h . a n
hanzi	h a n . z i
antrap	a n t r a p̚
asiri	a s i r i
bersuasana	b ə r . s u . w ä . r ä
keputusasaan	k ə p u t u s a s a a n
Estonia	e s t o n i a̯
lantamil	l a n t a m ɪ l
IP	i . p e
menjarum	m ə n d͡ʒ a r u m
Italia	ɪ t a l i a̯
fotosel	f o t o s ɛ l
kertas	k ə r t a s
lazuardi	l a z u a r d i
rendah	r ə n d a h
gundik	ɡ u n d i ʔ
ais	a ʔ ɪ s
parpol	p a r . p o l
potongan	p ɔ t ɔ ŋ a n
daras	d a r a s
losmen	l o s . m ɛ n
antuk	a n t u k
awuta	a w u . t a
perlengkapan	p ə r . l ə ŋ . k a p . a n
antarbahasa	a n t a r b a h a s a
śāsana	s a . s a . n a
mudra	m u d . r a
tambur	t a m b ʊ r
bradikardia	b r a . d i . k a r . d i a̯
kirik	k i . r ɪ ʔ
Bulgaria	b ʊ l ɡ a r i a̯
keluar	k ə . l u . a r
SAKIP	s a k ɪ p̚
kuintal	k w i n t a l
ateisme	a t e ɪ s m ə
bukak	b u k a k̚
kapan	k a . p a n
deduktif	d e d ʊ k t ɪ f
utan	u . t a n
Daffa	d a f a
tadarus	t a d a r u s
aftab	a f t a p̚
mazbah	m a z b a h
alot	a l ɔ t̚
gandeng	ɡ a n . d ɛ ŋ
aneka	a n ɛ . k a
fluks	f l ʊ k s
kudeta	k u d ɛ t a
rem	r ɛ m
putaran	p u . t a . r a n
ketersediaan	k ə . t ə r . s ə . d i . a . a n
apang	a p a ŋ
fakir	f a k ɪ r
gulud	ɡ u l ʊ t̚
tumbuh	t ʊ m b ʊ h
hadap	h a d a p̚
nakhoda	n a x o d a
dua	d u w ä
abalalu	a b a l a l u
diet	d i e t̚
devosi	d e v o s i
N	ɛ n
kriptogamik	k r ɪ p t o ɡ a m ɪ k
balak	b a l a ʔ
kolam	k o . l a m
mencela	m ə ŋ t͡ʃ ə l a
tamtama	t a m t a m a
aktris	a k t r ɪ s
asam	a s a m
akseptasi	a k . s ɛ p . t a . s i
diam	d i . a m
mengetatkan	m ə ŋ ə t a t̚ k a n
sandar	s a n d a r
amoh	a m ɔ h
rancang	r a n . t͡ʃ a ŋ
seharian	s ə . h a . r i . a n
bravo	b r a . v o
ikan	i k a n
santap	s a n . t a p̚
seri	s e . r i
langau	l a ŋ a u̯
mewah	m ɛ w a h
ramal	r a m a l
ergonomis	e r ɡ o n o m ɪ k
ilham	ɪ l h a m
anaheha	a n a h e h a
kedatangan	k ə d a t a ŋ a n
lengket	l ɛ ŋ k ɛ t̚
artikula	a r . t i . k u . l a
edisi	ɛ d i s i
pada	p a d a
terjelas	d͡ʒ ə l a s
aji	a d͡ʒ i
rapat	r a p a t
memberhentikan	m ə m b ə r h ə n t i k a n
kering	k ə r ɪ ŋ
sitoplasma	s i t o p l a s m a
steker	a b o n ə m ɛ n
nanti	n a n . t i
rasa	r a . s a
penyiksaan	p ə . ɲ ɪ k . s a . a n
alpiris	a l . p i . r ɪ s
televisi	t e l e v i s i
babka	b a p . k a
kosmonaut	k ɔ s m o n a u̯ t̚
kardiologi	k a r . d i . o . l o . ɡ i
anfakah	a n f a k a h
piadah	p i a d a h
tawar	t a w a r
tas	t a s
cadar	t͡ʃ a . d a r
arwah	a r . w a h
agraris	a ɡ r a r ɪ s
darat	d a r a t
maljum	m a l d͡ʒ u m
bunuh	b u n ʊ h
seniman	s ə n i m a n
Sumbar	s u m b a r
jelas	d͡ʒ ə l a s
intoleransi	ɪ n t o l e r a n s i
dekat	d ə k a t
G	ɡ e
didik	d i d ɪ ʔ
ganjar	ɡ a n d͡ʒ a r
konus	k o n ʊ s
homo	h o . m o
silsilah	s ɪ l s i l a h
jangankan	d͡ʒ a . ŋ a n . k a n
cempaka	t͡ʃ ə m . p a . k a
alutta	a l ʊ t t a
greha	ɡ r ə . h a
basantara	b a . s a n . t a . r a
empu	ə m p u
montase	m ɔ n . t a . s ə
anuitas	a . n u . i . t a s
influen	ɪ n f l u ɛ n
tersebar	t ə r s ə b a r
lengan	l ə . ŋ ä n
pembelahan	p ə m b ə l a h a n
seprei	s ə p . r e i
emoji	e . m o . d͡ʒ i
bab	b a b
arus	a . r ʊ s
percuma	p ə r t͡ʃ u m a
September	s ɛ p̚ . t ɛ m . b ə r
lenjer	l ə n d͡ʒ ə r
kejuruan	k ə . d͡ʒ u . r u . a n
capung	t͡ʃ a p ʊ ŋ
ambir	a m b ɪ r
rasuah	r a . s u . a h
M	ɛ m
ancaman	a n . t͡ʃ a . m a n
anjal	a n d͡ʒ a l
babad	b a b a t̚
kartika	k a r . t i . k a
indikator	ɪ n d i k a t ɔ r
hadir	h a . d ɪ r
sesak	s ə . s a k
sempurna	s ə m . p u r . n a
awam	a w a m
aboi	a . b o i̯
Jokowi	d͡ʒ o k o w i
bertambah	b ə r t a m b a h
geostasioner	ɡ e o s t a s i o n ɛ r
ampa	a m p a
gabah	ɡ a b a h
khatam	x a t a m
alel	a . l ɛ l
bang	b a ŋ
kesejahteraan	k ə s ə d͡ʒ a h t ə r a a n
tanda	t a n d a
gerus	ɡ ə . r ʊ s
lokapasar	l o k a p a s a r
pengendali	p ə . ŋ ə n . d a . l i
sampling	s a m p l ɪ ŋ
Perak	p ɛ . ɾ ʌ ʔ
nah	n a h
besikal	b ə s i . k a l
bel	b ɛ l
andala	a n d a l a
puji	p u . d͡ʒ i
cadang	t͡ʃ a . d a ŋ
skor	s k o r
transfigurasi	t r a n s f i ɡ u r a s i
berdasar	b ə r d a s a r
antil	a n t ɪ l
melansir	m ə . l a n . s ɪ r
feodalisme	f e o d a l ɪ s m ə
kali	k a . l i
buni	b u n i
diperburuk	d i p ə r b u r ʊ k̚
Ngawi	ŋ a w i
mendoa	m ə n d o a
kinase	k i . n a . s ə
prinsip	p r ɪ n s ɪ p̚
badam	b a d a m
Habel	h a b e l
menit	m ə n ɪ t
alferes	a l f e r e s
membranofon	m ɛ m b r a n o f ɔ n
mufasir	m u f a s ɪ r
kombinasi	k ɔ m b i n a s i
bus	b ʊ s
gayung	ɡ a j u ŋ
anaweli	a . n a . w e . l i
gawang	ɡ a w a ŋ
kerbau	k ə r b a u̯
obi	o . b i
ambo	a m . b o
resorpsi	r e s ɔ r p s i
pengucapan	p ə ŋ . u . t͡ʃ a p . a n
J	d͡ʒ e
menel	m e n e l
resonansi	r e . s o . n a n . s i
pecutan	p ə t͡ʃ ʊ t a n
olah	ɔ l a h
panjang	p a n d͡ʒ a ŋ
elipsis	e . l ɪ p . s ɪ s
demografi	d e m o ɡ r a f i
anaye	a n a j ɛ
pendek	p e n . d e k
kelinci	k ə l ɪ n . t͡ʃ i
kelas	k ə l a s
katode	k a . t o . d ə
bayu	b a j u
silabis	s i . l a . b ɪ s
ambiguitas	a m b i ɡ u i t a s
aplikatif	a p l i k a t ɪ f
slendro	s l ɛ n . d r o
hukuman	h u k u . m a n
blangko	b ə̆ l a ŋ k o
munsyi	m u n . ʃ i
endapan	ə n d a p a n
fotoelektrisitas	f o t o ɛ l ɛ k̚ t r i s i t a s
jangka	d͡ʒ a ŋ k a
KK	k a . k a
liturgis	l i . t ʊ r . ɡ ɪ s
permusyawarahan	p ə r m u ʃ a w a r a h a n
yo	j oː
pionir	p i o n ɪ r
konsultatif	k ɔ n . s ʊ l . t a . t ɪ f
kaprodi	k a . p r o . d i
ketimpangan	k ə t ɪ m p a ŋ a n
amer	a m ɛ r
amra	a m r a
ketat	k ə t a t
anungo	a . n u . ŋ o
hindar	h ɪ n . d a r
maka	m a k a
jelata	d͡ʒ ə . l a . t a
firaun	f i r . a . u n
wana	w a . n a
mancanegara	m a n . t͡ʃ a . n ə ɡ a . r a
hop	h o p
adipenghantar	a d i p ə ŋ h a n t a r
andap	a n . d a p
lipat	l i . p a t̚
ꦱꦺꦮ	s e w a
wanda	w a n . d a
suka	s u k a
buka	b u k a
duktus	d ʊ k̚ t ʊ s
maling	m a . l ɪ ŋ
dikau	d i k a u̯
swakriya	s w a k r i j a
anakia	a n a k i a̯
sungai	s u ŋ a i̯
mesjid	m ə s d͡ʒ ɪ t̚
garansi	ɡ a r a n s i
cenangga	t͡ʃ ə . n a ŋ . ɡ a
tasbih	t a s b ɪ h
badul	b a . d ʊ l
sumatif	s u . m a . t ɪ f
elektromagnetisme	ɛ l ɛ k t r o m a k n ɛ t ɪ s m ə
kelurahan	k ə . l u . r a h . a n
Belanda	b ə . l a n . d a
sumo	s u . m o
keberatan	k ə b ə r a t a n
mustahik	m ʊ s t a h ɪ k̚
tunda	t ʊ n d a
hentai	h ɛ n . t a i̯
transparan	t r a n s p a r a n
dewan	d ɛ w a n
barah	b a . r a h
manira	m a . n i . r a
asal	a . s a l
gala	ɡ a l a
asid	a s ɪ t
tawakal	t a w a k a l
babi	b a b i
ecer	ɛ t͡ʃ ɛ r
audiometri	a u̯ . d i . o . m e . t r i
wafat	w a f a t̚
lada	l a d a
loh	l ɔ h
seratus	s ə r a t ʊ s
menambah	m ə n a m b a h
tuntut	t u n . t ʊ t
menggali	m ə ŋ . ɡ a . l i
bupati	b u . p a . t i
vulkanis	v ʊ l k a n ɪ s
gerha	ɡ ə r . h a
kilang	k i l a ŋ
dehidrasi	d e h i d r a s i
Maret	m a r ə t
E	e
keturunan	k ə . t u . r u . n a n
hayati	h a . j a . t i
memperkokoh	m ə m p ə r k o k ɔ h
kunjung	k ʊ n . d͡ʒ ʊ ŋ
lowong	l ɔ w ɔ ŋ
butun	b u t u n
informasi	i n f ɔ r m a s i
penjelajah	p ə n d͡ʒ ə l a d͡ʒ a h
menghadiri	m ə ŋ . h a . d i r . i
kehakiman	k ə . h a . k ɪ m . a n
jumlah	d͡ʒ ʊ m l a h
antum	a n t ʊ m
proyek	p r o . j ɛ k
sedawa	s ə . d a . w a
irama	i r a m a
membanguni	m ə m b a ŋ ʊ n i
kartografer	k a r t o ɡ r a f ə r
ekaristi	ɛ k a r i s t i
ambekara	a m b e k a r a
among	a m ɔ ŋ
kamber	k a m . b ə r
Juni	d͡ʒ u . n i
awar	a w a r
baling	b a l ɪ ŋ
cuek	c u e ʔ
delman	d e l . m a n
dorna	d o r n a
saat	s a . ʔ a t
sadeu	s a d ɘ
aplikan	a p̚ l i k a n
lauk	l a . ʊ ʔ
adijana	a . d i . d͡ʒ a . n a
semah	s ə m a h
rasio	r a s i o̯
slang	s ə l a ŋ
sudra	s ʊ t . r a
arigol	a . r i . ɡ ɔ l
tobang	t o . b a ŋ
mutasi	m u . t a . s i
asistol	a . s ɪ s . t ɔ l
waria	w a . r i . j a
gampar	ɡ a m . p a r
kasuistik	k a s u ɪ s t ɪ k̚
memunculkan	m ə . m u n . t͡ʃ ʊ l . k a n
adenosina	a . d e . n o . s i . n a
dewana	d ɛ w a n a
aswa	a s . w a
gigit	ɡ ɪ . ɡ ɪ t̚
suvenir	s u v ə n ɪ r
aktivisme	a k̚ t i v ɪ s m ə
heptana	h e p . t a . n a
secang	s ə . t͡ʃ a ŋ
demografis	d e m o ɡ r a f ɪ s
pejamu	p ə . d͡ʒ a . m u
udah	u . d a h
kongruen	k ɔ n . ɡ r u . ɛ n
adiposa	a d i p o s a
isu	ɪ s u
giat	ɡ i a t̚
profesor	p r o f ɛ . s ɔ r
awelat	a . w e . l a t̚
pergelaran	p ə r . ɡ ə . l a r . a n
sengsai	s ɛ ŋ . s a i
cita	t͡ʃ i . t a
pengeluaran	p ə ŋ ə l u a r a n
jiwa	d͡ʒ i . w a
gabungan	ɡ a b ʊ ŋ a n
jenawi	d͡ʒ ə n a w i
mengencingi	m ə . ŋ e n . c i ŋ . i
albatros	a l . b a . t r ɔ s
ucul	u . t͡ʃ u l
ongkos	o ŋ . k o s
mukminin	m ʊ ʔ m i n ɪ n
angrem	a ŋ r ə m
membakar	m ə m . b a . k a r
desalinasi	d e . s a . l i . n a . s i
kapten	k a p̚ t ɛ n
basahan	b a s a h a n
defek	d e f ɛ k̚
antulawo	a n . t u . l a . w o
terbesar	t ə r b ə s a r
haus	h a . ʊ s
adikara	a d i . k a . r a
adimanusia	a . d i . m a . n u . s i . a
taring	t a . r ɪ ŋ
qasar	q a . s a r
onigiri	o . n i . ɡ i . r i
wortel	w o r . t ə l
pertambangan	p ə r t a m b a ŋ a n
anggas	a ŋ ɡ a s
Kristen	k r ɪ s . t ə n
kaki	k ä . k i
partus	p a r . t ʊ s
pemabuk	p ə m a b u k
go	ɡ o
pit	p ɪ t
kuna	k u n a
rindang	r ɪ n d a ŋ
PPDB	p e . p e . d e . b e
romantis	r o m a n t ɪ s
laku	l a k u
sagu	s a ɡ o
mencekokkan	m ə n . t͡ʃ ə . k o ʔ . k a n
khilafah	x i . l a . f a h
balobo	b a l o b o
nori	n o . r i
khizanatulkitab	x i z a n a t ʊ l k i t a p̚
transformasi	t r a n s . f ɔ r . m a . s i
daun	d a ʊ n
KPK	k a p e k a
negoisasi	n ɛ . ɡ o . s i . a . s i
anjar	a n d͡ʒ a r
Maroko	m a . r o . k o
menganggap	m ə ŋ a ŋ ɡ a p̚
gaga	ɡ a . ɡ a
heterogen	h e . t e . r o . ɡ ɛ n
parlementer	p a r l ə m ɛ n t ɛ r
coba	t͡ʃ o b a
membangun	m ə m b a ŋ u n
SHUN	ɛ s h a u ɛ n
babatan	b a . b a t . a n
mengubah	m ə ŋ u b a h
agen	a . ɡ ɛ n
aerasi	a e r a s i
persiapan	p ə r . s i . a p . a n
tepis	t ə . p ɪ s
anggal	a ŋ . ɡ a l
jadi	d ʒ a . d i
laksmana	l a k s . m a . n a
mencekoki	m ə ɲ . t͡ʃ ə . k o . k i
ampu	a m . p u
sambungan	s a m . b ʊ ŋ . a n
kedutaan	k ə d u t a a n
kanca	k ɔ n t͡ʃ ɔ
menyatakan	m ə ɲ a t a k a n
menyebar	m ə ɲ ə b a r
lapar	l a p a r
batara	b a . t a . r a
siang	s i . a ŋ
kami	k ä . m i
kemudahan	k ə m u d a h a n
datar	d a t a r
linear	l i n ɛ a r
lobak	l o . b a k
tersier	t ɛ r s i ɛ r
sampir	s a m p ɪ r
umur	u m ʊ r
rasional	r a s i o n a l
kolektivitas	k o l ɛ k t i v i t a s
Jateng	d͡ʒ a t ə ŋ
penguji	p ə ŋ . ʊ d͡ʒ i
menjaring	m ə n d͡ʒ a r i ŋ
praktik	p r a k̚ t ɪ k̚
sekresi	s ə k r e s i
moda	m o . d a
inferensi	ɪ n . f e . r ɛ n . s i
petahana	p ə t a h a n a
KY	k a j e
asyik	a . ʃ ɪ k
ꦱꦺꦴꦕ	s o t͡ʃ ɔ
pemacu	p ə . m a . t͡ʃ u
akidah	a k i d a h
memutakhirkan	m ə m u t a x i r k a n
biostatika	b i . o . s t a . t i . k a
mentol	m ɛ n . t ɔ l
memproklamasikan	m ə m p r o k l a m a s i k a n
benzol	b e n . z o l
bakero	b a k e r o
asbabulwurud	a s . b a . b ʊ l . w u . r ʊ t
pengecaman	p ə . ŋ ə . t͡ʃ a m . a n
peduli	p ə d u l i
gilik	ɡ i l ɪ k̚
binasa	b i . n a . s a
micin	m i . t͡ʃ i n
kalurahan	k a . l u . r a h . a n
pandemi	p a n d e m i
kabuki	k a b u k i
merk	m ɛ r k
angki	a ŋ k i
duren	d u . r ɛ n
sebar	s ə b a r
bentar	b ə n t a r
catat	t͡ʃ a t a t̚
luka	l u k a
Islandia	ɪ s l a n d i a̯
Indra	i n . d r a
antaladan	a n . t a . l a . d a n
julang	d͡ʒ u l a ŋ
gelut	ɡ ə . l ʊ t
samper	s a m p ə r
bandung	b a n . d ʊ ŋ
pertahanan	p ə r t a h a n a n
liyan	l i j a n
sein	s e ɪ̯ n
tanya	t a . ɲ a
teori	t e o r i
barid	b a r ɪ t̚
liana	l i a̯ n a
bendu	b ə n . d u
bungsut	b ʊ ŋ s ʊ t̚
akresi	a . k r e . s i
ate	a . t e
bineka	b i . n e . k a
kapal	k a . p a l
talian	t a l i a n
bungsu	b u ŋ s u
karna	k a r . n a
masakan	m a s a k̚ a n
lelangit	l ə . l ä . ŋ ɪ t̪̚
kolusi	k o l u s i
junta	d͡ʒ ʊ n . t a
intensi	i n t ɛ n s i
jagung	d͡ʒ a ɡ ʊ ŋ
perpaduan	p ə r p a d u a n
mengimbuh	m ə ŋ . i m . b u h
gang	ɡ a ŋ
swatantra	s ʋ a t a n t r a
lali	l a l i
tromol	t r o . m o l
kultivasi	k ʊ l t i v a s i
hiu	h i . u
tarekat	t a r ɛ k a t̚
aspal	a s . p a l
alkana	a l . k a . n a
membaca	m ə m b a t͡ʃ a
IPM	i p ɛ ɛ m
aloun	a . l o . ʊ n
Sulut	s u . l u t
serampang	s ə r a m p a ŋ
perbuatan	p ə r . b u . a . t a n
akar	a . k a r
pemeruman	p ə m ə r u m a n
tengok	t e . ŋ ɔ k
wilis	w i . l ɪ s
perembesan	p ə . r ə m . b ə s . a n
kotor	k o t o r
jijik	d͡ʒ i . d͡ʒ ɪ ʔ
pemandian	p ə m a n d i a n
tuai	t u a i̯
limas	l i m a s
tiram	t i r a m
baba	b a . b a
borang	b ɔ r a ŋ
ambil	a m b ɪ l
dukung	d u . k ʊ ŋ
tinjau	t i n d͡ʒ a u̯
canang	t͡ʃ a . n a ŋ
angkruk	a ŋ k r ʊ k̚
pernyataan	p ə r . ɲ a . t a . a n
onagata	o . n a . ɡ a . t a
arowon	a . r o . w ɔ n
keseruan	k ə s ə r u a n
magnitudo	m a k n i t u d o
angkatan	a ŋ k a t a n
senantiasa	s ə n a n t i a s a
nyaman	ɲ a m a n
menghadap	m ə ŋ . h a . d a p
ardi	a r . d i
abi	a b i
uap	ʊ a p̚
formatif	f ɔ r . m a . t ɪ f
mengemasi	m ə ɲ ə m a s i
cedera	t͡ʃ ə . d ə . r a
zikir	z i k ɪ r
rehabilitasi	r e h a b i l i t a s i
dipantau	d i p a n t a u̯
peria	p ə r i a̯
bagi	b a . ɡ i
menyanggah	m ə ɲ a ŋ ɡ a h
gilap	ɡ i l a p̚
andam	a n d a m
pedagogi	p e d a ɡ o ɡ i
kubak	k u b a ʔ
kecil	k ə t͡ʃ i l
ekstrapolasi	ɛ k s . t r a . p o . l a . s i
pengenalan	p ə ŋ ə n a l a n
lancia	l a n . t͡ʃ i a̯
menggarisbawahi	m ə ŋ . ɡ a . r i s . b a . w a h . i
penganjur	p ə ŋ a n d͡ʒ ʊ r
kontributor	k ɔ n . t r i . b u . t ɔ r
kuap	k u a p̚
berbeda	b ə r b ɛ d a
lurah	l u . r a h
kabupaten	k a . b u . p a . t e n
bushido	b u s . h i . d o
handschoen	h a n . s ə k ʊ n
nabatah	n a b a t a h
pola	p o l a
tanggapan	t a ŋ . ɡ a . p a n
buruk	b u r u k
insaf	i n . s a f
keparat	k ə . p a . r a t
patriarki	p a . t r i . a r . k i
tengar	t ə ŋ a r
toksik	t ɔ k . s ɪ k
japri	d͡ʒ a . p r i
frater	f r a t ə r
kemacetan	k ə m a t͡ʃ ə t a n
min	m ɪ n
produk	p r o . d ʊ k
siber	s i b ə r
permainan	p ə r m a i . n a n
Merkurius	m ɛ r . k u . r i . ʊ s
rekonsiliasi	r e . k ɔ n . s i . l i . a . s i
diperkokoh	d i p ə r k o k ɔ h
tapa	t a . p a
naskah	n a s . k a h
LPMP	ɛ l p e ɛ m p e
aborsi	a b ɔ r s i
cultuurstelsel	k ʊ l t ʊ r s t ɛ l s ə l
mengatakan	m ə ŋ a t a k a n
ritsleting	r i t . s l ə . t i ŋ
memilih	m ə . m i . l i h
nalar	n a l a r
jujitsu	d ʒ u . d ʒ ɪ t . s u
ketumbar	k ə t ʊ m b a r
memaafkan	m ə . m a . a f . k a n
mukbang	m ʊ k b ɑ ŋ
kayas	k a j a s
manset	m a n s ɛ t
bustan	b ʊ s t a n
pihak	p i h a ʔ
membangunkan	m ə m b a ŋ ʊ n k a n
monomer	m o n o m ɛ r
kehujanan	k ə h u d͡ʒ a n a n
sarden	s a r d ɛ n
berkembang	b ə r k ə m b a ŋ
asrok	a s . r ɔ k
adil	a . d i l
amporang	a m p o r a ŋ
pastor	p a s t o r
bersenandung	b ə r s ə n a n d ʊ ŋ
ransel	r a n . s ə l
perdana	p ə r d a n a
am	a m
pita	p i . t a
buku	b u k u
eksim	ɛ k . s ɪ m
sarana	s a . r a . n a
bulu	b u . l u
determinasi	d e . t ɛ r . m i . n a . s i
beban	b ə b a n
luak	l u a k̚
dolar	d o l a r
warkat	w a r . k a t
sembilan	s ə m . b i . l ä n
sentul	s ə n . t ʊ l
umat	u m a t̚
membuka	m ə m b u k a
umi	ʊ m i
anggana	a ŋ ɡ a n a
yuyitsu	j u . j i t . s u
menjijikkan	m ə n . d͡ʒ i . d͡ʒ ɪ ʔ . k a n
izin	ɪ z ɪ n
menyusun	m ə . ɲ u . s ʊ n
siluet	s i . l u . ɛ t
hibrida	h i b r i d a
kompetisi	k ɔ m p ə t i s i
calak	t͡ʃ a l a ʔ
sementara	s ə m ə n t a r a
sini	s i n i
seronok	s ə . r o . n ɔ ʔ
takoyaki	t a . k o . j a . k i
abras	a b . r a s
Februari	f ɛ b r u a r i
perabuan	p ə r a b u a n
manga	m a n ɡ a
darwis	d a r w ɪ s
rungu	r u . ŋ u
IPA	i . p a
landasan	l a n . d a . s a n
hitung	h i t ʊ ŋ
feodal	f e o d a l
kedaerahan	k ə . d a ɛ . r a h . a n
komet	k o . m ɛ t̚
alodna	a . l ɔ t . n a
mula	m u l a
bingar	b i ŋ a r
bunga	b u ŋ a
eutanasia	e u t a n a s i a
katedral	k a t ə d r a l
beton	b ə . t o n
alfuil	a l f u ɪ l
psikolog	p ə s i k o l ɔ k̚
gender	ɡ ɛ n d ə r
lepra	l ɛ p r a
apologi	a p o l o ɡ i
pialang	p ɪ j a l a ŋ
sadir	s a d ɪ r
kaliks	k a l ɪ k s
embrio	ɛ m b r i o
kaca	k a t͡ʃ a
alis	ʔ ä . l i s
geulis	ɡ ɘ . l ɪ s
kuy	k u j
aora	a . o . r a
memola	m ə m o l a
doa	d o a
bulbul	b ʊ l b ʊ l
persentil	p ə r . s ɛ n . t ɪ l
gemuk	ɡ ə m ʊ ʔ
adisi	a . d i . s i
pembohong	p ə m . b o . h o n ɡ
mahakuasa	m a h a k u a s a
ilah	ɪ l a h
perulangan	p ə r . ʊ l a ŋ . a n
agung	a ɡ ʊ ŋ
Tamil	t a m ɪ l
gusi	ɡ u . s i
esa	ə . s a
pokok	p o k ɔ k̚
biner	b i n ɛ r
makna	m a ʔ n a
aruris	a . r u . r ɪ s
pencucian	p ə n t͡ʃ u t͡ʃ iʲ a n
sami	s a m i
wanprestasi	w a n p r e s t a s i
kanji	k a n . d͡ʒ i
bagan	b a . ɡ a n
amput	a m p ʊ t̚
ajara	a d͡ʒ a r a
gugus	ɡ u ɡ ʊ s
buana	b u a̯ . n a
teladan	t ə l a d a n
Austria	a ʊ s t r i a
muluk	m u . l ʊ ʔ
kandungan	k a n d ʊ ŋ a n
ketombe	k ə t ɔ m b e
bawi	b a . w i
internasional	i n t ə r n a s i o n a l
iotasisme	i o t a s ɪ s m ə
dekan	d e k a n
