<|PUS|>آر	ɑ r
<|PUS|>آره	ɑ r a
<|PUS|>آسو	ɑ s u
<|PUS|>آيات	ɑ j ɑ t̪
<|PUS|>ابادول	a b ɑ d̪ a w ə l
<|PUS|>اتل	a t̪ ə l
<|PUS|>اتله	a t̪ ə l a
<|PUS|>اته	a t̪ ə
<|PUS|>اتيا	a t̪ j ɑ
<|PUS|>اتڼ	a t̪ a ɳ
<|PUS|>اخته	a x t̪ a
<|PUS|>اخلم	a x l ə m
<|PUS|>اخيستل	a x i s t ə l
<|PUS|>اخښل	a . ˈx ə l
<|PUS|>اخښی	ˈa x . ʂ a i
<|PUS|>ارزان	a r . z ɑ n
<|PUS|>ارزانه	a r z ɑ n a
<|PUS|>ارزښت	a r . z ə ʂ t̪
<|PUS|>ارمان	a r m ɑ n
<|PUS|>اري	a r i
<|PUS|>اس	a s
<|PUS|>استول	a s t a w ə l
<|PUS|>اسمان	a s m ɑ n
<|PUS|>اسماني	a s m ɑ n i
<|PUS|>اسټراليا	a s ʈ r ɑ l j ɑ
<|PUS|>اسپانيا	ɑ s p ɑ n j ɑ
<|PUS|>اسپه	a s p a
<|PUS|>اغزی	a ɣ z a i
<|PUS|>اغوندم	a ɣ u n d ə m
<|PUS|>اغږم	a ɣ a ʐ ə m
<|PUS|>افغانستان	a f ˈɣ ɑ n ˈɪ s ˈt ɑ n
<|PUS|>البند	i l ˈb a n d
<|PUS|>المانيا	a l m ɑ n j ɑ
<|PUS|>الوبالو	a l u b ɑ l u
<|PUS|>الوتل	a l w ə t ə l
<|PUS|>الوتکه	a l w a t̪ ə k a
<|PUS|>الوزم	a l w ə z ə m
<|PUS|>امريکا	a m r i k ɑ
<|PUS|>امريکايی	a m r i k ɑ j a ɪ
<|PUS|>املوک	a m l u k
<|PUS|>امېل	a ˈm e l
<|PUS|>انا	a n ɑ
<|PUS|>اند	a n d̪
<|PUS|>انځور	a n d͡z o r
<|PUS|>انځورګر	a n d͡z o r ɡ a r
<|PUS|>انګلستان	ɪ ŋ ɡ . l ɪ s . t̪ ɑ n
<|PUS|>انګوړی	a n ɡ o ɺ ˞ a i
<|PUS|>اهاړ	a h ɑ ɻ
<|PUS|>اهوړ	a ˈh u ɽ
<|PUS|>او	a w
<|PUS|>اوباسم	u b ɑ s ə m
<|PUS|>اوبه	o b ə
<|PUS|>اور	o r
<|PUS|>اورلوبه	o r l o b a
<|PUS|>اورم	a w r ə m
<|PUS|>اورول	a w r a w ə l
<|PUS|>اوريګامي	o r i ɡ ɑ m i
<|PUS|>اورګاډی	o r . ɡ ɑ . ɖ a ɪ
<|PUS|>اورېدل	a w r e d ə l
<|PUS|>اورېدونکی	a w r e d u n k a i
<|PUS|>اوسم	o s ə m
<|PUS|>اوسېدونکی	o s e d̪ u n k a ɪ
<|PUS|>اوسېدونکې	o s e d̪ u n k e
<|PUS|>اوش	o ʃ
<|PUS|>اوشه	o ʃ a
<|PUS|>اولس	u l ə s
<|PUS|>اوم	u m
<|PUS|>اومامي	u m ɑ m i
<|PUS|>اووه	u w ə
<|PUS|>اويم	o j ə m
<|PUS|>اوړم	a w ɺ ˞ ə m
<|PUS|>اوړی	o ɻ a ɪ
<|PUS|>اوږه	o ʐ a
<|PUS|>ايستل	i s t ə l
<|PUS|>ايسلنډ	a i s ˈl ə ŋ ɖ
<|PUS|>اينو	i n o
<|PUS|>اپريدی	a p r i d̪ a ɪ
<|PUS|>اپيم	a p i m
<|PUS|>اپين	a p i n
<|PUS|>اچول	a t͡ʃ a w ə l
<|PUS|>اړخ	a ɺ̢ x
<|PUS|>اګل	a ɡ a l
<|PUS|>اېخ	e x
<|PUS|>اېسټونيا	e s ʈ o n j ɑ
<|PUS|>اېموجي	e m o d͡ʒ i
<|PUS|>اېکوادور	e k w ɑ d o r
<|PUS|>بابا	b ɑ ˈb ɑ
<|PUS|>بادول	b ɑ d a w ə l
<|PUS|>باران	b ɑ ˈr ɑ n
<|PUS|>بارول	b ɑ r a w ə l
<|PUS|>بازو	b ɑ z u
<|PUS|>باغ	b ɑ ɣ
<|PUS|>باغوان	b ɑ ɣ w ɑ n
<|PUS|>بالښت	b ɑ ˈl ə ʂ t
<|PUS|>بام	b ɑ m
<|PUS|>باندې	b ɑ n d e
<|PUS|>بته	b ə t̪ a
<|PUS|>بخښل	b a ˈx ə l
<|PUS|>بخښنه	b a x . x ə . n a
<|PUS|>بد	b ə d
<|PUS|>بدرو	b a d̪ r u
<|PUS|>بدسترګی	b a d s t ə r ɡ a i
<|PUS|>بدلاری	b a d l ɑ r a i
<|PUS|>بدلېدل	b a d l e d ə l
<|PUS|>بدمخی	b ə d m ə x a i
<|PUS|>بده	b ə d a
<|PUS|>برابر	b a r ɑ ˈb a r
<|PUS|>برايي	b ə r ɑ j i
<|PUS|>بربنډ	b ə r b ə ŋ ɖ
<|PUS|>برتانيه	b a r t ɑ n j a
<|PUS|>برج	b r a d͡ʒ
<|PUS|>برجۍ	b ʊ r d͡ʒ ə i
<|PUS|>برطانيه	b a r t . ɑ n . j a
<|PUS|>برغټ	b ə r ɣ ə ʈ
<|PUS|>بريتانيا	b r i t ɑ n i ˈj ɑ
<|PUS|>برېت	b r e t̪
<|PUS|>بغری	b a ɣ a r a ɪ
<|PUS|>بغور	b ə ɣ w ə r
<|PUS|>بلا	b ə ˈl ɑ
<|PUS|>بلغارستان	b o l . ɣ ɑ . r ɪ s . t̪ ɑ n
<|PUS|>بلغاريا	b o l ɣ ɑ r ˈj ɑ
<|PUS|>بلغاريه	b u l ɣ ɑ r j a
<|PUS|>بلل	b a l ə l
<|PUS|>بن	b ə n
<|PUS|>بنج	b a n d͡ʒ
<|PUS|>بنده	b a n d̪ a
<|PUS|>بندي	b ə n d̪ i
<|PUS|>بنګېدل	b ə ŋ ɡ e d ə l
<|PUS|>به	b a
<|PUS|>بهېدل	b ə h e d ə l
<|PUS|>بهېږم	b a h e ɡ ə m
<|PUS|>بوخت	b o x t̪
<|PUS|>بوره	b u r a
<|PUS|>بوزېدل	b u z e d ə l
<|PUS|>بولم	b o l ə m
<|PUS|>بونا	b o n ɑ
<|PUS|>بوټان	b u ʈ ɑ n
<|PUS|>بوټپوهنه	b u ʈ p o h ə n a
<|PUS|>بوڼېدل	b u ɳ e d ə l
<|PUS|>بيا	b j ɑ
<|PUS|>بيايم	b j ɑ j ə m
<|PUS|>بيزو	b i z o
<|PUS|>بيول	b i w ə l
<|PUS|>بييی	b i j a ɪ
<|PUS|>بيژکۍ	b i ʒ a k ə i
<|PUS|>بڅرکی	b ə t͡s ə r k a ɪ
<|PUS|>بچ	b a t͡ʃ
<|PUS|>بډایه	b u ˈd aː . j a
<|PUS|>بړستن	b ɺ ˞ ə s t ə n
<|PUS|>بکاڼه	b a k ɑ ɳ a
<|PUS|>بڼ	b a ɳ
<|PUS|>بڼکی	b ə ɳ k a ɪ
<|PUS|>بې	b e
<|PUS|>بېخي	b e x i
<|PUS|>بېـ	b e
<|PUS|>بېل	b e l
<|PUS|>بېلتون	b e l t̪ u n
<|PUS|>بېلچه	b e l c h a
<|PUS|>بېړۍ	b e ɽ ə i
<|PUS|>تاسو	t ɑ s o
<|PUS|>تاسې	ˈt ɑ s e
<|PUS|>تانوکی	t̪ ɑ n u k a ɪ
<|PUS|>تانۀ	t̪ ɑ n ə
<|PUS|>تاو	t ɑ w
<|PUS|>تاوول	t ɑ w a w ə l
<|PUS|>تل	t æ l
<|PUS|>تلل	t̪ l ə l
<|PUS|>تنور	t̪ ə n u r
<|PUS|>ته	t a
<|PUS|>توت	t̪ u t̪
<|PUS|>تود	t̪ o d̪
<|PUS|>تودوخي	t ə w d u x i
<|PUS|>تويول	t o j a w ə l
<|PUS|>توپان	t̪ o p ɑ n
<|PUS|>تَپُوس	t a ˈp o s
<|PUS|>تڼۍ	t̪ a ɳ ə i
<|PUS|>تۀ	t ə
<|PUS|>تېروتل	t̪ e r w a t̪ ə l
<|PUS|>تېروتنه	t̪ e r w a t̪ ə n a
<|PUS|>تېرۀ	t̪ e r ə
<|PUS|>جلا	d ʒ ə l ɑ
<|PUS|>جنکۍ	d͡ʒ i n ə k ə i
<|PUS|>جنګول	d ʒ a ŋ ɡ a w ə l
<|PUS|>جنګيالی	d͡ʒ ə ŋ ɡ j ɑ l a i
<|PUS|>جنۍ	d ʒ i n ə i
<|PUS|>جوړ	d ʒ o ɻ
<|PUS|>جوړول	d͡ʒ o ɽ a w ə l
<|PUS|>جکړ	d͡ʒ a k a ɽ
<|PUS|>جګتيا	d͡ʒ ə ɡ t̪ j ɑ
<|PUS|>جګړن	d͡ʒ ə ɡ ɺ ˞ ə n
<|PUS|>جګړه	d͡ʒ ə ɡ ə ɺ ˞ a
<|PUS|>جګړول	d ʒ a ɡ ɺ ˞ a w ə l
<|PUS|>جې	d͡ʒ e
<|PUS|>جېبوتي	j e b u t̪ i
<|PUS|>خام	x ɑ m
<|PUS|>خت	x ə t̪
<|PUS|>ختل	x a t̪ ə l
<|PUS|>ختيځ	x a t̪ i d͡z
<|PUS|>خمچې	x ə m a t͡ʃ e
<|PUS|>خواشينی	x w ɑ ʃ i n a i
<|PUS|>خواږه	x w ɑ ʐ ə
<|PUS|>خور	x o r
<|PUS|>خوله	x w l ə
<|PUS|>خونه	ˈx u n a
<|PUS|>خوټه	x w ə ʈ a
<|PUS|>خوړنځی	x w ə ɻ ə n d͡z a ɪ
<|PUS|>خوږ	x o ʐ
<|PUS|>خيدک	x a i d ə k
<|PUS|>خيرن	x i r ə n
<|PUS|>خپرونه	x p a r a w ə n a
<|PUS|>خپسه	x ə p ə s a
<|PUS|>خپه	x ə p a
<|PUS|>خړ	x ə ɻ
<|PUS|>خېټه	x e ʈ a
<|PUS|>دا	d̪ ɑ
<|PUS|>دارو	d ɑ ˈr u
<|PUS|>داسې	d ɑ s e
<|PUS|>دانه	d ɑ n a
<|PUS|>دانګ	ɖ ɑ ŋ ɡ
<|PUS|>داړل	d ɑ ɺ ˞ ə l
<|PUS|>در	d a r
<|PUS|>درزي	d̪ a r z i
<|PUS|>درمل	d̪ a r m a l
<|PUS|>درملتون	d̪ ə r m ə l t̪ u n
<|PUS|>درملپوهنه	d̪ ə r m ə l p o h ə n a
<|PUS|>دروزه	d̪ r u z a
<|PUS|>دروستل	d ə r w ə s t̪ ə l
<|PUS|>دروغ	d̪ r o ɣ
<|PUS|>دروند	d̪ r u ŋ d̪
<|PUS|>درکول	d a r k a w ə l
<|PUS|>درېدل	d̪ r e d̪ ə l
<|PUS|>درېږم	d a ˈr e ɡ ə m
<|PUS|>دعوه	d̪ ɑ w a
<|PUS|>دوبی	d̪ o b a i
<|PUS|>دود	d̪ o d̪
<|PUS|>دونه	d̪ o n a
<|PUS|>دوه	d w a
<|PUS|>دوولس	d w o l a s
<|PUS|>دويم	d̪ w a i m
<|PUS|>ديارلس	d̪ j ɑ r l ə s
<|PUS|>دړد	d̪ ə ɺ ˞ d̪
<|PUS|>دی	d̪ a i
<|PUS|>دې	d̪ e
<|PUS|>دېو	d̪ e w
<|PUS|>دېګ	d̪ e ɡ
<|PUS|>دېګلی	d̪ e ɡ l a ɪ
<|PUS|>ذکر	z ɪ k ə r
<|PUS|>را	r ɑ
<|PUS|>راتلل	r ɑ t̪ l ə l
<|PUS|>راسې	r ɑ s e
<|PUS|>راهیسې	r ɑ h i s e
<|PUS|>راوستل	r ɑ w ə s t̪ ə l
<|PUS|>راولم	r ɑ w a l ə m
<|PUS|>راوړل	r ɑ w ɽ ə l
<|PUS|>راکول	r ɑ k a w ə l
<|PUS|>رحم	r a ˈh ə m
<|PUS|>رسنۍ	r ə s ə n a i
<|PUS|>رنډۍ	r ə n ɖ ə i̯
<|PUS|>روسيه	r u s j a
<|PUS|>روغتون	r o ɣ t̪ u n
<|PUS|>روغتيا	r o ɣ t j ɑ
<|PUS|>رول	r o l
<|PUS|>رڼا	r ə ˈɳ ɑ
<|PUS|>رېبز	r e b ə z
<|PUS|>زامبه	z ɑ m b a
<|PUS|>زاڼه	z ɑ ɳ a
<|PUS|>زباتل	z b ɑ t̪ ə l
<|PUS|>زبرځواک	z ə b ə r d͡z w ɑ k
<|PUS|>زبرګ	z b ə r ɡ
<|PUS|>زده	z d̪ a
<|PUS|>زر	z ə r
<|PUS|>زرغون	z ə r ɣ u n
<|PUS|>زغره	ˈz ɣ ə r a
<|PUS|>زغمل	z ɣ a m ə l
<|PUS|>زلیخا	z ʊ . l ə i . x a
<|PUS|>زما	z m ɑ
<|PUS|>زمری	z m a r a ɪ
<|PUS|>زمرۍ	z m a r ə i
<|PUS|>زمونږ	z ə m u n ɡ
<|PUS|>زموږ	z m u ʐ
<|PUS|>زوی	z o ɪ
<|PUS|>زڼکی	z ɘ ɳ k ɑ i
<|PUS|>زېږېدل	z e ˈʐ e ˈd ə l
<|PUS|>ساپټ	s ɑ ˈp a ʈ
<|PUS|>ساړه	s ɑ ɺ̢ ə
<|PUS|>ساک	s ɑ k
<|PUS|>ستا	s t̪ ɑ
<|PUS|>ستاسو	s t̪ ɑ s o
<|PUS|>ستاسې	s t ɑ s e
<|PUS|>ستر	s t ə r
<|PUS|>سترګه	s t̪ ə r ɡ a
<|PUS|>ستوری	s t̪ o r a ɪ
<|PUS|>سخی	s x a ɪ
<|PUS|>سره	s ə r a
<|PUS|>سرېښ	s r e x
<|PUS|>سل	s ə l
<|PUS|>سم	s ə m
<|PUS|>سمندر	s ə m ə n d̪ ə r
<|PUS|>سنډا	s a n ɖ ɑ
<|PUS|>سور	s u r
<|PUS|>سورلنډی	s u r l ə n ɖ a i
<|PUS|>سوماليا	s o m ɑ l j ɑ
<|PUS|>سومر	s u m ə r
<|PUS|>سوړ	s o ɻ
<|PUS|>سوی	s o j
<|PUS|>سوېل	s w e l
<|PUS|>سيلۍ	s i l ə i
<|PUS|>سيمه	s i m a
<|PUS|>سټک	s a ʈ a k
<|PUS|>سپرلی	s p ɑ r ˈl a i
<|PUS|>سپره	s p ə r a
<|PUS|>سپنج	s p ə ŋ d͡ʒ
<|PUS|>سپوږمۍ	s p o ʐ ˈm ə i
<|PUS|>سپين	s p i n
<|PUS|>سپک	s p a k
<|PUS|>سپی	s p a ɪ
<|PUS|>سپېلني	s p e . l a ˈn i
<|PUS|>سړه	s ə ɻ a
<|PUS|>سړی	s a ɺ̢ a ɪ
<|PUS|>سږى	s ə ˈ. ʐ a ɪ
<|PUS|>سکالو	s k ɑ l o
<|PUS|>سکه	s a k a
<|PUS|>سېلۍ	s e l ə i
<|PUS|>شالي	ʃ ɑ l i
<|PUS|>شاهد	ʃ ɑ ˈh e d
<|PUS|>شرم	ʃ a r a m
<|PUS|>شرمښ	ʃ ə r ˈm ə ʂ
<|PUS|>شروع	ʃ ʊː r ʊː
<|PUS|>شغال	ʃ a ˈɣ ɑ l
<|PUS|>شل	ʃ ə l
<|PUS|>شلتالو	ʃ a l t̪ ɑ l u
<|PUS|>شمېرپوهنه	ʃ m e r p o h ə n a
<|PUS|>شوتالو	ʃ a w t̪ ɑ l u
<|PUS|>شول	ʃ w ə l
<|PUS|>شوملې	ʃ u m . l e
<|PUS|>شومېر	ʃ u m e r
<|PUS|>شونی	ʃ o n a i
<|PUS|>شين	ʃ i n
<|PUS|>شيګره	ʃ i ɡ a r a
<|PUS|>شپاړس	ʃ p ɑ ɺ ˞ ə s
<|PUS|>شپږ	ʃ p a ɡ
<|PUS|>شپېته	ʃ p e t ə
<|PUS|>شډل	ʃ ə ɖ ə l
<|PUS|>طالب	t̪ ɑ l ɪ b
<|PUS|>غاښ	ɣ ɑ ʂ
<|PUS|>غبرګاوی	ɣ b a r ɡ ɑ w a i
<|PUS|>غر	ɣ a r
<|PUS|>غريز	ɣ a r ˈi z
<|PUS|>غرڅنی	ɣ a r t͡s ə n a i
<|PUS|>غل	ɣ a l
<|PUS|>غلا	ɣ l ɑ
<|PUS|>غلط	ɣ a . l a ˈt̪
<|PUS|>غمجن	ɣ a m d͡ʒ a n
<|PUS|>غندل	ɤ a n d̪ ə l
<|PUS|>غنم	ɣ a n ə m
<|PUS|>غوا	ɣ w ɑ
<|PUS|>غواړم	ɣ w ɑ ɺ̢ ə m
<|PUS|>غوبه	ɣ o b a
<|PUS|>غوره	ɣ w ə r a
<|PUS|>غورځنګ	ɣ o r ˈd͡z a ŋ ɡ
<|PUS|>غورځول	ɣ o r d͡z a w ə l
<|PUS|>غومبه	ɣ u m b a
<|PUS|>غونه	ɣ u n a
<|PUS|>غونډ	ɣ w ə ŋ ɖ
<|PUS|>غونډاری	ɣ w ə n . ɖ ɑ . r a i
<|PUS|>غوول	ɣ o w ə l
<|PUS|>غويی	ɣ w a j a ɪ
<|PUS|>غوړي	ɣ w a ɺ̢ i
<|PUS|>غوږ	ɣ w a ɡ
<|PUS|>غوښتل	ɣ u x ˈt ə l
<|PUS|>غوښه	ɣ w a ˈ. ʂ a
<|PUS|>غيم	ɣ ə j ə m
<|PUS|>غټ	ɣ a ʈ
<|PUS|>غپا	ɣ a p ɑ
<|PUS|>غپول	ɣ a p a w ə l
<|PUS|>غپېدل	ɣ a p e d ə l
<|PUS|>غړومبل	ɣ ɺ̢ u m b ə l
<|PUS|>غږېدل	ɣ a . ɡ e . d̪ ə l
<|PUS|>غښتل	ɣ ə ʂ ˈt̪ ə l
<|PUS|>غڼه	ɣ ə ɳ a
<|PUS|>غېږ	ɣ e ɡ
<|PUS|>ـتانۀ	t̪ ɑ n ə
<|PUS|>ـتون	t̪ u n
<|PUS|>ـغاړی	ɣ ɑ ɻ a i
<|PUS|>ـوړ	w ə ɻ
<|PUS|>ـځی	d͡z a i
<|PUS|>فرانس	f r ɑ ŋ s
<|PUS|>فرانسه	ɸ r . ɑ n . s a
<|PUS|>فردوس	f ɪ r ˈd̪ a w s
<|PUS|>قاموس	k ɑ m o s
<|PUS|>قصه	q ɪ s a
<|PUS|>قطر	ˈk a t ə r
<|PUS|>كاچوغه	k ɑ t͡ʃ o ɣ a
<|PUS|>كره	k a r a
<|PUS|>كوتره	k a w t̪ ə r a
<|PUS|>لار	l ɑ r
<|PUS|>لاريون	l ɑ r j u n
<|PUS|>لاس	l ɑ s
<|PUS|>لامبل	l ɑ m b ə l
<|PUS|>لامبو	l ɑ m b o
<|PUS|>لرغونپوهنه	l ə r ɣ u n p o h ə n a
<|PUS|>لرګی	l ə r ɡ a i
<|PUS|>لرې	l ə r e
<|PUS|>لس	l a s
<|PUS|>لشه	l a ʃ a
<|PUS|>لمر	l a m a r
<|PUS|>لمريز	l m a r i z
<|PUS|>لمسی	l m a s a i
<|PUS|>لمن	l a m ə n
<|PUS|>لوبول	l o b a w ə l
<|PUS|>لوبېدل	l o b e d ə l
<|PUS|>لور	l u r
<|PUS|>لوست	l w ə s t̪
<|PUS|>لوستل	l w ə s t̪ ə l
<|PUS|>لومبړ	l u m b a ɽ
<|PUS|>لومړی	l u m ɺ ˞ a i
<|PUS|>لوڅ	l u t͡s
<|PUS|>لوړ	l w a ɻ
<|PUS|>لوړل	l o ɽ ə l
<|PUS|>لوښي	l o ʃ i
<|PUS|>لوی	l o i
<|PUS|>لوېديځ	l o e d̪ i d͡z
<|PUS|>ليدل	l i d ə l
<|PUS|>لړه	l ə ɽ a
<|PUS|>لږ	l ə ɡ
<|PUS|>لېور	l e w a r
<|PUS|>لېونی	l e w a n a i
<|PUS|>لېوۀ	l e w ə
<|PUS|>مالک	m ɑ l ɪ k
<|PUS|>مالګه	m ɑ l ɡ a
<|PUS|>ماما	m ɑ m ɑ
<|PUS|>ماندې	ˈm ɑ n d e
<|PUS|>مانګر	m ɑ ŋ . ˈɡ ə r
<|PUS|>ماښام	m ɑ ˈx ɑ m
<|PUS|>ماڼو	m ɑ ɳ o
<|PUS|>ماڼۍ	m ɑ ɳ ə i
<|PUS|>مخوېينه	m ə x w e j ə n a
<|PUS|>مذهب	m a ˈz a b
<|PUS|>مرخېړی	m a r x e ɺ̢ a i
<|PUS|>مرستونی	m r a s t̪ u n a ɪ
<|PUS|>مرغ	m r a ɣ
<|PUS|>مرغه	m a r ˈɣ a
<|PUS|>مرغړی	m a r ɣ a ɺ̢ a i
<|PUS|>مرغۀ	m ə r . ɣ ə ˈ
<|PUS|>مرګ	m a r ɡ
<|PUS|>مزری	m z a r a ɪ
<|PUS|>مشرانوجرګه	m ə ʃ ə r ɑ n o d͡ʒ a r ɡ a
<|PUS|>معدن	m ɑ d̪ ə n
<|PUS|>مل	m a l
<|PUS|>ملګرې	m ə l ɡ ə r e
<|PUS|>مننه	m ə n ɘ n ə
<|PUS|>منو	m a n o
<|PUS|>مني	m a n i
<|PUS|>منټ	m ɪ n ə ʈ
<|PUS|>منځ	m a n d z
<|PUS|>منځنی	m ə n d͡z ə n ə i
<|PUS|>منډه	m ə n ɖ a
<|PUS|>منی	ˈm ə n a ɪ
<|PUS|>مور	m o r
<|PUS|>موسيقي	m u ˈs i ˈk i
<|PUS|>موندل	m u n d̪ ə l
<|PUS|>مونږ	m u n ɡ
<|PUS|>موټک	m u ʈ a k
<|PUS|>موږ	m u ʐ
<|PUS|>موږک	m u ʐ ə k
<|PUS|>مياشت	m j ɑ ʃ t̪
<|PUS|>ميليون	m i l j u n
<|PUS|>مينه	m i n a
<|PUS|>ميېر	m j e r
<|PUS|>مټ	m ə ʈ
<|PUS|>مټونګى	m ə ʈ u n ɡ a i
<|PUS|>مړه	m ə ɽ a
<|PUS|>مړۍ	m a ɺ̢ ə i̯
<|PUS|>مږه	m ə ɡ a
<|PUS|>مګر	m ə . ˈɡ ə r
<|PUS|>میاشت	m i ɑ ʃ t
<|PUS|>مې	ˈm e
<|PUS|>مېجی	m e ʒ a i
<|PUS|>مېخ	m e x
<|PUS|>مېشيکو	m e ʃ i k o
<|PUS|>مېشکوړ	m e ʃ k o ɻ
<|PUS|>مېلمه	m e l m a
<|PUS|>مېله	m e l a
<|PUS|>مېلوه	m e l a w a
<|PUS|>مېړګی	m e ɻ ɡ a i
<|PUS|>مېړۀ	m e ɻ ə
<|PUS|>نا	n ɑ
<|PUS|>نارنجي	n ɑ r ə n d͡ʒ i
<|PUS|>ناسم	n ɑ s ə m
<|PUS|>ناـ	n ɑ
<|PUS|>ناړولی	n ɑ ɻ a w ɘ l a i
<|PUS|>نجلۍ	n d ʒ ə l ə i
<|PUS|>نرکاشه	n ə r k ɑ ʃ a
<|PUS|>نزدې	n i z d e
<|PUS|>نس	n a s
<|PUS|>نسواري	n a s w ɑ r i
<|PUS|>نشت	n ə ʃ t̪
<|PUS|>نطفه	n ʊ t̪ ˈf a
<|PUS|>نمازديګر	n ə . m ɑ z . d̪ i . ɡ a r
<|PUS|>نماسخوتن	n ə . m ɑ s . x o . t a n
<|PUS|>نماسپېښين	n ə . m ɑ s . p e . ʂ i n
<|PUS|>نماښام	n ə . m ɑ ˈʂ ɑ m
<|PUS|>نمونځ	ⁿm u ŋ d͡z
<|PUS|>ننګ	n ə ŋ ɡ
<|PUS|>نه	n ə
<|PUS|>نو	n u
<|PUS|>نور	n w a r
<|PUS|>نولس	n u l a s
<|PUS|>نوملړ	n u m l a ɻ
<|PUS|>نوي	n a w i
<|PUS|>نوکغوڅی	n u k ɣ w ə t͡s a i
<|PUS|>نوی	n ə w a i
<|PUS|>نياو	n j ɑ w
<|PUS|>نيلي	n i l i
<|PUS|>نيمبو	n i m b u
<|PUS|>نيوکه	n i w ə k a
<|PUS|>نږدې	n i ɡ ˈd e
<|PUS|>نژدې	n i ʒ d e
<|PUS|>نښتر	n ə x ˈt̪ a r
<|PUS|>هدف	h a d ə f
<|PUS|>هسک	h a s k
<|PUS|>هغه	h a . ˈɣ ə
<|PUS|>هغې	h a . ˈɣ e
<|PUS|>هلته	h a l t a
<|PUS|>هلک	h a ˈl ə k
<|PUS|>هماليۀ	h ɪ m ɑ l ə j ə
<|PUS|>همېل	h a ˈm e l
<|PUS|>هو	h o
<|PUS|>هوښيار	h u x j ɑ r
<|PUS|>هيله	h i l a
<|PUS|>هڅه	h a t͡s a
<|PUS|>هګۍ	h ə ɡ ə i
<|PUS|>هېر	h e r
<|PUS|>هېلۍ	h e l ə i
<|PUS|>هېواد	h e w ɑ d̪
<|PUS|>وئ	w ə i
<|PUS|>واورتون	w ɑ w r a t̪ u n
<|PUS|>واوره	w ɑ ˈw r a
<|PUS|>واټ	w ɑ ʈ
<|PUS|>واک	w ɑ k
<|PUS|>وتل	w a t̪ ə l
<|PUS|>وخ	w a x
<|PUS|>ودان	w ə d̪ ɑ n
<|PUS|>ودانول	w a d ɑ n a w ə l
<|PUS|>ور	w a r
<|PUS|>ورشو	w a r ʃ o
<|PUS|>ورو	w r o ʊ
<|PUS|>وروستل	w a r w a s t ə l
<|PUS|>ورولم	w a r w a l ə m
<|PUS|>وريجې	w r i d͡ʒ e
<|PUS|>وريژې	w r i ʒ e
<|PUS|>ورځ	w r a d͡z
<|PUS|>ورکول	w a r k a w ə l
<|PUS|>وزير	w ə z i r
<|PUS|>وزیرستان	w ə z i r ɪ s t̪ ɑ n
<|PUS|>ولسوالي	w ə l ə s w ɑ l i
<|PUS|>ولسوالۍ	w ə l ə s w ɑ l ə i
<|PUS|>وله	w a l a
<|PUS|>وم	w ə m
<|PUS|>ونه	w ə n a
<|PUS|>ووړکی	w o ɺ̢ k a i
<|PUS|>ووړکۍ	w o ɺ̢ k ə i
<|PUS|>ووړی	w o ɺ ˞ a i
<|PUS|>ويده	w i d ə
<|PUS|>ويشتل	w i ʃ t ə l
<|PUS|>وينګ	w a j a ŋ ɡ
<|PUS|>ويه	w a j a
<|PUS|>وييونه	w i j u n a
<|PUS|>وييپانګه	w ə j i p ɑ ŋ ɡ a
<|PUS|>ويی	w ə j a i
<|PUS|>وټه	w ə ʈ a
<|PUS|>وړيا	w ə ɻ j ɑ
<|PUS|>وږی	w ə ɡ a i
<|PUS|>وګړواکي	w ə ɡ ə ɻ w ɑ k i
<|PUS|>وګړپوهنه	w ə ɡ ə ɻ p o h ə n a
<|PUS|>وګړی	w ə ɡ ə ɻ a i
<|PUS|>وېرول	w e r a w ə l
<|PUS|>وېرېدل	w e r e d ə l
<|PUS|>وېښتان	w e ʃ t̪ ɑ n
<|PUS|>ياد	j ɑː d
<|PUS|>يم	j ə m
<|PUS|>يهک	j h a k
<|PUS|>يو	j a w
<|PUS|>يوم	j u m
<|PUS|>يونی	y u n a i
<|PUS|>يوولس	j a w o l a s
<|PUS|>يې	j e
<|PUS|>ټاپو	ʈ ɑ p u
<|PUS|>ټبر	ʈ a b a r
<|PUS|>ټماټر	ʈ a m ɑ ʈ ə r
<|PUS|>ټنډه	ʈ ə n ɖ a
<|PUS|>ټوسپارۍ	ʈ u s p ɑ r ɘ y
<|PUS|>ټول	ʈ o l
<|PUS|>ټوپکی	ʈ u p a k a i
<|PUS|>ټوکر	ʈ u k ə r
<|PUS|>ټوکه	ʈ o k a
<|PUS|>ټوکي	ʈ o k i
<|PUS|>ټينګ	ʈ i ŋ ɡ
<|PUS|>ټپاکی	ʈ u p ɑ k a i
<|PUS|>ټکی	ˈʈ ə k a i
<|PUS|>پارسه	p ɑ r . s a
<|PUS|>پارسیوان	p ɑ r s i w ɑ n
<|PUS|>پامدور	p ɑ m a d̪ o r
<|PUS|>پايول	p ɑ y a w ə l
<|PUS|>پاړو	p ɑ ɻ u
<|PUS|>پاڼه	p ɑ ɳ a
<|PUS|>پت	p a t̪
<|PUS|>پتخه	p a t̪ ə x a
<|PUS|>پتنګ	p a t̪ a ŋ ɡ
<|PUS|>پخول	p a x a w ə l
<|PUS|>پرتله	p a r t̪ a l a
<|PUS|>پرتوګ	p a r t̪ u ɡ
<|PUS|>پروت	p r o t̪
<|PUS|>پروړه	p r o ˈɻ a
<|PUS|>پرېز	p a r e z
<|PUS|>پرېکړه	p r e k ɻ a
<|PUS|>پسرلی	p ə s ə r l a i
<|PUS|>پسه	p s ə
<|PUS|>پسې	p ə s e
<|PUS|>پشۍ	p ə ʃ ə i̯
<|PUS|>پلاز	p l ɑ z
<|PUS|>پلازمېنه	p l ɑ z m e n a
<|PUS|>پلاله	p l ɑ . l a
<|PUS|>پلم	p ɪ l m
<|PUS|>پلورل	p l o r ə l
<|PUS|>پمنکی	p a m a n k a ɪ
<|PUS|>پنځوس	p ə n d z o s
<|PUS|>پنځپوهنه	p ə ŋ d͡z p o h ə n a
<|PUS|>پنډوس	p ə n ɖ u s
<|PUS|>پوخ	p o ʊ x
<|PUS|>پوله	p u l a
<|PUS|>پوليس	p o l i s
<|PUS|>پوه	p o h
<|PUS|>پوهاند	p o h ɑ n d
<|PUS|>پوهنتون	p o . h a n ˈt̪ u n
<|PUS|>پوهنه	p o h ə n a
<|PUS|>پوهه	ˈp o h a
<|PUS|>پوهېدل	p o h e d ə l
<|PUS|>پوهېږي	p o ˈh e ɡ i
<|PUS|>پوڅه	p o t͡s a
<|PUS|>پوړۍ	p o ˈɻ ə i
<|PUS|>پوښتنه	p o x t̪ ə n a
<|PUS|>پيشو	p i ʃ o
<|PUS|>پيل	p a ɪ l
<|PUS|>پټکی	p a ʈ . k a i
<|PUS|>پړانګ	p ɽ ɑ ŋ ɡ
<|PUS|>پړسوب	p a ɻ s o b
<|PUS|>پړی	ˈp ə ɽ a i
<|PUS|>پښتنه	p a ʂ . t̪ a . n a
<|PUS|>پښتو	p ə ʂ ˈt̪ o
<|PUS|>پښتون	p a ʂ . t̪ u n
<|PUS|>پکان	p a k ɑ n
<|PUS|>پیل	p i l
<|PUS|>پې	p e
<|PUS|>پېرل	p e r ə l
<|PUS|>پېړۍ	p e ɻ ə i
<|PUS|>پېښور	p e ˈχ ə w ə r
<|PUS|>ځار	d͡z ɑ r
<|PUS|>ځان	d z ɑ n
<|PUS|>ځای	d͡z ɑ i
<|PUS|>ځغلم	d z ɣ ə l ə m
<|PUS|>ځغلول	d z ɣ ə l a w ə l
<|PUS|>ځل	d͡z ə l
<|PUS|>ځلمی	z ɘ l m ɑ i
<|PUS|>ځم	d z ə m
<|PUS|>ځمکپوهنه	d͡z m ə k p o h ə n a
<|PUS|>ځوان	d͡z w ɑ n
<|PUS|>ځواک	d͡z w ɑ k
<|PUS|>ځيرک	d͡z i r a k
<|PUS|>ځينې	ˈd z i n e
<|PUS|>ځکه	d͡z ə k a
<|PUS|>ځیږ	z i ʐ
<|PUS|>ځېل	d͡z e l
<|PUS|>څادر	t͡s ɑ d̪ a r
<|PUS|>څارونکى	t͡s ɑ r u n k a ɪ ɪ
<|PUS|>څاروى	t͡s ɑ r w a ɪ
<|PUS|>څاروی	t͡s ɑ r w a i
<|PUS|>څاوار	t͡s ɑ w ɑ r
<|PUS|>څاپېړه	t͡s ɑ p e ɽ a
<|PUS|>څاښکه	t͡s ɑ ˈx . k a
<|PUS|>څرخول	t s a r x a w ə l
<|PUS|>څلور	t͡s a . l o r
<|PUS|>څلوېښت	t s a l ˈw e ç t
<|PUS|>څنډه	t s ə n ɖ a
<|PUS|>څنګ	t s a n ɡ
<|PUS|>څنګل	t͡s ə ŋ ɡ ə l
<|PUS|>څه	t͡s ə
<|PUS|>څومره	t͡s u m r a
<|PUS|>څوک	t͡s o k
<|PUS|>څټک	t͡s a ʈ a k
<|PUS|>څپلۍ	t͡s a p l ə i
<|PUS|>څپېړه	t͡s a p e ɽ a
<|PUS|>څښاک	t͡s x ɑ k
<|PUS|>څکل	t s k a l
<|PUS|>څېره	t s e r a
<|PUS|>څېړنه	t͡s e ɻ ə n a
<|PUS|>چاينک	t͡ʃ ɑ i n ə k
<|PUS|>چاکلېټ	t͡ʃ ɑ ˈk l e ʈ
<|PUS|>چورلکه	t͡ʃ u r l ə k a
<|PUS|>چوپړ	t͡ʃ o p ə ɻ
<|PUS|>چوڼيا	t͡ʃ u ɳ j ɑ
<|PUS|>چيتر	t͡ʃ eː . ˈt ə r
<|PUS|>چيچل	t ʃ i t ʃ ə l
<|PUS|>چېرته	t͡ʃ e r t a
<|PUS|>چېري	t͡ʃ e r i
<|PUS|>ډانډ	ɖ ɑ ŋ ɖ
<|PUS|>ډاکو	ɖ ɑ k u
<|PUS|>ډله	ɖ a l a
<|PUS|>ډنډ	ɖ a n ɖ
<|PUS|>ډنګر	ɖ a ŋ ɡ ə r
<|PUS|>ډول	ɖ a w l
<|PUS|>ډولي	ɖ ə ʊ l i
<|PUS|>ډوډۍ	ɖ o ɖ ə i
<|PUS|>ډير	ɖ a i r
<|PUS|>ډک	ɖ a k
<|PUS|>ډېر	ɖ e r
<|PUS|>ړومبی	ɺ ˞ u m b a i
<|PUS|>ږغېدل	ʐ a ɣ e d ə l
<|PUS|>ږمنځ	ʐ m̩ ə ŋ d͡z
<|PUS|>ژباړل	ʒ b ɑ ɻ ə l
<|PUS|>ژبه	ʒ ə b ə
<|PUS|>ژبپوهنه	ʒ ə b p o h ə n a
<|PUS|>ژبکۍ	ʒ a b a k ə i
<|PUS|>ژرنده	ʒ r a n . d̪ a
<|PUS|>ژمی	ˈʒ ə m a ɪ
<|PUS|>ژور	ʒ a . w a ˈr
<|PUS|>ژوندينکه	ʒ w a n d̪ i n a k a
<|PUS|>ژوندی	ʒ w ə n d̪ a i
<|PUS|>ژوپوهنه	ʒ o p o h ə n a
<|PUS|>ژګاګ	ʒ ɪ ɡ ɑ ɡ
<|PUS|>ژېړ	ʒ e ɻ
<|PUS|>ښار	ʂ ɑ r
<|PUS|>ښارو	x ɑ . r o ˈ
<|PUS|>ښاغلی	ʂ ɑ ˈɣ ə ˈl a i
<|PUS|>ښامار	ʂ ɑ . m ɑ ˈr
<|PUS|>ښايي	x ɑ ˈy i
<|PUS|>ښایسته	ʂ ɑ j s t a
<|PUS|>ښه	x ə
<|PUS|>ښوونځی	ʂ o w ə n ˈd z a i
<|PUS|>ښوونکی	x o . ˈw u n . k a ɪ
<|PUS|>ښوونکې	x o ˈw u n ˈk e
<|PUS|>ښځه	ʂ ə ˈd͡z a
<|PUS|>ښځينه	x ə z i ˈn a
<|PUS|>ښکار	x k ɑ r
<|PUS|>ښکاره	x k ɑ ˈr a
<|PUS|>ښکلی	ʂ k w ə ˈl a i
<|PUS|>ښکنځل	x k ə n d͡z ə l
<|PUS|>ښۀ	x ə
<|PUS|>کارغه	k ɑ r ˈɣ ə
<|PUS|>کال	k ɑ l
<|PUS|>کالنی	k ɑ l a n a i
<|PUS|>کالي	k ɑ l i
<|PUS|>کاپيوره	k ɑ p i w a r a
<|PUS|>کاګل	k ɑ ɡ ə l
<|PUS|>کب	k a b
<|PUS|>کتاب	k ɪ t̪ . ɑ b
<|PUS|>کتل	k a t ə l
<|PUS|>کسم	k ə s ə m
<|PUS|>کله	ˈk ə l a
<|PUS|>کلک	k l a k
<|PUS|>کلکوالى	k l a k w ɑ l a ɪ
<|PUS|>کلی	k ə l a ɪ
<|PUS|>کندهار	k a n d̪ a h ɑ r
<|PUS|>کنګال	k a n ɡ ɑ l
<|PUS|>که	k ə
<|PUS|>کوبا	k u b ɑ
<|PUS|>کور	k o r
<|PUS|>کوربه	k o r b a
<|PUS|>کورنۍ	k o r a n ə i̯
<|PUS|>کوس	k w ə s
<|PUS|>کول	k a w ə l
<|PUS|>کونه	k w ə n a
<|PUS|>کونړ	k u n a ɻ
<|PUS|>کونګرى	k u n ɡ r a ɪ
<|PUS|>کوټ	k o ʈ
<|PUS|>کوټه	k o ʈ a
<|PUS|>کړ	k ə ɻ
<|PUS|>کښې	k ʂ e
<|PUS|>کینخي	k i . n a . x i
<|PUS|>کېدل	k e d ə l
<|PUS|>ګاڼه	ɡ ɑ ɳ a
<|PUS|>ګبين	ɡ a b i n
<|PUS|>ګرد	ɡ ə r d
<|PUS|>ګردی	ɡ ə r d̪ a i
<|PUS|>ګرمي	ɡ a r m i
<|PUS|>ګروه	ɡ r o h
<|PUS|>ګرځېدل	ɡ ə r d͡z e d̪ ə l
<|PUS|>ګل	ɡ w ə l
<|PUS|>ګلابي	ɡ w ə l ɑ b i
<|PUS|>ګنده	s x ɑ
<|PUS|>ګهيځ	ɡ ə h i d͡z
<|PUS|>ګودر	ɡ u d̪ a r
<|PUS|>ګورل	ɡ o r ə l
<|PUS|>ګيټۍ	ɡ i ʈ ə i
<|PUS|>ګټل	ɡ a ʈ ə l
<|PUS|>ګډون	ɡ a ɖ u n
<|PUS|>ګړدود	ɡ ə ɻ d̪ o d̪
<|PUS|>ګڼ	ɡ a ɳ
<|PUS|>ګڼل	ɡ a ɳ ə l
<|PUS|>ګېډه	ɡ e ɖ a
<|PER|>سوسمار	s uː s m ɒː r
<|PER|>توسی	t uː s iː
<|PER|>اسفند	e s f æ n d̪
<|PER|>مشکل	m u ʃ k i l
<|PER|>لایه	l ɒː j e
<|PER|>عجان	ʔ e d ʒ ɒː n
<|PER|>شوروی	ʃ uː ɾ æ v iː
<|PER|>خوشگل‌ترین	x o ʃ ɡ e l t æ ɾ iː n
<|PER|>مرمی	m a r m iː
<|PER|>تقصیر	t æ ɣ s iː ɾ
<|PER|>صدا	s æ d ɒː
<|PER|>مشق	m æ ʃ ɢ
<|PER|>تمبر	t æ m b ɾ
<|PER|>بنگ	b æ ŋ ɡ
<|PER|>درها	d æ ɾ h ɒː
<|PER|>گاز	ɡ ɒː z
<|PER|>المزده	æ l æ m z æ d e
<|PER|>افیون	ʔ æ f j uː n
<|PER|>بەت	b æː t
<|PER|>شلوغ‌تر	ʃ o l uː ɣ t æ ɾ
<|PER|>شیک	ʃ iː k
<|PER|>بال	b ɒː l
<|PER|>رحیم	r æ h iː m
<|PER|>اشرج	æ ʃ r æ d ʒ
<|PER|>حاد	h ɒː d
<|PER|>سپاهی	s e p ɒː h iː
<|PER|>لایه	l ɒː j e
<|PER|>شادمان	ʃ ɒː d m ɒː n
<|PER|>فسیل	f o s iː l
<|PER|>گسترده	ɡ o s t æ ɾ d e
<|PER|>گاب	ɡ ɒː b
<|PER|>شمال	ʃ o m ɒː l
<|PER|>آرامی	ɒː ɾ ɒː m iː
<|PER|>درزی	d æ ɾ z iː
<|PER|>لثه	l a s e
<|PER|>پسی	p o s eː
<|PER|>آدم‌ها	ɒː d æ m h ɒː
<|PER|>می‌گم	m iː ɡ æ m
<|PER|>ویژگی‌ها	v iː ʒ e ɡ iː h ɒː
<|PER|>ذاتی	z ɒː t iː
<|PER|>فانوس	f ɒː n uː s
<|PER|>گز	ɡ æ z
<|PER|>نیرومند	n iː ɾ uː m æ n d̪
<|PER|>کنسرت	k o n s e ɾ t
<|PER|>دودل	d o d e l
<|PER|>شروع	ʃ o r uː ʔ
<|PER|>ناو	n ɒː w
<|PER|>نومد	n o w m a d
<|PER|>گیتا	ɡ iː t ɒː
<|PER|>بیمارترین	b iː m ɒː ɾ t æ ɾ iː n
<|PER|>چاشت	t ʃʰ ɒː ʃ tʰ
<|PER|>ترسایی	t æ ɾ s ɒː j iː
<|PER|>وای	v ɒː j
<|PER|>هجران	h i d͡ʒ ɾ ɒː n
<|PER|>رختن	r e x t æ n
<|PER|>فیلیپ	f i l i p
<|PER|>پارسه	p ɒː ɾ s e
<|PER|>انگیختن	æ ŋ ɡ iː x t æ n
<|PER|>مجرد	m o d͡ʒ æ ɾ ɾ æ d
<|PER|>ابری‌سازی	ʔ æ b ɾ iː s ɒː z iː
<|PER|>تاریک‌ترین	t ɒː ɾ iː k t æ ɾ iː n
<|PER|>خاص‌ترین	x ɒː s tʰ æ ɾ iː n
<|PER|>پیرتر	p iː ɾ t æ ɾ
<|PER|>بریدن	b o ɾ iː d æ n
<|PER|>توزیع	tʰ o ʊ̯ z iː ʔ
<|PER|>مرداد	m o ɾ d̪ ɒː d̪
<|PER|>سرای	s æ ɾ ɒː j
<|PER|>زیست‌شناسی	z iː s t ʃ e n ɒː s iː
<|PER|>ونوس	v e n uː s
<|PER|>خواستار	x ɒː s t̪ ɒː ɾ
<|PER|>سریدن	s o ɾ iː d æ n
<|PER|>فک	f æ k
<|PER|>بختر	b e x t æ ɾ
<|PER|>اهواز	æ h w ɒː z
<|PER|>شمال	ʃ o m ɒː l
<|PER|>شکستنی	ʃ i k æ s t̪ æ n iː
<|PER|>نعوظ	n o ʔ uː z
<|PER|>مختل	m o x t æ l
<|PER|>بزاق	b o z ɒː ɣ
<|PER|>گاری	ɡ ɒː ɾ iː
<|PER|>تقریبا	t æ ɣ ɾ iː b æ n
<|PER|>ژکفر	ʒ æ k f æ ɾ
<|PER|>کتی	k a t iː
<|PER|>آشتی	ɒː ʃ t iː
<|PER|>سنگ	s æ ŋ ɡ
<|PER|>ویژگی‌ها	v iː ʒ e ɡ iː h ɒː
<|PER|>رختن	r e x t æ n
<|PER|>پشیمان	p æ ʃ iː m ɒː n
<|PER|>هی	h e j
<|PER|>شاذ	ʃ ɒː z
<|PER|>شکلاتی	ʃ o kʰ o l ɒ tʰ i
<|PER|>قایق	ɢ ɒː j e ɣ
<|PER|>کهکشان‌ها	k æ h k æ ʃ ɒː n h ɒː
<|PER|>عام‌المنفعه	ʔ ɒː m o l m æ n f æ ʔ e
<|PER|>شاخه	ʃ ɒː x e
<|PER|>بدرود	b e d ɾ uː d
<|PER|>زال	z ɒː l
<|PER|>وای	v ɒː j
<|PER|>زرناپا	z u r n ɒː p ɒː
<|PER|>بیمارترین	b iː m ɒː ɾ t æ ɾ iː n
<|PER|>مجازات‌ها	m o d ʒ ɒː z ɒː t h ɒː
<|PER|>یاساق	j ɒː s ɒː q
<|PER|>رستوران	r e s t o ɾ ɒː n
<|PER|>اراده	e ɾ ɒː d e
<|PER|>پیرترین	p iː ɾ t æ ɾ iː n
<|PER|>قرغیزستان	q ɪ ɾ ɣ iː z ɪ s t ɒː n
<|PER|>سپاهی	s e p ɒː h iː
<|PER|>عجیب‌ترین	æ d ʒ iː b t æ ɾ iː n
<|PER|>جعفر	d͡ʒ æ ʔ f æ r
<|PER|>شلوغ‌ترین	ʃ o l uː ɣ t æ ɾ iː n
<|PER|>عباسی	ʔ æ b b ɒː s iː
<|PER|>نر	n æ ɾ
<|PER|>نزدیک‌تر	n æ z d iː k t æ ɾ
<|PER|>باروت	b ɒː ɾ uː t
<|PER|>شکلاتی	ʃ o kʰ o l ɒ tʰ i
<|PER|>گره	ɡ e r e h
<|PER|>میلادی	m iː l ɒː d iː
<|PER|>کرفس	k æ ɾ æ f s
<|PER|>قبض	ɢ æ b z
<|PER|>بالغ	b ɒː l e ɣ
<|PER|>شاهزادگان	ʃ ɒː h z ɒː d e ɡ ɒː n
<|PER|>خاویار	x ɒː v i j ɒː ɾ
<|PER|>لبی	l æ b iː
<|PER|>میخی	m iː x iː
<|PER|>شاپور	ʃ ɒː p uː ɾ
<|PER|>شدنی	ʃ o d æ n iː
<|PER|>باریک	b ɒː ɾ iː k
<|PER|>کارورزی	k ɒː ɾ v æ ɾ z iː
<|PER|>سیلاس	s iː l ɒː s
<|PER|>ابری	ʔ æ b ɾ iː
<|PER|>داد	d ɒː d
<|PER|>قاسم	ɢ ɒː s e m
<|PER|>یاب	j ɒː b
<|PER|>عجیب‌ترین	æ d ʒ iː b t æ ɾ iː n
<|PER|>مشکل‌ها	m o ʃ k e l h ɒː
<|PER|>کوچک‌تر	k uː t ʃ e k t æ ɾ
<|PER|>ترسایی	t æ ɾ s ɒː j iː
<|PER|>فک	f æ k
<|PER|>مصون	m æ s uː n
<|PER|>داد	d ɒː d
<|PER|>گزاف‌ترین	ɡ æ z ɒː f t æ ɾ iː n
<|PER|>خیم	x iː m
<|PER|>کتی	k a t iː
<|PER|>پوده	p uː d æ
<|PER|>نمایندگان	n æ m ɒː j æ n d e ɡ ɒː n
<|PER|>خوشنویسی	x o ʃ n e v iː s iː
<|PER|>بایست	b ɒː j e s t
<|PER|>با	b ɒː
<|PER|>بژ	b e ʒ
<|PER|>اولی	æ v v æ l iː
<|PER|>تهرون	t e h ɾ uː n
<|PER|>دفتر	d æ f t æ r
<|PER|>ستون	s ʊ t uː n
<|PER|>کفتر	k e f t æ ɾ
<|PER|>ضربان	z æ ɾ æ b ɒː n
<|PER|>کرفس	k æ ɾ æ f s
<|PER|>دنیدن	d æ n iː d æ n
<|PER|>بال	b ɒː l
<|PER|>چپ	t ʃ æ p
<|PER|>چاشنی	t ʃʰ ɒː ʃ n iː
<|PER|>چوکی	t ʃ a w k iː
<|PER|>اشرج	æ ʃ r æ d ʒ
<|PER|>بنگ	b æ ŋ ɡ
<|PER|>غرق	ɣ æ ɾ ɣ
<|PER|>توسی	t uː s iː
<|PER|>آش	ʔ ɒː ʃ
<|PER|>مد	m o d
<|PER|>جام	d͡ʒ ɒː m
<|PER|>عاصی	ʔ ɒː s iː
<|PER|>چلوکباب	t͡ʃ e l o w k a b ɒː b
<|PER|>هندی	h e n d iː
<|PER|>سیاه‌گوش	s i j ɒː h ɡ oː ʃ
<|PER|>کرایه	k i ɾ ɒː j æ
<|PER|>یلدا	j a l d ɒ
<|PER|>پیادگان	p iː j ɒː d e ɡ ɒː n
<|PER|>یاساء	j ɒː s ɒː ʔ
<|PER|>دیسک	d iː s k
<|PER|>وزغ	v æ z æ ɣ
<|PER|>آخ	ɒː χ
<|PER|>معجزه	m o ʔ d͡ʒ e z e
<|PER|>باریک‌تر	b ɒː ɾ iː k t æ ɾ
<|PER|>زیویدن	z iː v iː d æ n
<|PER|>بالغ	b ɒː l e ɣ
<|PER|>تنبان	t o m b ɒ n
<|PER|>سامانه‌ها	s ɒː m ɒː n e h ɒː
<|PER|>مسلمون	m o s æ l m uː n
<|PER|>یی	j iː
<|PER|>پلاستیک	p e l ɒː s t iː k
<|PER|>هفته‌ها	h æ f t e h ɒː
<|PER|>کون	kʰ u n
<|PER|>مرداد	m o ɾ d̪ ɒː d̪
<|PER|>پناهندگان	p æ n ɒː h æ n d e ɡ ɒː n
<|PER|>رخ	r o x
<|PER|>ترکیدن	t æ ɾ æ kʲ iː d æ n
<|PER|>بوران	b uː ɾ ɒ n
<|PER|>آئورت	ɒː ʔ o ɾ t
<|PER|>دیسک	d iː s k
<|PER|>نجس‌ترین	n æ d ʒ æ s t æ ɾ iː n
<|PER|>اولی	æ v v æ l iː
<|PER|>اتمام	e t m ɒː m
<|PER|>قشنگی	q æ ʃ æ n ɡ iː
<|PER|>ویستا	v i s t ɒ
<|PER|>معجزه	m o ʔ d͡ʒ e z e
<|PER|>طاس	t ɒː s
<|PER|>باریک	b ɒː ɾ iː k
<|PER|>عاصی	ʔ ɒː s iː
<|PER|>ناوخدا	n ɒː v x o d ɒː
<|PER|>پیرترین	p iː ɾ t æ ɾ iː n
<|PER|>بلگ	b æ l ɡ
<|PER|>اهریمن	ʔ æ h ɾ iː m æ n
<|PER|>بایستی	b ɒː j æ s t iː
<|PER|>بژ	b e ʒ
<|PER|>خاویار	x ɒː v i j ɒː ɾ
<|PER|>خرم	x o ɾː æ m
<|PER|>شلوغ‌تر	ʃ o l uː ɣ t æ ɾ
<|PER|>امضاء	e m z ɒː
<|PER|>تنیدن	t æ n iː d æ n
<|PER|>روادید	r æ v ɒː d̪ iː d̪
<|PER|>موی	m uː j
<|PER|>بم	b ə m
<|PER|>روادید	r æ v ɒː d̪ iː d̪
<|PER|>گراز	ɡ o ɾ ɒː z
<|PER|>نجس‌ترین	n æ d ʒ æ s t æ ɾ iː n
<|PER|>غمگینی	ɢ æ m ɡ iː n iː
<|PER|>سیستم	s iː s tʰ e m
<|PER|>موافق	m o v ɒː f e ɣ
<|PER|>مشکل‌ترین	m o ʃ k e l t æ ɾ iː n
<|PER|>کوتاه‌ترین	k uː t ɒː h t æ ɾ iː n
<|PER|>فائده	f ɒː ʔ e d e
<|PER|>یراق	j æ ɾ ɒː ɣ
<|PER|>برنامه	b æ ɾ n ɒː m æ
<|PER|>آسیاب	ɒː s i j ɒː b
<|PER|>حافظ	h ɒː f e z
<|PER|>عضوها	o z v h ɒ
<|PER|>شپش	ʃ e p e ʃ
<|PER|>هامون	h ɒː m uː n
<|PER|>نژادها	n e ʒ ɒː d h ɒː
<|PER|>اراده	e ɾ ɒː d e
<|PER|>درخت	d æ ɾ æ x t
<|PER|>تکفور	t æ k f uː ɾ
<|PER|>شیرین‌تر	ʃ iː ɾ iː n t æ ɾ
<|PER|>شلوغ‌ترین	ʃ o l uː ɣ t æ ɾ iː n
<|PER|>کنکور	k o ŋ k uː r
<|PER|>آرامی	ɒː ɾ ɒː m iː
<|PER|>بد	b æ d
<|PER|>سرندیپ	s a r a n d iː p
<|PER|>باریک‌تر	b ɒː ɾ iː k t æ ɾ
<|PER|>نشلیدن	n e ʃ e l iː d æ n
<|PER|>بایست	b ɒː j e s t
<|PER|>نسرین	n æ s ɾ iː n
<|PER|>نعناع	n æ ʔ n ɒː ʔ
<|PER|>سیلو	s i l u
<|PER|>بر	b æ ɾ
<|PER|>ضخیم	z æ x iː m
<|PER|>لحظه	l æ h z æ
<|PER|>صورتی	s uː ɾ æ tʰ iː
<|PER|>شدنی	ʃ o d æ n iː
<|PER|>شوروی	ʃ uː ɾ æ v iː
<|PER|>خشکوندن	x o ʃ k uː n d æ n
<|PER|>خزاعی	x æ z ɒː ʔ iː
<|PER|>خو	x o
<|PER|>المزده	æ l æ m z æ d e
<|PER|>عباء	a b ɒː
<|PER|>مربا	m o r æ b b ɑ
<|PER|>کمو	k æ m uː
<|PER|>سرندیپ	s a r a n d iː p
<|PER|>تاریک‌تر	t ɒː ɾ iː k t æ ɾ
<|PER|>ژوپیتر	ʒ u p i t e ɾ
<|PER|>گوساله	ɡ uː s ɒː l e
<|PER|>هوتن	h uː t æ n
<|PER|>شپش	ʃ e p e ʃ
<|PER|>کنکور	k o ŋ k uː r
<|PER|>اشتر	ʔ o ʃ t o ɾ
<|PER|>باجی	b ɒː d ʒ iː
<|PER|>ترکیدن	t æ ɾ æ kʲ iː d æ n
<|PER|>بازیچه	b ɒː z iː t ʃʰ e
<|PER|>کفتر	k e f t æ ɾ
<|PER|>نیازها	n iː j ɒː z h ɒː
<|PER|>تنیسور	t e n iː s o ɾ
<|PER|>عقرب	ʔ æ ɣ ɾ æ b
<|PER|>پلاک	p e l ɒː k
<|PER|>سالار	s ɒː l ɒː ɾ
<|PER|>لبخند	l æ b x æ n d
<|PER|>کنفرانس	k o n f e ɾ ɒː n s
<|PER|>خونه	x oː n æ
<|PER|>مختل	m o x t æ l
<|PER|>سالن	s ɒː l o n
<|PER|>سلیمانی	s o l e j m ɒː n iː
<|PER|>نیرومند	n iː ɾ uː m æ n d̪
<|PER|>علف	ʔ æ l æ f
<|PER|>برنامه	b æ ɾ n ɒː m æ
<|PER|>آبان	ɒː b ɒː n
<|PER|>تنیسور	t e n iː s o ɾ
<|PER|>زیباترین	z iː b ɒː t æ ɾ iː n
<|PER|>ایام	ʔ æ j j ɒː m
<|PER|>تعلیم	t æ ʔ l i m
<|PER|>آکندن	ʔ ɒː k æ n d æ n
<|PER|>گراز	ɡ o ɾ ɒː z
<|PER|>صورتی	s uː ɾ æ tʰ iː
<|PER|>روحانی	r o ʊ h ɒː n iː
<|PER|>سالن	s ɒː l o n
<|PER|>سریدن	s o ɾ iː d æ n
<|PER|>اندی	æ n d eː
<|PER|>شجر	ʃ æ d ʒ æ r
<|PER|>پاپوش	p ɒː p oː ʃ
<|PER|>سیستم	s iː s tʰ e m
<|PER|>رستوران‌ها	r e s t o ɾ ɒː n h ɒː
<|PER|>نیازها	n iː j ɒː z h ɒː
<|PER|>آبلیمو	ɒː b l iː m uː
<|PER|>ژولیدن	ʒ uː l iː d æ n
<|PER|>شکستنی	ʃ i k æ s t̪ æ n iː
<|PER|>آشوب‌ها	ɒː ʃ uː b h ɒː
<|PER|>مایه	m ɒː j æ
<|PER|>پوزخند	p uː z x æ n d
<|PER|>جام	d͡ʒ ɒː m
<|PER|>اهواز	æ h w ɒː z
<|PER|>دنیدن	d æ n iː d æ n
<|PER|>روحانی	r o ʊ h ɒː n iː
<|PER|>مریضی	m æ ɾ iː z iː
<|PER|>شلوغ	ʃ o l uː ɣ
<|PER|>همچنان	h æ m t ʃ o n ɒː n ~ h æ m t ʃ e n ɒː n
<|PER|>تقریبا	t æ ɣ ɾ iː b æ n
<|PER|>زیباتر	z iː b ɒː t æ ɾ
<|PER|>مک	m æ k
<|PER|>بارود	b ɒː ɾ uː d
<|PER|>دلسوز	d̪ i l s oː z
<|PER|>امین	æ m iː n
<|PER|>بازیچه	b ɒː z iː t ʃʰ e
<|PER|>غرق	ɣ æ ɾ ɣ
<|PER|>قربک	q o ɾ b æ k
<|PER|>خاص‌ترین	x ɒː s tʰ æ ɾ iː n
<|PER|>بامزه	b ɒː m æ z e
<|PER|>بسنده	b æ s æ n d e
<|PER|>ستون	s ʊ t uː n
<|PER|>صلح	s u l h
<|PER|>نوک	n v æ k
<|PER|>صدا	s æ d ɒː
<|PER|>کفش	k æ f ʃ
<|PER|>حاد	h ɒː d
<|PER|>منشی	m u n ʃ iː
<|PER|>اندی	æ n d eː
<|PER|>بفرمایید	b e f æ ɾ m ɒː j iː d
<|PER|>کنگره	k o n ɡ r e
<|PER|>بفرمایید	b e f æ ɾ m ɒː j iː d
<|PER|>نزدیک‌ترین	n æ z d iː k t æ ɾ iː n
<|PER|>فغفور	f æ ɣ f uː ɾ
<|PER|>شات	ʃ ɒː t
<|PER|>طاس	t ɒː s
<|PER|>ضربان	z æ ɾ æ b ɒː n
<|PER|>خوشنویسی	x o ʃ n e v iː s iː
<|PER|>مین	m iː n
<|PER|>خزندگان	x æ z æ n d e ɡ ɒː n
<|PER|>مشکل	m u ʃ k i l
<|PER|>ابرش	æ b ɾ æ ʃ
<|PER|>تمیزترین	t æ m iː z t æ ɾ iː n
<|PER|>بر	b æ ɾ
<|PER|>آسیا	ɒː s ɪ j ɒː
<|PER|>میخی	m iː x iː
<|PER|>تغییرات	t æ ɣ j iː ɾ ɒː t
<|PER|>برخی	b æ r x iː
<|PER|>دارو	d ɒː ɾ uː
<|PER|>بالاخره	b e l æ x æ ɾ e
<|PER|>تغییرات	t æ ɣ j iː ɾ ɒː t
<|PER|>سردار	s æ ɾ d ɒː ɾ
<|PER|>همسده	h æ m s e d æ
<|PER|>خندون	x æ n d uː n
<|PER|>نیوشا	n i j oː ʃ ɒː
<|PER|>پشمین	p æ ʃ m iː n
<|PER|>مامانی	m ɒː m ɒː n iː
<|PER|>مقداد	m e ɣ d ɒː d
<|PER|>شلوغ	ʃ o l uː ɣ
<|PER|>مشکل‌ترین	m o ʃ k e l t æ ɾ iː n
<|PER|>آزردن	ɒː z o ɾ d æ n
<|PER|>مشق	m æ ʃ ɢ
<|PER|>تمبر	t æ m b ɾ
<|PER|>خندون	x æ n d uː n
<|PER|>ژرف‌تر	ʒ æ ɾ f t æ ɾ
<|PER|>جعفر	d͡ʒ æ ʔ f æ r
<|PER|>تندیس	t æ n d iː s
<|PER|>کالیفرنیا	k ɒː l iː f o r n i j ɒː
<|PER|>قشنگی	q æ ʃ æ n ɡ iː
<|PER|>مادیان	m ɒː d i i̯ ɒː n
<|PER|>شاهان	ʃ ɒː h ɒː n
<|PER|>هامون	h ɒː m uː n
<|PER|>سینا	s iː n ɒː
<|PER|>برخی	b æ r x iː
<|PER|>گاراژ	ɡ ɒː ɾ ɒː ʒ
<|PER|>عضوها	o z v h ɒ
<|PER|>مادیان	m ɒː d i i̯ ɒː n
<|PER|>ایرانیان	iː ɾ ɒː n i j ɒː n
<|PER|>کاروان	k ɒː ɾ w ɒː n
<|PER|>پوهنتون	p oː h a n t uː n
<|PER|>لبی	l æ b iː
<|PER|>استراتژی	ɛ s t ɾ ɒː t ɛ ʒ iː
<|PER|>آبان	ɒː b ɒː n
<|PER|>گزاف‌تر	ɡ æ z ɒː f t æ ɾ
<|PER|>مجازات	m o d ʒ ɒː z ɒː t
<|PER|>بالاخره	b e l æ x æ ɾ e
<|PER|>ناز	n ɒː z
<|PER|>اوکی	o kʰ e j
<|PER|>میلادی	m iː l ɒː d iː
<|PER|>جعفری	d͡ʒ æ ʔ f æ ɾ iː
<|PER|>واژه‌نامه	v ɒː ʒ e n ɒː m e
<|PER|>شهرزاد	ʃ æ h ɾ z ɒː d
<|PER|>لبخند	l æ b x æ n d
<|PER|>هنی	h æ n iː
<|PER|>حافظ	h ɒː f e z
<|PER|>لی	l iː
<|PER|>آخر	ɒː x æ ɾ
<|PER|>نعناع	n æ ʔ n ɒː ʔ
<|PER|>انبار	ʔ æ m b ɒː ɾ
<|PER|>الماس‌ها	æ l m ɒː s h ɒː
<|PER|>آئورت	ɒː ʔ o ɾ t
<|PER|>هرتز	h e ɾ t z
<|PER|>شروع	ʃ o r uː ʔ
<|PER|>برزیستن	b a r z iː s t æ n
<|PER|>قفسه	ɢ æ f æ s e
<|PER|>ابری‌سازی	ʔ æ b ɾ iː s ɒː z iː
<|PER|>کوچک‌تر	k uː t ʃ e k t æ ɾ
<|PER|>ستاره‌شناس	s e t ɒː ɾ e ʃ e n ɒː s
<|PER|>مدهوش	m æ d h u ʃ
<|PER|>اورشلیم	ʔ o ɾ ʃ æ l iː m
<|PER|>بون	b uː n
<|PER|>کاغذها	k ɒː ɣ æ z h ɒː
<|PER|>شاهزادگان	ʃ ɒː h z ɒː d e ɡ ɒː n
<|PER|>شاذ	ʃ ɒː z
<|PER|>دلسوز	d̪ i l s oː z
<|PER|>سالار	s ɒː l ɒː ɾ
<|PER|>آزردن	ɒː z o ɾ d æ n
<|PER|>کالیفرنیا	k ɒː l iː f o r n i j ɒː
<|PER|>گنم	ɡ e n o m
<|PER|>ادیان	æ d j ɒː n
<|PER|>استیون	e s t iː v e n
<|PER|>ساده‌تر	s ɒː d e t æ ɾ
<|PER|>تمیزترین	t æ m iː z t æ ɾ iː n
<|PER|>نیزه	n e i̯ z e
<|PER|>چاشنی	t ʃʰ ɒː ʃ n iː
<|PER|>نماینده	n æ m ɒː j æ n d e
<|PER|>حق	h a q q
<|PER|>زیست‌شناسی	z iː s t ʃ e n ɒː s iː
<|PER|>خوشگل‌ترین	x o ʃ ɡ e l t æ ɾ iː n
<|PER|>لزوماً	l o z uː m æ n
<|PER|>انجمن	ʔ æ n d͡ʒ o m æ n
<|PER|>یاور	j ɒː v æ ɾ
<|PER|>فرآیند	f æ ɾ ɒː j æ n d
<|PER|>مله	m æ l æ
<|PER|>پوده	p uː d æ
<|PER|>برگ	b æ ɾ ɡ
<|PER|>جگر	d ʒ e ɡ æ ɾ
<|PER|>گیتا	ɡ iː t ɒː
<|PER|>شیرین‌تر	ʃ iː ɾ iː n t æ ɾ
<|PER|>کرایه	k i ɾ ɒː j æ
<|PER|>کلپ	k l æ p
<|PER|>بهبود	b e h b uː d
<|PER|>شاخه	ʃ ɒː x e
<|PER|>آشتی	ɒː ʃ t iː
<|PER|>بوران	b uː ɾ ɒ n
<|PER|>پشتون	p æ ʃ t uː n
<|PER|>باحال‌تر	b ɒː h ɒː l t æ ɾ
<|PER|>ژوپیتر	ʒ u p i t e ɾ
<|PER|>شاخ	ʃ ɒ x
<|PER|>دادار	d ɒː d ɒː r
<|PER|>نمایندگان	n æ m ɒː j æ n d e ɡ ɒː n
<|PER|>پسی	p o s eː
<|PER|>یی	j iː
<|PER|>آکندن	ʔ ɒː k æ n d æ n
<|PER|>خندان	x æ n d ɒ n
<|PER|>کفش	k æ f ʃ
<|PER|>کارواژه‌ها	k ɒː r v ɒː ʒ e h ɒː
<|PER|>هندوانه	h e n d e v ɒː n e
<|PER|>زیرزمین	z iː ɾ z æ m iː n
<|PER|>سریانی	s o ɾ j ɒː n iː
<|PER|>نومد	n o w m a d
<|PER|>شاداب	ʃ ɒː d ɒː b
<|PER|>توزیع	tʰ o ʊ̯ z iː ʔ
<|PER|>گوساله	ɡ uː s ɒː l e
<|PER|>کنعان	k æ n ʔ ɒː n
<|PER|>همسده	h æ m s e d æ
<|PER|>زیرسیگاری	z iː ɾ s iː ɡ ɒː ɾ iː
<|PER|>فامیل	f ɒː m iː l
<|PER|>زیست‌شناس	z iː s t ʃ e n ɒː s
<|PER|>استراتژی	ɛ s t ɾ ɒː t ɛ ʒ iː
<|PER|>ثابت	s ɒː b e tʰ
<|PER|>عجیب‌تر	æ d ʒ iː b t æ ɾ
<|PER|>بزاق	b o z ɒː ɣ
<|PER|>نشلیدن	n e ʃ e l iː d æ n
<|PER|>تازه‌ترین	t ɒː z e t æ ɾ iː n
<|PER|>سیاه‌گوش	s i j ɒː h ɡ oː ʃ
<|PER|>مله	m æ l æ
<|PER|>موافق	m o v ɒː f e ɣ
<|PER|>امیدیار	ʔ o m iː d y ɒː ɾ
<|PER|>ژاندرم	ʒ ɒː n d æ r m
<|PER|>کله	k æ l l æ
<|PER|>کودکان	k uː d æ k ɒː n
<|PER|>نالون	n ɒː l uː n
<|PER|>فائده	f ɒː ʔ e d e
<|PER|>کنعان	k æ n ʔ ɒː n
<|PER|>زرشکی	z e ɾ e ʃ k iː
<|PER|>نریمان	n æ ɾ eː m ɒː n
<|PER|>هنی	h æ n iː
<|PER|>آمیزش	ɒː m iː z e ʃ
<|PER|>خرم	x o ɾː æ m
<|PER|>خزنده	x æ z æ n d e
<|PER|>اتمام	e t m ɒː m
<|PER|>مد	m o d
<|PER|>شکستن	ʃ e kʲ æ s t̪ʰ æ n
<|PER|>گاری	ɡ ɒː ɾ iː
<|PER|>قاسم	ɢ ɒː s e m
<|PER|>هندوانه	h e n d e v ɒː n e
<|PER|>سرداب	s æ ɾ d ɑː b
<|PER|>زیباتر	z iː b ɒː t æ ɾ
<|PER|>واژگان	v ɒː ʒ e ɡ ɒː n
<|PER|>دپارتمان	d e p ɒ r tʰ e m ɒ n
<|PER|>گاز	ɡ ɒː z
<|PER|>مشکل‌ها	m o ʃ k e l h ɒː
<|PER|>فامیل	f ɒː m iː l
<|PER|>کاروان	k ɒː ɾ w ɒː n
<|PER|>سلیمانی	s o l e j m ɒː n iː
<|PER|>مجرد	m o d͡ʒ æ ɾ ɾ æ d
<|PER|>تاریک‌ترین	t ɒː ɾ iː k t æ ɾ iː n
<|PER|>خرداد	x o ɾ d̪ ɒː d̪
<|PER|>بارود	b ɒː ɾ uː d
<|PER|>زیویدن	z iː v iː d æ n
<|PER|>مایه	m ɒː j æ
<|PER|>عمو	a m u
<|PER|>فسیل	f o s iː l
<|PER|>قربک	q o ɾ b æ k
<|PER|>جواب‌ها	d ʒ æ v ɒː b h ɒː
<|PER|>وزغ	v æ z æ ɣ
<|PER|>نمایه	n æ m ɒː j e
<|PER|>مامانی	m ɒː m ɒː n iː
<|PER|>اسفناج	e s f e n ɒː d͡ʒ
<|PER|>اصلی	æ s l iː
<|PER|>لی	l iː
<|PER|>نغز	n æ ɣ z
<|PER|>کارواژگان	k ɒː r v ɒː ʒ e ɡ ɒː n
<|PER|>شهرزاد	ʃ æ h ɾ z ɒː d
<|PER|>چلوکباب	t͡ʃ e l o w k a b ɒː b
<|PER|>نعوظ	n o ʔ uː z
<|PER|>باغات	b ɒː ɣ ɒː t̪
<|PER|>درودن	d o ɾ uː d æ n
<|PER|>غژب	ɢ o ʒ b
<|PER|>خشکوندن	x o ʃ k uː n d æ n
<|PER|>آمیزش	ɒː m iː z e ʃ
<|PER|>تلویحی	t æ l v iː h iː
<|PER|>نیزه	n e i̯ z e
<|PER|>سیلاس	s iː l ɒː s
<|PER|>هلو	h o l uː
<|PER|>درزی	d æ ɾ z iː
<|PER|>کله	k æ l l æ
<|PER|>ماشین	m ɒː ʃ iː n
<|PER|>کنسرت	k o n s e ɾ t
<|PER|>مسلمون	m o s æ l m uː n
<|PER|>وزیدن	v æ z iː d æ n
<|PER|>خزندگان	x æ z æ n d e ɡ ɒː n
<|PER|>شاهان	ʃ ɒː h ɒː n
<|PER|>گزاف‌ترین	ɡ æ z ɒː f t æ ɾ iː n
<|PER|>مغرور	m æ ɣ ɾ uː ɾ
<|PER|>تنبان	t o m b ɒ n
<|PER|>دروغ‌ها	d o ɾ uː ɣ h ɒː
<|PER|>سیلو	s i l u
<|PER|>قید	ɢ e j d
<|PER|>ایرانیان	iː ɾ ɒː n i j ɒː n
<|PER|>درگاه	d æ ɾ ɡ ɒː h
<|PER|>مک	m æ k
<|PER|>هجران	h i d͡ʒ ɾ ɒː n
<|PER|>عجان	ʔ e d ʒ ɒː n
<|PER|>ژاندرم	ʒ ɒː n d æ r m
<|PER|>ونوس	v e n uː s
<|PER|>رحیم	r æ h iː m
<|PER|>ویه	uː j e
<|PER|>باغ‌ها	b ɒː ɣ h ɒː
<|PER|>نغز	n æ ɣ z
<|PER|>بدرود	b e d ɾ uː d
<|PER|>خیس	x iː s
<|PER|>درودن	d o ɾ uː d æ n
<|PER|>بلور	b ɪ l oː ɾ
<|PER|>انگلیس	ʔ e ŋ ɡʲ e l iː s
<|PER|>خیم	x iː m
<|PER|>فاک	f ɒː k
<|PER|>آدم‌ها	ɒː d æ m h ɒː
<|PER|>زال	z ɒː l
<|PER|>اورشلیم	ʔ o ɾ ʃ æ l iː m
<|PER|>جواب‌ها	d ʒ æ v ɒː b h ɒː
<|PER|>خندان	x æ n d ɒ n
<|PER|>تکفور	t æ k f uː ɾ
<|PER|>تعلیم	t æ ʔ l i m
<|PER|>افشردن	æ f ʃ o ɾ d æ n
<|PER|>کنفرانس	k o n f e ɾ ɒː n s
<|PER|>استیون	e s t iː v e n
<|PER|>حقوق	h o q u q
<|PER|>هرکس	h æ r k æ s
<|PER|>امین‌ها	æ m iː n h ɒː
<|PER|>کمو	k æ m uː
<|PER|>شاداب	ʃ ɒː d ɒː b
<|PER|>مجازات‌ها	m o d ʒ ɒː z ɒː t h ɒː
<|PER|>ساده‌ترین	s ɒː d e t æ ɾ iː n
<|PER|>فاک	f ɒː k
<|PER|>شجر	ʃ æ d ʒ æ r
<|PER|>کهر	k æ h æ ɾ
<|PER|>حق	h a q q
<|PER|>مقداد	m e ɣ d ɒː d
<|PER|>خونه	x oː n æ
<|PER|>بابک	b ɒː b æ k
<|PER|>نالان	n ɒː l ɒː n
<|PER|>مرغان	m o ɾ ɣ ɒː n
<|PER|>یلدا	j a l d ɒ
<|PER|>فراموشیدن	f æ ɾ ɒː m uː ʃ iː d̪ æ n
<|PER|>شیمی	ʃ iː m iː
<|PER|>یزدان	j æ z d ɒː n
<|PER|>گاب	ɡ ɒː b
<|PER|>مشکی	m e ʃ kʰ iː
<|PER|>ختنه	x æ tʰ n e
<|PER|>نزدیک‌ترین	n æ z d iː k t æ ɾ iː n
<|PER|>بامزه	b ɒː m æ z e
<|PER|>پوهنتون	p oː h a n t uː n
<|PER|>مارس	m ɒː ɾ s
<|PER|>امین‌ها	æ m iː n h ɒː
<|PER|>دیسک‌ها	d iː s k h ɒː
<|PER|>عقرب	ʔ æ ɣ ɾ æ b
<|PER|>غمگینی	ɢ æ m ɡ iː n iː
<|PER|>شاخ	ʃ ɒ x
<|PER|>ساده‌تر	s ɒː d e t æ ɾ
<|PER|>یاساء	j ɒː s ɒː ʔ
<|PER|>گز	ɡ æ z
<|PER|>مصون	m æ s uː n
<|PER|>شاپور	ʃ ɒː p uː ɾ
<|PER|>خزاعی	x æ z ɒː ʔ iː
<|PER|>خاص	x ɒː s
<|PER|>گنم	ɡ e n o m
<|PER|>بلاگ	b l ɒː ɡ
<|PER|>ستاره‌شناس	s e t ɒː ɾ e ʃ e n ɒː s
<|PER|>پیرتر	p iː ɾ t æ ɾ
<|PER|>خوانندگان	x ɒː n æ n d e ɡ ɒː n
<|PER|>شات	ʃ ɒː t
<|PER|>انجمن	ʔ æ n d͡ʒ o m æ n
<|PER|>واژه‌ها	v ɒː ʒ e h ɒː
<|PER|>موی	m uː j
<|PER|>خواستار	x ɒː s t̪ ɒː ɾ
<|PER|>نالون	n ɒː l uː n
<|PER|>مدهوش	m æ d h u ʃ
<|PER|>انرژی	æ n æ ɾ ʒ iː
<|PER|>بلور	b ɪ l oː ɾ
<|PER|>علف	ʔ æ l æ f
<|PER|>سه	s e
<|PER|>برنز	b o ɾ o n z
<|PER|>برنز	b o ɾ o n z
<|PER|>ناوخدا	n ɒː v x o d ɒː
<|PER|>فراموشیدن	f æ ɾ ɒː m uː ʃ iː d̪ æ n
<|PER|>شعب	ʃ o ʔ æ b
<|PER|>کارواژه‌ها	k ɒː r v ɒː ʒ e h ɒː
<|PER|>بلاگ	b l ɒː ɡ
<|PER|>خو	x o
<|PER|>جعفری	d͡ʒ æ ʔ f æ ɾ iː
<|PER|>زبان‌ها	z æ b ɒː n h ɒː
<|PER|>درگاه	d æ ɾ ɡ ɒː h
<|PER|>خوانندگان	x ɒː n æ n d e ɡ ɒː n
<|PER|>شادمان	ʃ ɒː d m ɒː n
<|PER|>سوخته	s uː x t e
<|PER|>مغرور	m æ ɣ ɾ uː ɾ
<|PER|>شپش‌ها	ʃ e p e ʃ h ɒː
<|PER|>پیادگان	p iː j ɒː d e ɡ ɒː n
<|PER|>داغ	d ɒː ɣ
<|PER|>زیرزمین	z iː ɾ z æ m iː n
<|PER|>آدرس	ɒː d ɾ e s
<|PER|>سریانی	s o ɾ j ɒː n iː
<|PER|>قاقم	ɢ ɑː ɢ o m
<|PER|>ژم	ʒ æ m
<|PER|>دادار	d ɒː d ɒː r
<|PER|>پوزخند	p uː z x æ n d
<|PER|>انگیختن	æ ŋ ɡ iː x t æ n
<|PER|>باروت	b ɒː ɾ uː t
<|PER|>آش	ʔ ɒː ʃ
<|PER|>حقوق	h o q u q
<|PER|>سرداب	s æ ɾ d ɑː b
<|PER|>خرداد	x o ɾ d̪ ɒː d̪
<|PER|>افیون	ʔ æ f j uː n
<|PER|>کارورزی	k ɒː ɾ v æ ɾ z iː
<|PER|>عباء	a b ɒː
<|PER|>برزیستن	b a r z iː s t æ n
<|PER|>سرای	s æ ɾ ɒː j
<|PER|>سامانه‌ها	s ɒː m ɒː n e h ɒː
<|PER|>نسرین	n æ s ɾ iː n
<|PER|>مسعود	m æ s ʔ uː d
<|PER|>کارواژگان	k ɒː r v ɒː ʒ e ɡ ɒː n
<|PER|>باحال‌تر	b ɒː h ɒː l t æ ɾ
<|PER|>خزنده	x æ z æ n d e
<|PER|>شهریور	ʃ æ h ɾ iː v æ ɾ
<|PER|>ثابت	s ɒː b e tʰ
<|PER|>زرشک	z e ɾ e ʃ k
<|PER|>مربا	m o r æ b b ɑ
<|PER|>سینا	s iː n ɒː
<|PER|>یاور	j ɒː v æ ɾ
<|PER|>نالان	n ɒː l ɒː n
<|PER|>فرآیند	f æ ɾ ɒː j æ n d
<|PER|>زرشک	z e ɾ e ʃ k
<|PER|>الموت	ʔ æ l æ m uː t
<|PER|>ویستا	v i s t ɒ
<|PER|>سال	s ɒː l
<|PER|>انعکاس	e n ʔ e k ɒː s
<|PER|>بلعیدن	b æ l ʔ iː d æ n
<|PER|>دیسک‌ها	d iː s k h ɒː
<|PER|>بد	b æ d
<|PER|>گزاف‌تر	ɡ æ z ɒː f t æ ɾ
<|PER|>کلپ	k l æ p
<|PER|>چوپ	t͡ʃ oː p
<|PER|>هفته‌ها	h æ f t e h ɒː
<|PER|>خیس	x iː s
<|PER|>پاپوش	p ɒː p oː ʃ
<|PER|>سه	s e
<|PER|>زیرسیگاری	z iː ɾ s iː ɡ ɒː ɾ iː
<|PER|>نزدیک‌تر	n æ z d iː k t æ ɾ
<|PER|>عمو	a m u
<|PER|>امضاء	e m z ɒː
<|PER|>پلاک	p e l ɒː k
<|PER|>پشمین	p æ ʃ m iː n
<|PER|>قفسه	ɢ æ f æ s e
<|PER|>بابک	b ɒː b æ k
<|PER|>قید	ɢ e j d
<|PER|>دپارتمان	d e p ɒ r tʰ e m ɒ n
<|PER|>قزاق	q æ z z ɒː q
<|PER|>کنگره	k o n ɡ r e
<|PER|>ساده‌ترین	s ɒː d e t æ ɾ iː n
<|PER|>گیک	ɡ iː k
<|PER|>شهریور	ʃ æ h ɾ iː v æ ɾ
<|PER|>پشیمان	p æ ʃ iː m ɒː n
<|PER|>بایستی	b ɒː j æ s t iː
<|PER|>باغ‌ها	b ɒː ɣ h ɒː
<|PER|>ادیان	æ d j ɒː n
<|PER|>کودکان	k uː d æ k ɒː n
<|PER|>انگلیس	ʔ e ŋ ɡʲ e l iː s
<|PER|>عجیب‌تر	æ d ʒ iː b t æ ɾ
<|PER|>آشوب‌ها	ɒː ʃ uː b h ɒː
<|PER|>کاغذها	k ɒː ɣ æ z h ɒː
<|PER|>انعکاس	e n ʔ e k ɒː s
<|PER|>واژه‌ها	v ɒː ʒ e h ɒː
<|PER|>ابری	ʔ æ b ɾ iː
<|PER|>گسترده	ɡ o s t æ ɾ d e
<|PER|>آسیاب	ɒː s i j ɒː b
<|PER|>بریدن	b o ɾ iː d æ n
<|PER|>واژه‌نامه	v ɒː ʒ e n ɒː m e
<|PER|>خاص	x ɒː s
<|PER|>صحنه	s æ h n e
<|PER|>سوخته	s uː x t e
<|PER|>فلاخن	f æ l ɒː x æ n
<|PER|>باریک‌ترین	b ɒː ɾ iː k t æ ɾ iː n
<|PER|>سوسمار	s uː s m ɒː r
<|PER|>آخ	ɒː χ
<|PER|>افشردن	æ f ʃ o ɾ d æ n
<|PER|>هرکس	h æ r k æ s
<|PER|>ژرف‌تر	ʒ æ ɾ f t æ ɾ
<|PER|>کفاش	k æ f f ɒ ʃ
<|PER|>انبار	ʔ æ m b ɒː ɾ
<|PER|>باریک‌ترین	b ɒː ɾ iː k t æ ɾ iː n
<|PER|>پارسه	p ɒː ɾ s e
<|PER|>نیوشا	n i j oː ʃ ɒː
<|PER|>فانوس	f ɒː n uː s
<|PER|>آخر	ɒː x æ ɾ
<|PER|>کینه	k iː n e
<|PER|>تازه‌ترین	t ɒː z e t æ ɾ iː n
<|PER|>کهر	k æ h æ ɾ
<|PER|>سال	s ɒː l
<|PER|>شپش‌ها	ʃ e p e ʃ h ɒː
<|PER|>اگرچه	æ ɡ æ ɾ t ʃ e
<|PER|>ژم	ʒ æ m
<|PER|>نوک	n v æ k
<|PER|>اشتر	ʔ o ʃ t o ɾ
<|PER|>پشتون	p æ ʃ t uː n
<|PER|>گرزمان	ɡ æ ɾ æ z m ɒː n
<|PER|>غژب	ɢ o ʒ b
<|PER|>بم	b ə m
<|PER|>پلاستیک	p e l ɒː s t iː k
<|PER|>درخت	d æ ɾ æ x t
<|PER|>همچنان	h æ m t ʃ o n ɒː n ~ h æ m t ʃ e n ɒː n
<|PER|>ختنه	x æ tʰ n e
<|PER|>ضخیم	z æ x iː m
<|PER|>قایق	ɢ ɒː j e ɣ
<|PER|>فلاخن	f æ l ɒː x æ n
<|PER|>با	b ɒː
<|PER|>تلویحی	t æ l v iː h iː
<|PER|>زبان‌ها	z æ b ɒː n h ɒː
<|PER|>گرزمان	ɡ æ ɾ æ z m ɒː n
<|PER|>هی	h e j
<|PER|>باجی	b ɒː d ʒ iː
<|PER|>امیدیار	ʔ o m iː d y ɒː ɾ
<|PER|>کهکشان‌ها	k æ h k æ ʃ ɒː n h ɒː
<|PER|>عباسی	ʔ æ b b ɒː s iː
<|PER|>جگر	d ʒ e ɡ æ ɾ
<|PER|>بختر	b e x t æ ɾ
<|PER|>شعب	ʃ o ʔ æ b
<|PER|>کوتاه‌ترین	k uː t ɒː h t æ ɾ iː n
<|PER|>شیمی	ʃ iː m iː
<|PER|>مریضی	m æ ɾ iː z iː
<|PER|>ویه	uː j e
<|PER|>قبض	ɢ æ b z
<|PER|>نمایه	n æ m ɒː j e
<|PER|>باغات	b ɒː ɣ ɒː t̪
<|PER|>بلگ	b æ l ɡ
<|PER|>مارس	m ɒː ɾ s
<|PER|>یزدان	j æ z d ɒː n
<|URD|>رائےدہندگان	ɽ a: ɪ d ə ɦ ə n d ɡ a: n
<|URD|>جدیدترین	d͡ʒ a d iː d t a r iː n
<|URD|>رامو	ɽ a: m ʊ
<|URD|>اتوار	ɪ t ʋ a: ɽ
<|URD|>منہ	m ʊ ɦ
<|URD|>خسارہ	x ɪ s a: ɽ a: ɦ
<|URD|>مشروب	m a ʃ r uː b
<|URD|>ارب	ə ɽ ə b
<|URD|>غیرمستحکم	ɣ ɪ r m ʊ s t ɦ a k a m
<|URD|>ابھشیک	ə bʰ ɪ ʂ eː k
<|URD|>رنگولی	ɽ ə ŋ ɡ oː l iː
<|URD|>آکاش	a: k a: ʃ
<|URD|>ہمسفر	ɦ ə m s ə f ə ɽ
<|URD|>حقارت	ɦ ʊ q a: ɽ ə t
<|URD|>مسئلہ	m ə s l a:
<|URD|>اسٹائسٹکس	ɪ s ʈ a: ɪ s ʈ k s
<|URD|>بالے	b a: l eː
<|URD|>گرنا	ɡ ɪ ɽ n a:
<|URD|>فلاحی	f l a: ɦ iː
<|URD|>تمھیں	t ʊ m e:
<|URD|>سکو	s k uː
<|URD|>سفر	s ə f ə ɽ
<|URD|>رویئہ	ɽ ə ʋ ə i a:
<|URD|>لوتھ	l oː tʰ
<|URD|>میزان	m iː z a: n
<|URD|>نافذ	n a: f ɪ z
<|URD|>پار	p a: ɽ
<|URD|>اودبلاؤ	uː d b ɪ l a: oː
<|URD|>باشندہ	b a: ʃ ɪ n d a:
<|URD|>راجو	ɽ a: d͡ʒ oː
<|URD|>جامعہ	d͡ʒ a: m ɪ ʔ a:
<|URD|>پالیسی	p a: l iː s iː
<|URD|>کارگزاری	k a: r ɡ ʊ z a: r iː
<|URD|>سمیع	s ə m iː a
<|URD|>سنگھ	s ɪ ŋ ɡʰ
<|URD|>اردو	ʊ ɽ d uː
<|URD|>ریمارک	r eɪ m a: r k
<|URD|>پرکاش	p ɽ ə k a: ʃ
<|URD|>صفرواں	s ɪ f ə ɽ ʋ a:
<|URD|>ملازم	m ʊ l a: z ə m
<|URD|>اختیارکردہ	ə x t iː j aː ɽ k ə ɽ d ə ɦ
<|URD|>کھاگ	kʰ a: ɡ
<|URD|>دیواکر	d iː ʋ a: k ə ɽ
<|URD|>ربوہ	ɽ ə b ʋ a: ɦ
<|URD|>ماک	m a: k
<|URD|>داردر	d a: ɽ ɪ d ɽ
<|URD|>پہلا	p ə ɦ l a:
<|URD|>راجا	ɽ a: d͡ʒ a:
<|URD|>ڈھيٹھ	ɖʰ iː ʈʰ
<|URD|>سترویں	s t ɽ oː ʋ eː n
<|URD|>بھونگیر	bʰ ʊ ŋ ɡ iː r
<|URD|>ڈیفنس	ɖ iː f n ɪ s
<|URD|>دستبردار	d ʊ s t b ɛ r d a: r
<|URD|>جگر	d͡ʒ ə ɡ ə r
<|URD|>جانی	d͡ʒ a: n iː
<|URD|>پولیت	p oː l iː t
<|URD|>شروع	ʃ ʊ ɽ uː a
<|URD|>ڈگیس	ɖ ɪ ɡ iː s
<|URD|>ورزش	ʋ ə ɽ z ɪ ʃ
<|URD|>فٹچ	f t͡ʃ
<|URD|>فتنہ	f ə t n ə
<|URD|>گودھرا	ɡ oː dʰ ɽ aː
<|URD|>سختی	s a x t iː
<|URD|>کوہیر	k oː ɦ iː ɽ
<|URD|>پریم	p ɽ eː m
<|URD|>غیرضروری	ɣ eː ɽ z ə ɽ uː ɽ iː
<|URD|>ڈر	ɖ ə ɽ
<|URD|>بہار	b ə ɦ a: ɽ
<|URD|>کمیشن	k a m iː ʃ a n
<|URD|>عکس	a k s
<|URD|>پنا	p ə n n a:
<|URD|>شائق	ʃ a: ɪ q
<|URD|>تکنیکی	t a k n iː k iː
<|URD|>ایرانڈیا	a iː r aː n d iː aː
<|URD|>خودکش	x ʊ d k ʊ ʃ
<|URD|>روپیا	ɽ uː p iː a:
<|URD|>افق	a: f ə q
<|URD|>عجائب	ə d͡ʒ a: ɪ b
<|URD|>تیسری	t eː s r iː
<|URD|>اردن	a: r d ə n
<|URD|>ژالہ	ʒ a: l ə
<|URD|>پیشاب	p eː ʃ a: b
<|URD|>لیبرمن	l iː b ə r m ə n
<|URD|>پرتبھا	p ə r t ʊ bʰ a:
<|URD|>ایماندار	iː m a: n d a: ɽ
<|URD|>پورکر	p u: r k ə r
<|URD|>بستی	b ə s t iː
<|URD|>مہلوک	m ə ɦ l oː k
<|URD|>لیگ	l iː ɡ
<|URD|>مئی	m eː ɪ
<|URD|>حالانکہ	ɦ a: l a: k iː
<|URD|>دیکشت	d iː k ʃ t
<|URD|>کشتی	k ə ʃ t iː
<|URD|>طوطی	ʈ ɔː ʈ iː
<|URD|>لڑکی	l ə ɽ k iː
<|URD|>کھانی	kʰ a: n iː
<|URD|>اطباء	ɪ t ɪ b a: a:
<|URD|>بوتھا	b oː tʰ a:
<|URD|>مالیت	m a: l iː t
<|URD|>گز	ɡ ʊ z
<|URD|>جوس	d͡ʒ oʊ s
<|URD|>تال	t a: l
<|URD|>وسنت	ʋ ʊ s n a t
<|URD|>کلکٹر	k ʊ l k ʈ ɛ ɽ
<|URD|>جھوٹ	d͡ʒ ʱ uː ʈ
<|URD|>دینا	d eː n a:
<|URD|>رنگاریڈی	ɽ ə ŋ ɡ a: ɽ iː d iː
<|URD|>ش	ʃ
<|URD|>عوامی	a ʋ aː m iː
<|URD|>دعائے	d̪ʊ a: ɪ eː
<|URD|>لیکچرر	l iː k t͡ʃ ə ɽ ɽ
<|URD|>کورٹ	k ɔː r ʈ
<|URD|>سؤر	s uː ə ɽ
<|URD|>میٹرس	m eː t ə r s
<|URD|>پرسوں	p ə ɽ s o:
<|URD|>گلال	ɡ ʊ l a: l
<|URD|>گرجنا	ɡ ə ɽ ə d͡ʒ n a:
<|URD|>یونیورسٹی	j uː n iː ʋ a r s ʈ iː
<|URD|>اختتام۔پزیر	a: x t t a: m p ə z iː ɽ
<|URD|>میٹابولائز	m eː ʈ a: b oː l aː ɪ z
<|URD|>کارڈ	k a: ɽ d
<|URD|>بند	b ə n d
<|URD|>فلک	f ə l ə k
<|URD|>چھاڑ	t͡ʃʰ a: ɽ
<|URD|>گردی	ɡ ʊ r d iː
<|URD|>دھول	dʰ uː l
<|URD|>ایمان	iː m a: n
<|URD|>چوٹ	t͡ʃ oː ʈ
<|URD|>وصولی	ʋ ʊ s uː l iː
<|URD|>ماریشیس	m a: r iː ʃ iː s
<|URD|>مستحکم	m ʊ s t a ɦ k a m
<|URD|>جرأت	d͡ʒ ʊ ɽ ɽ ə t
<|URD|>اکانٹس	ə k a: n ʈ s
<|URD|>جرثومہ	d͡ʒ ʊ ɽ s uː m a:
<|URD|>بابرہ	b a: b ɽ a:
<|URD|>پڑھنا	p ə ɽʰ n a:
<|URD|>ڈابسن	ɖ a: b s ə n
<|URD|>نظرانداز	n ʊ z ɽ a: n d a: z
<|URD|>احتمال	eː ɦ t eː m a: l
<|URD|>ئن	ʔ ɪ n
<|URD|>خون	x uː n
<|URD|>مجھ	m ʊ d͡ʒʰ
<|URD|>پستان	p ɪ s t a: n
<|URD|>علامہ	a ə l aː m ə
<|URD|>آیئنا	a: iː ə n ə
<|URD|>تگنا	t ɪ ɡ n a:
<|URD|>ذات	z a: t
<|URD|>بلین	b ɛː l iː n
<|URD|>دیکھنا	d eː kʰ n a:
<|URD|>اندر	ɪ n d ə ɽ
<|URD|>جھوٹی	d͡ʒ ʱ uː ʈ iː
<|URD|>کارخانہ	k a: r x a: n ə
<|URD|>منصور	m ə n s ʊ ɽ
<|URD|>سنجیدہ	s ʊ n d͡ʒ iː d a
<|URD|>اسرائیل	ɪ s ɽ a: iː l
<|URD|>پورہ	p uː r a:
<|URD|>پھول	pʰ uː l
<|URD|>پردیب	p ə ɽ d iː b
<|URD|>پیٹ	p eː ʈ
<|URD|>کاویہ	k a: ʋ j ə
<|URD|>لاپرواہی	l a: p ɽ ʋ a: ɦ iː
<|URD|>تئیں	t ɛː ɪ n
<|URD|>لسانیات	l ɪ s a: n ɪ j a: t
<|URD|>میٹنگ	m iː ʈ ɪ ŋ ɡ
<|URD|>سہولت	s ʊ ɦ ʊ l t
<|URD|>احسان	ə ɦ ə s a: n
<|URD|>یوگانڈا	j ʊ ɡ a: n ʈ a:
<|URD|>غرناطہ	ɣ ə ɽ n a: t a: ɦ
<|URD|>حصول	ɦ ʊ s uː l
<|URD|>شرینگر	ʃ ɽ iː n ə ɡ ə ɽ
<|URD|>فٹنس	f ɪ t n ə s
<|URD|>فرار	f a r aː r
<|URD|>کاڑھا	k a: ɽʰ a:
<|URD|>موجودہ	m oː d͡ʒ uː d a:
<|URD|>تحصیل	t ɦ ʊ s iː l
<|URD|>شعر	ʃ eː ɽ
<|URD|>دوران	d ʊ ɽ a: n
<|URD|>ذلیل	z ə l iː l
<|URD|>وہ	ʋ oː
<|URD|>کوی۶	k oː ɪ a 6
<|URD|>بلی	b ə l iː
<|URD|>خصوصا	x ʊ s uː s ə n
<|URD|>کھجلی	kʰ ʊ d͡ʒ l iː
<|URD|>اصول	ʊ s uː l
<|URD|>اترنا	ʊ t ə ɽ n a:
<|URD|>کشادہ	k ə ʃ aː d ə
<|URD|>سوالیہ	s uː aː l iː ə
<|URD|>باولی	b aː oː l iː
<|URD|>ارسطو	ə ɽ ə s t uː
<|URD|>حسین	ɦ ʊ s eɪ n
<|URD|>بغیر	b ɪ ɣ ɛː r
<|URD|>یہود	j ə ɦ uː d
<|URD|>مسوری	m ʊ s ʋ ʊ r iː
<|URD|>ویریا	ʋ iː r iː a:
<|URD|>کٹرپسند	k ʈ ə ɽ p s ʊ n d
<|URD|>چلانا	t͡ʃ ɪ l l a: n a:
<|URD|>ڈکار	ɖ ə k a: ɽ
<|URD|>صلیب	s ə l iː b
<|URD|>اسٹال	ɪ s ʈ aː l
<|URD|>چنگال	t͡ʃ ə ŋ ɡ a: l
<|URD|>شے۶	ʃ eː t͡ʃʰ ʰ
<|URD|>اودھاؤ	ɔː dʰ a: ʊ
<|URD|>آخرت	a: x ɪ ɽ ə t
<|URD|>چتا	t͡ʃ ʊ t a:
<|URD|>راجیش	ɽ a: d͡ʒ iː ʃ
<|URD|>پھاڑ	pʰ a: ɽ
<|URD|>وصال	ʋ ɪ s a: l
<|URD|>لکیج	l ə k iː d͡ʒ
<|URD|>بجٹ	b ə d͡ʒ ʈ
<|URD|>چوتھا	t͡ʃ ɔː tʰ a:
<|URD|>پولیو	p oː l iː oː
<|URD|>جلسہ	d͡ʒ ə l s a ɦ
<|URD|>اللہ	ə l l a: ɦ
<|URD|>بحیثیت	b ɦ ɪ s iː t
<|URD|>ارجت	ə ɽ d͡ʒ ɪ t
<|URD|>بالخصوص	b a: l x a s ʊ s
<|URD|>جنوری	d͡ʒ a n uː r iː
<|URD|>بتایاکہ	b ɪ t a: j a: k ɛː
<|URD|>دل	d ɪ l
<|URD|>نہ	n a:
<|URD|>بیلاروس	b eː l a: ɽ uː s
<|URD|>ریشی	r eː ʃ iː
<|URD|>باہوبلی	b a: ɦ ʊ b ə l iː
<|URD|>چوتھائی	t͡ʃ ɔː tʰ a: iː
<|URD|>مدیرا	m ə d iː ɽ a:
<|URD|>فرمائش	f ə ɽ m a: ɪ ʃ
<|URD|>بلکہ	b ə l k iː
<|URD|>انٹرملان	ɪ n ʈ ə ɽ m ə l a: n
<|URD|>تلبیہ	t ə l b iː ə
<|URD|>سمکھ	s ə m m ʊ kʰ
<|URD|>متوفی	m ʊ t ʋ ɔː f iː
<|URD|>پرچہ	p ə ɽ t͡ʃ ə
<|URD|>کتی	k ə t iː
<|URD|>ایکسپریس	aɪ k s p ɽ iː s
<|URD|>ناخوش	n a: x ʊ ʃ
<|URD|>روانہ	ɽ ə ʋ a: n a:
<|URD|>بیمار	b eː m a: ɽ
<|URD|>مورتی	m uː ɽ t iː
<|URD|>ٹھوس	ʈʰ oː s
<|URD|>باون	b a: ʊ n
<|URD|>جامن	d͡ʒ a: m ə n , d͡ʒ a: m ʊ n
<|URD|>ساتھ	s a: tʰ
<|URD|>مکھ	m ʊ kʰ
<|URD|>شیواجی	ʃ iː ʋ a: d͡ʒ iː
<|URD|>نعرہ	n a: ɽ a: ɦ
<|URD|>عجب	a d͡ʒ a b
<|URD|>انفراسٹرکچر	ɪ n f r a: s t ɽ ʊ k t͡ʃ ʊ ɽ
<|URD|>گمانا	ɡ ʊ m a: n a:
<|URD|>پٹی	p ʈ iː
<|URD|>چڑیا	t͡ʃ ɪ ɽ ɪ j a:
<|URD|>بیاگ	b j aː ɡ
<|URD|>دمشق	d ə m ɪ ʃ q
<|URD|>لئے	l ɛː
<|URD|>لیاپس	l iː a: p s
<|URD|>تب	t ə b
<|URD|>بالکل	b ɪ l k ʊ l
<|URD|>ایشین	eː ʃ iː n
<|URD|>کپاسی	k ə p a: s iː
<|URD|>روزگار	r oː z ɡ a: r
<|URD|>پاکستان	p a: k ɪ s t a: n
<|URD|>عبید	a ʊ b eː d
<|URD|>طینت	ʈ ɪ n t
<|URD|>غیردستوری	ɣ ɛː r d ʊ s t ʊ ɽ iː
<|URD|>بیٹھ	b eː ʈʰ
<|URD|>چیتاپور	t͡ʃ iː t aː p ɔː r
<|URD|>چپل	t͡ʃ ə p ə l
<|URD|>راشٹرپتی	r a: ʃ t r p a t iː
<|URD|>ٹیکساس	ʈ iː k s a: s
<|URD|>بتدریج	b ə t d ɽ iː d͡ʒ
<|URD|>تلخ	t ə l ə x
<|URD|>تھوکنا	tʰ uː k n a:
<|URD|>امن	ə m ə n
<|URD|>برتر	b ɪ ɽ t ɽ
<|URD|>ہونا	ɦ oː n a:
<|URD|>گفتگو	ɡ ʊ f t ɡ oʊ
<|URD|>عالمی	a a: l ə m iː
<|URD|>یوسف	j uː s ə f
<|URD|>کالا	k a: l a:
<|URD|>خاصی	x a: s iː
<|URD|>صحافت	s ɪ ɦ a: f ə t
<|URD|>بیوی	b iː ʋ iː
<|URD|>معلوم	m aː l uː m
<|URD|>ملک	m ʊ l k
<|URD|>بے۔چین	b eː t͡ʃ eː n
<|URD|>کالنگ	k a: l ə ŋ ɡ
<|URD|>ساڑھے	s aː r a
<|URD|>دوپہر	d uː p ɛː ɽ
<|URD|>سینکڑا	s ɛː ŋ k ɽ a:
<|URD|>ثروت	s ə ɽ ʋ ə t
<|URD|>گنبذ	ɡ ʊ m b ə z
<|URD|>اندرا	ɪ n d r a:
<|URD|>منسٹرا	m ə n s ʈ ɽ a:
<|URD|>آفسیر	a: f s iː ɽ
<|URD|>ٹائیلس	ʈ a: ɪ l s
<|URD|>گاڑی	ɡ a: ɽ iː
<|URD|>ایونٹ	a: j uː n ʈ
<|URD|>البتہ	a l b ə t a:
<|URD|>یونٹس	j ʊ n ɪ t s
<|URD|>بہنا	b ɛ ɦ n a:
<|URD|>آنکھ	a: kʰ
<|URD|>سینا	s iː n a:
<|URD|>چوٹکی	t͡ʃʰ ʊ ʈ k iː
<|URD|>لمبا	l ə m b a:
<|URD|>سنہ	s ɪ ŋ ɦ
<|URD|>تندرست	t ə n d ʊ ɽ ʊ s t
<|URD|>آگار	a: ɡ a: ɽ
<|URD|>امیت	a m iː t
<|URD|>صفائی	s ɪ f a: iː
<|URD|>خریدنا	x ə ɽ iː d n a:
<|URD|>گلبرگہ	ɡ ʊ l b ə ɽ ɡ ə
<|URD|>سید	s eː d
<|URD|>الم	ə l ə m
<|URD|>ایذارسانیوں	a: ɪ z a: ɽ s a: n iː ʊ n
<|URD|>بکس	b ə k s
<|URD|>شرکرا	ʃ ə ɽ k ə ɽ a:
<|URD|>بریہ	b ə ɽ j ə
<|URD|>امداد	ɪ m d a: d
<|URD|>انتخاب	ɪ n t ɪ x a: b
<|URD|>سرزنش	s ə ɽ z n ɪ ʃ
<|URD|>حریت	ɦ ʊ r iː t
<|URD|>باشاہ	b a: ʃ a: ɦ
<|URD|>سکنا	s ə k n a:
<|URD|>بکم	b ʊ k m
<|URD|>تندرستی	t ə n d ʊ ɽ ʊ s t iː
<|URD|>بہتر	b ə ɦ ə t t ə ɽ
<|URD|>نہایت	n ɪ ɦ a: j ə t
<|URD|>مت	m ə t
<|URD|>مسٹرسنہا	m ɪ s ʈ ə r s n ə ɦ a:
<|URD|>نکسلائٹ	n ɪ k s l a: iː t
<|URD|>جور	d͡ʒ ʋ ə ɽ
<|URD|>حرج	ɦ ʊ r d͡ʒ
<|URD|>کلومیٹر	k ɪ l oʊ m iː t ə ɽ
<|URD|>محنت	m ɪ ɦ n ə t
<|URD|>آدھا	a: dʰ a:
<|URD|>غرض	ɣ ʊ r d z
<|URD|>زیرقیادت	z i: r q iː a: d t
<|URD|>کیمیکل	k iː m iː k ə l
<|URD|>دجلہ	d ə d͡ʒ l a:
<|URD|>سائینس	s a: ɪ n s
<|URD|>ماہ	m aː ɦ
<|URD|>داغ	d a: ɣ
<|URD|>گھیرنے	ɡʰ iː r n eɪ
<|URD|>مقفل	m ʊ q f ʊ l
<|URD|>آزمانا	a: z m a: n a:
<|URD|>بیورو	b j ʊ ɽ oː
<|URD|>وشنو	ʋ ɪ ʃ n uː
<|URD|>قوم	q ɔː m
<|URD|>پنکھا	p ə ŋ kʰ a:
<|URD|>کھوکس	kʰ oː k s
<|URD|>انگریزی	ə ŋ ɡ ɽ eː z iː
<|URD|>بھوتنی	bʰ uː t ɪ n iː
<|URD|>نکال	n ɪ k a: l
<|URD|>شرط	ʃ ə ɽ t
<|URD|>سمجھدار	s ə m ə d͡ʒʰ d a: ɽ
<|URD|>بارہا	b a: ɽ ɦ a:
<|URD|>نصرت	n ʊ s ɽ ə t
<|URD|>نیلا	n iː l a:
<|URD|>صحیح	s ə ɦ iː
<|URD|>توحیدیت	t ɔː ɦ iː d ɪ j ə t
<|URD|>راس	ɽ aː s
<|URD|>نہس	n ɛ ɦ s
<|URD|>گھڑیال	ɡʰ ə ɽ ɪ j a: l
<|URD|>فالحال	f ɪ l ɦ a: l
<|URD|>کھٹائی	kʰ ə ʈ a: iː
<|URD|>جسور	d͡ʒ ə s uː ɽ
<|URD|>بھکتی	bʰ ə k t iː
<|URD|>رہنا	ɽ ə ɦ n a:
<|URD|>چٹس	t͡ʃ ə ʈ s
<|URD|>برچھیت	b ə ɽ t͡ʃʰ ɛː t
<|URD|>کھاتا	kʰ a: t a:
<|URD|>چہارم	t͡ʃ ə ɦ a: ɽ ʊ m
<|URD|>جدول	d͡ʒ ʊ d ʊ l
<|URD|>اسٹیون	ɪ s t iː ʋ ə n
<|URD|>نمائندہ	n ʊ m a: ɪ n d ə ɦ
<|URD|>رکھا	ɽ ʊ kʰ a:
<|URD|>تنازع	t ə n a: z oː ʔ
<|URD|>مہاجرت	m ʊ ɦ a: d͡ʒ ə ɽ ə t
<|URD|>لاٹھی	l a: ʈʰ iː
<|URD|>كا	k a:
<|URD|>وجود	ʋ ə d͡ʒ uː d
<|URD|>تلقین	t ə l q iː n
<|URD|>خدا	x ʊ d a:
<|URD|>ریکارڈز	ɽ eɪ k a: ɽ ɖ z
<|URD|>نکتہ	n ʊ k t a:
<|URD|>اومیش	oː m iː ʃ
<|URD|>دھوسر	dʰ uː s ə r
<|URD|>لینا	l eː n a:
<|URD|>حبش	ɦ ə b ə ʃ
<|URD|>اگان	ə ɡ a: n
<|URD|>سینیٹر	s iː n eː ʈ ə ɽ
<|URD|>سوار	s ʋ a: ɽ
<|URD|>سرونام	s ə ɽ ʋ n a: m
<|URD|>مذاکرہ	m ʊ z a: k ə r a:
<|URD|>شبہات	ʃ ə b ɦ a: t
<|URD|>قلم	q ə l ə m
<|URD|>کولکاتا	k oː l k a: t a:
<|URD|>چکنا	t͡ʃ ʊ k n a:
<|URD|>شاعری	ʃ a: j ɽ iː
<|URD|>نوٹس	n oː ʈ s
<|URD|>سستی	s ʊ s t iː
<|URD|>موقع	m ɔː q a:
<|URD|>العرفائ	ə l a ɽ f a: ɪ
<|URD|>سنجیدگی	s ʊ n d͡ʒ iː d ɡ iː
<|URD|>روزہ	ɽ oː z a:
<|URD|>توصیف	t ʋ o s iː f
<|URD|>جگاڑ	d͡ʒ ʊ ɡ a: ɽ
<|URD|>اداسی	ʊ d a: s iː
<|URD|>استقبال	ɪ s t ɪ q b a: l
<|URD|>پھلنا	pʰ ə l n a:
<|URD|>تمام۔تر	t ʊ m a: m t ɽ
<|URD|>سوچنا	s oː t͡ʃ n a:
<|URD|>ڈیولپمنٹ	ɖ iː oʊ l p m ə n ʈ
<|URD|>سیریز	s iː ɽ iː z
<|URD|>سرسید	s ə ɽ s iː d
<|URD|>للاٹ	l ə l a: ʈ
<|URD|>فالسئی	f a: l s ə iː
<|URD|>ایف	eː f
<|URD|>بغير	b ə ɣ ɛː ɽ
<|URD|>انتخابی	ɪ n t ɪ x a: b iː
<|URD|>تمھارا	t ʊ m a: ɽ a:
<|URD|>قیدی	q iː d iː
<|URD|>سائبرٹاورس	s a: ɪ b ə ɽ ʈ a: ʋ ə ɽ s
<|URD|>سناتن	s ə n a: t ə n
<|URD|>کمیونٹی	k a m j uː n ɪ ʈ iː
<|URD|>زیر۔قیادت	z iː ɽ q iː a: d ə t
<|URD|>رنگت	ɽ ə ŋ ɡ ə t
<|URD|>تیمور	t ɛː m uː ɽ
<|URD|>ٹیلی	ʈ iː l iː
<|URD|>عنقاد	a ɪ n q a: d
<|URD|>گنجان	ɡ ʊ n d͡ʒ a: n
<|URD|>ڈال	ɖ a: l
<|URD|>چندربند	t͡ʃ ə n d ə ɽ ə b ɪ n d ʊ
<|URD|>شکایات	ʃ iː k aː j aː t
<|URD|>اطلس	ə t l ə s
<|URD|>سیرسہ	s eː ɽ s ə
<|URD|>متھرا	m ə tʰ ʊ ɽ a:
<|URD|>کھرجو	kʰ ə ɽ d͡ʒ uː
<|URD|>کوشش	k oː ʃ ɪ ʃ
<|URD|>گمبھیر	ɡ ə m bʰ iː ɽ
<|URD|>ضمانت	z ə m a: n ə t
<|URD|>سینکڑوں	s eː n k ə ɽ oː n
<|URD|>نوواں	n ə u ʋ a:
<|URD|>ہرانا	ɦ ə ɽ a: n a:
<|URD|>سائنسداں	s a: ɪ n s d a: n
<|URD|>گھاو	ɡʰ a: ʋ
<|URD|>ضلاع	z ʊ l a: a
<|URD|>ذمہ۔دارانہ	z ə m ɦ ɖ a: ɽ a: n a:
<|URD|>انکڈل	ɪ n k ə ɖ l
<|URD|>علوم	ʔ ʊ l uː m
<|URD|>جڑواں	d͡ʒ ʊ ɽ ʋ a:
<|URD|>دلچسپ	d ɪ l t͡ʃ ə s p
<|URD|>رنڈی	ɽ ə n ɖ iː
<|URD|>اقامت	ɪ q a: m ə t
<|URD|>گیند	ɡ eː n d
<|URD|>مقبوضہ	m ə q b uː z ə
<|URD|>روپے	ɽ uː p eː
<|URD|>باضابطہ	b a: z a: b ɪ t ɦ a:
<|URD|>دھارا	dʰ a: ɽ a:
<|URD|>بمبہ	b ə m b
<|URD|>ٹھیس	ʈʰ iː s
<|URD|>کشما	k ʂ ə m a:
<|URD|>ڈھانک	ɖʰ a: n k
<|URD|>اسکواڈ	a: s k uː a: d
<|URD|>خاطیوں	x a: t iː j oː n
<|URD|>ازدواج	ɪ z d ɪ ʋ a: d͡ʒ
<|URD|>موجھی	m oʊ d͡ʒʰ iː
<|URD|>مینا	m eː n a:
<|URD|>واقعاتی	ʋ a: q eː a: t iː
<|URD|>خالد	x a: l ɪ d
<|URD|>پریمئر	p r eɪ m ɪə r
<|URD|>رائےدہی	ɽ aː ɪ ə d ɦ iː
<|URD|>گجویل	ɡ ə d͡ʒ ʋ ə iː l
<|URD|>دبئی	d ʊ b ə iː
<|URD|>پرشنسا	p ɽ ə ʃ ə n s a:
<|URD|>انشاء	ɪ n ʃ a: ʔ
<|URD|>نوموہیون	n ʊ m ʊ ɦ iː ʊ n
<|URD|>چوتر	t͡ʃ uː t ə ɽ
<|URD|>کار	k a: ɽ
<|URD|>افغانستان	ə f ɣ a: n ɪ s t a: n
<|URD|>پراڈکٹس	p ɽ a: ʈ k ʈ s
<|URD|>تمنا	t ə m ə n n a:
<|URD|>درسگاہ	d ə r s ɡ a: ɦ
<|URD|>بت	b ʊ t
<|URD|>کوڈا	k ʊ d a:
<|URD|>مرحومہ	m ə ɽ ɦ uː m ə
<|URD|>غزہ	ɣ ə z ə
<|URD|>متوجہ	m ʊ t ə ʋ ə d͡ʒ d͡ʒ ʊ ɦ
<|URD|>بددعا	b ə d d ʊ a:
<|URD|>نبض	n ə b z
<|URD|>استثنی	ɪ s t ɪ s n a: iː
<|URD|>ارے	ə ɽ eː
<|URD|>اسکینڈلس	ə s k iː n d ə l s
<|URD|>منان	m ʊ n a: n
<|URD|>برسلز	b ɽ ə s ə l z
<|URD|>الھند	ʔ ə l ɦ ɪ n d
<|URD|>کپتان	k ə p t a: n
<|URD|>ہومگارڈ	ɦ oː m ɡ aː r ɖ
<|URD|>کونسل	k oː n s ə l
<|URD|>دہندہ	d ə ɦ n d ə
<|URD|>ڈرونس	ɖ ɽ oː n s
<|URD|>مہنگی	m ə ɦ n ɡ iː
<|URD|>باقاعدگی	b a: q a: ʔ ɪ d ɡ iː
<|URD|>پٹے	p a t eɪ
<|URD|>عادل	a a: d ə l
<|URD|>رامائن	ɽ a: m a: j ə n
<|URD|>آس	a: s
<|URD|>گرانٹس	ɡ r a: n t s
<|URD|>مؤذن	m ʊ ə z z ɪ n
<|URD|>ٹائلٹ	ʈ a: ɪ l ʈ
<|URD|>جنرل	d͡ʒ ə n ɽ ə l
<|URD|>زائد	z a: ɪ d
<|URD|>تنگ	t ə ŋ ɡ
<|URD|>اڑیوا	ə ɽ eː ʋ a:
<|URD|>کالسانگرا	k a: l s a: ŋ ɡ r a:
<|URD|>جھنڈا	d͡ʒʰ ə n ɖ a:
<|URD|>حویلی	ɦ ə ʋ eː l iː
<|URD|>مکھن	m ə kʰ ə n
<|URD|>کپوت	k ə p oː t
<|URD|>مارکٹس	m a: r k ɪ t s
<|URD|>مینٹن	m eː n ʈ n
<|URD|>حجر	ɦ ə d͡ʒ ɽ
<|URD|>سنوار	s ʊ n ʋ a: r
<|URD|>ذائقہ	z a: j q a:
<|URD|>مکانپور	m ə k a: n p ɔː ɽ
<|URD|>خسرہ	x ə s ɽ a:
<|URD|>الفاظ	a l f a: z
<|URD|>قاسمی	q aː s m iː
<|URD|>بھالو	bʰ a: l uː
<|URD|>چومنا	t͡ʃ uː m n a:
<|URD|>عیسیٰ	iː s a:
<|URD|>تناظر	t ə n a: z ə r
<|URD|>گلانی	ɡ l a: n iː
<|URD|>جرمنی	d͡ʒ ə ɽ m ə n iː
<|URD|>دام	d a: m
<|URD|>کشدھا	k ʂ ʊ dʰ a:
<|URD|>بجلی	b ɪ d͡ʒ l iː
<|URD|>پاور	p a: ʋ ə ɽ
<|URD|>واحد	ʋ a: ɦ ɪ d
<|URD|>بڑھوتری	b a ɽ ʊ t ɽ iː
<|URD|>کھنک	kʰ ə n ə k
<|URD|>سويمور	s ʋ ə j ə m ʋ ə ɽ
<|URD|>روس	ɽ uː s
<|URD|>قیمتی	q iː m ə t iː
<|URD|>جبری	d͡ʒ ʊ b r iː
<|URD|>ریکارڈکردہ	r eː k a: r ʈ k ʊ r d ə ɦ
<|URD|>چھوٹا	t͡ʃʰ oː ʈ a:
<|URD|>خارجہ	x a: ɽ ɪ d͡ʒ a:
<|URD|>ڈوجی	ɖ oː d͡ʒ iː
<|URD|>وارسا	ʋ a: ɽ s a:
<|URD|>سننا	s ʊ n n a:
<|URD|>فلسطین	f ɪ l ɪ s t iː n
<|URD|>مٹنا	m ɪ ʈ n a:
<|URD|>گنگولی	ɡ ʊ ŋ ɡ ɔː l iː
<|URD|>مجرمانہ	m ʊ d͡ʒ ɽ ɪ m a: n a:
<|URD|>کارن	k a: ɽ ə n
<|URD|>ہمیں	ɦ ə m e:
<|URD|>ین	iː n
<|URD|>جوہر	d͡ʒ ɔː ɦ ə ɽ
<|URD|>صلاح	s ʊ l a: ɦ
<|URD|>عشق	ɪ ʃ q
<|URD|>سوٹ	s uː ʈ
<|URD|>شری	ʃ ɽ iː
<|URD|>اخلاق	ə x l a: q
<|URD|>اگربتی	ə ɡ ə ɽ b ə t t iː
<|URD|>شوارع	ʃ oː aː r a
<|URD|>انشورنس	ɪ n ʃ ʊ r ə n s
<|URD|>چوتڑ	t͡ʃ uː t ə ɽ
<|URD|>بھوگ	bʰ ʊ ɡ
<|URD|>ککش	k ə k ʃ
<|URD|>راو	r aː ʋ
<|URD|>گندا	ɡ ʊ n d a:
<|URD|>ناراض	n a: ɽ a: z
<|URD|>فہد	f ə ɦ d
<|URD|>مرنا	m ə ɽ n a:
<|URD|>اهہ	ɪ ɦ
<|URD|>سلجوقی	s ə l d͡ʒ uː q iː
<|URD|>تماشہ	t ʊ m a: ʃ a:
<|URD|>اضطراری	ɪ z t ɪ ɽ a: ɽ iː
<|URD|>الوداع	ə l ʋ ɪ d a:
<|URD|>چھوٹ	t͡ʃʰ uː ʈ
<|URD|>اوسو	ɔː s o
<|URD|>لکژری	l ʊ k z ʊ r iː
<|URD|>زندہ	z ɪ n d a:
<|URD|>تعاقب	t a a: q ʊ b
<|URD|>دوسرا	d uː s ɽ a:
<|URD|>نائٹ	n aɪ t
<|URD|>مردانہ	m ə ɽ d a: n a:
<|URD|>اوقاف	ɔː q a: f
<|URD|>تخلیہ	t ə x l iː ə
<|URD|>ضبط	z a b t
<|URD|>چھان	t͡ʃʰ a: n
<|URD|>دوستانہ	d oː s t a: n a:
<|URD|>کیمیائی	k iː m ɪ j a: iː
<|URD|>گاڑ	ɡ a: ɽ
<|URD|>سوہال	s uː ɦ aː l
<|URD|>پردیش	p ɽ ə d iː ʃ
<|URD|>کنجی	k ʊ n d͡ʒ iː
<|URD|>موہنی	m oː ɦ n iː
<|URD|>لداخ	l ə d a: x
<|URD|>جی	d͡ʒ iː
<|URD|>پیرس	p ɛː ɽ ɪ s
<|URD|>تقریباً	t ə q ɽ iː b ə n
<|URD|>انسیت	ɪ n s iː t
<|URD|>ارتعاش	ɪ ɽ t eː a: ʃ
<|URD|>سفید	s ə f eː d
<|URD|>نبی	n ə b iː
<|URD|>مظاہرہ	m ʊ z a: ɦ ɪ ɽ a:
<|URD|>بکرا	b ə k ɽ a:
<|URD|>نظم	n ə z ə m
<|URD|>کہنا	k ə ɦ n a:
<|URD|>النکار	ə l ə ŋ k a: ɽ
<|URD|>راہداری	ɽ a: ɦ d a: ɽ iː
<|URD|>نستعلیق	n ə s t a: l iː q
<|URD|>نباتیات	n ə b a: t ɪ j a: t
<|URD|>فصل	f a s l
<|URD|>معبود	m a: ʔ b uː d
<|URD|>دندنا	d ə n d ə n a:
<|URD|>جونیر	d͡ʒ ʊ n iː ɽ
<|URD|>سے	s eː
<|URD|>کب	k a b
<|URD|>روپ	ɽ uː p
<|URD|>تیرنا	t ɛː ɽ n a:
<|URD|>آندھی	a: n dʰ iː
<|URD|>ناٹ	n a: ʈ
<|URD|>للن	l ʊ l ə n
<|URD|>کسمپرسی	k ə s m ʊ p r ə s iː
<|URD|>روزن	ɽ ɔː z ə n
<|URD|>گارڈیولا	ɡ aː ɽ ɖ iː oː l aː
<|URD|>میگھ	m eː ɡʰ
<|URD|>پانچ	p a: t͡ʃ
<|URD|>دامودر	d a: m uː d a r
<|URD|>بال	b a: l
<|URD|>انقلاب	ɪ n q ɪ l a: b
<|URD|>جپنا	d͡ʒ ə p n a:
<|URD|>جراثیم	d͡ʒ ə ɽ a: s iː m
<|URD|>مقدسہ	m ʊ q ə d d ə s a:
<|URD|>ڈنکرک	ɖ ə n k ə ɽ k
<|URD|>جل	d͡ʒ ə l
<|URD|>ہوس	ɦ ə ʋ ə s
<|URD|>غیرمحفوظ	ɣ ɛː ɽ m ɦ ʊ f ʊ z
<|URD|>قیام	q iː a: m
<|URD|>غفلت	ɣ ə f l ə t
<|URD|>لائینز	l aɪ n z
<|URD|>محمدو	m ʊ ɦ ə m ə d ʋ oʊ
<|URD|>نوبت	n ɔː b ə t
<|URD|>مرکندہ	m ʊ ɽ k ə n d ə
<|URD|>جائزہ	d͡ʒ a: ɪ z a:
<|URD|>مفاہمت	m ʊ f a: ɦ ɪ m ə t
<|URD|>سرکار	s ə ɽ k a: ɽ
<|URD|>معالجہ	m a a a: l ɪ d͡ʒ a:
<|URD|>بوائز	b oʊ z
<|URD|>ہیڈکوارٹر	ɦ iː ʈ k ʋ a: ɽ ʈ ə ɽ
<|URD|>معلنہ	m a ə l ə n ə ɦ
<|URD|>پیاز	p ɪ j a: z
<|URD|>گدھ	ɡ ɪ d dʰ
<|URD|>مینڈس	m eː n ɖ s
<|URD|>ہچکنا	ɦ ɪ t͡ʃ ə k n a:
<|URD|>طرابلس	t ɽ a: b ʊ l s
<|URD|>بظاہر	b ə z a: ɦ ɪ ɽ
<|URD|>اینٹی	ʔ eː n ʈ iː
<|URD|>جلوس	d͡ʒ ʊ l uː s
<|URD|>شہزادہ	ʃ ə ɦ z a: d a:
<|URD|>برما	b ə ɽ m a:
<|URD|>اپدهان	ʊ p dʰ a: n
<|URD|>کواری	k ʋ a: r iː
<|URD|>ناظم	n a: z ɪ m
<|URD|>جدا	d͡ʒ ʊ d a:
<|URD|>اسکام	ə s k a: m
<|URD|>چھٹی	t͡ʃʰ ʊ ʈ iː
<|URD|>گنگ	ɡ ʊ ŋ ɡ
<|URD|>میکسیکو	m eː k s iː k oː
<|URD|>بدھا	b ʊ dʰ a:
<|URD|>شنتانو	ʃ ə n t ə n uː
<|URD|>ونا	ʋ ɪ n a:
<|URD|>زبردستی	z ʊ b ɽ d ʊ s t iː
<|URD|>سمپرداے	s ə m p ɽ ə d a: eː
<|URD|>داعش	d a: ʔ ɪ ʃ
<|URD|>بلے	b ʊ l eː
<|URD|>تو	t uː
<|URD|>مفت	m ʊ f t
<|URD|>اٹاپٹو	a t aː p t o
<|URD|>دلجمعی	d ə l d͡ʒ ʊ m a iː
<|URD|>فون	f o: n
<|URD|>پراڈکٹ	p ɽ aː ɖ a k ʈ
<|URD|>خراش	x ə ɽ a: ʃ
<|URD|>نسق	n ɪ s q
<|URD|>استعمال	ɪ s t eː m a: l
<|URD|>چیمپین	t͡ʃ iː m p iː n
<|URD|>امدادی	ə m d a: d iː
<|URD|>آسیب	a: s eː b
<|URD|>اپستھت	ʊ p ə s tʰ ɪ t
<|URD|>بینالاقوامی	b eɪ n a: l a: q ʋ a: m iː
<|URD|>کیتیش	k eː t iː ʃ
<|URD|>سوپراسٹار	s uː p ɽ a: s ʈ a: ɽ
<|URD|>محروم	m ə ɦ ɽ uː m
<|URD|>کیمپ	k eː m p
<|URD|>نافذالعمل	n aː f iː z ʔ ə l a ə m ə l
<|URD|>انوراللہ	a: n ʋ ə r a: l l a: ɦ
<|URD|>گلو	ɡ ʊ l oː , ɡ ʊ l uː , ɡ ə l uː
<|URD|>ہتھیلی	ɦ ə tʰ eː l iː
<|URD|>جوفری	d͡ʒ o f r iː
<|URD|>کامرس	k aː m ə ɽ s
<|URD|>ارکنساس	a: ɽ k ə n s a: s
<|URD|>ممتا	m ʊ m t a:
<|URD|>چھوٹنا	t͡ʃʰ uː ʈ n a:
<|URD|>گائیڈنس	ɡ a: iː d n s
<|URD|>پنیسر	p a n iː s ɛ r
<|URD|>بشمول	b ə ʃ m ʊ l
<|URD|>پوشیدہ	p oː ʃ iː d ə
<|URD|>مشکل	m ʊ ʃ k ɪ l
<|URD|>تعداد	t ə ʔ d a: d
<|URD|>فرق	f ɽ q
<|URD|>مصنوعات	m ʊ s n u: a a: t
<|URD|>پاؤڈر	p a: ʊ ʈ ə ɽ
<|URD|>ٹھیک	ʈʰ iː k
<|URD|>معتمد	m ʊ ʔ t ə m ɪ d
<|URD|>کہاوت	k ə ɦ a: ʋ ə t
<|URD|>فلپائن	f ɪ l ɪ p a: ɪ n
<|URD|>سندھ	s ɪ n dʰ
<|URD|>خبریں	x ə b ɽ iː n
<|URD|>جوڑ	d͡ʒ oː ɽ
<|URD|>قمیض	q ə m iː z
<|URD|>دیوبندی	d eː ʋ b ə n d iː
<|URD|>مایہ	m aː j ɦ
<|URD|>ابابیل	ə b a: b iː l
<|URD|>کفر	k ə f ə r
<|URD|>وشاکھا	ʋ ʊ ʃ a: kʰ a:
<|URD|>تلاش	t ə l a: ʃ
<|URD|>کلب	k ʊ l b
<|URD|>تیزاب	t eː z aː b
<|URD|>چانسلر	t͡ʃ a: n s ə l ə ɽ
<|URD|>آلودگی	a: l uː d ə ɡ iː
<|URD|>عمان	ʔ o m a: n
<|URD|>تبدیلی	t a b d iː l iː
<|URD|>ذریعہ	z ə ɽ ɪ j ə
<|URD|>جہنم	d͡ʒ ə ɦ ə n n ə m
<|URD|>مراسم	m ʊ r aː s ɪ m
<|URD|>انگلی	ʊ ŋ ɡ l iː
<|URD|>ہوا	ɦ ə ʋ a:
<|URD|>قسط	q ɪ s t
<|URD|>ولتھاٹی	ʋ ʊ l tʰ a: ʈ iː
<|URD|>قرمزی	q ɪ ɽ m ɪ z iː
<|URD|>عبد	a ʊ b d
<|URD|>المسلمین	ʊ l m ʊ s l iː m iː n
<|URD|>پکار	p ʊ k a: ɽ
<|URD|>سلم	s ʊ l m
<|URD|>غیرموسمی	ɣ ɛː ɽ m oː s m iː
<|URD|>چیلنج	t͡ʃ eː l n d͡ʒ
<|URD|>مضحکہ	m ʊ z ɦ a: k ə
<|URD|>شاعرہ	ʃ a: j ɽ a:
<|URD|>ہانکنا	ɦ a: ŋ k n a:
<|URD|>اسپاٹ	ɪ s p a: ʈ
<|URD|>پرسکون	p ə ɽ s k uː n
<|URD|>غرور	ɣ ʊ ɽ uː ɽ
<|URD|>جگنو	d͡ʒ ʊ ɡ n uː
<|URD|>بناوٹی	b ə n a: ʋ ə ʈ iː
<|URD|>لکشمن	l ʊ k ʃ m ʊ n
<|URD|>ٹکٹس	ʈ ɪ k ʈ s
<|URD|>جسونت	d͡ʒ ʊ s ʊ n t
<|URD|>رات	ɽ a: t
<|URD|>حلقہ	ɦ ə l q ə
<|URD|>اکائی	a: k a: iː
<|URD|>بامشقت	b a: m ʃ q a t
<|URD|>میدان	m eː d a: n
<|URD|>ماحول	m a: ɦ ɔː l
<|URD|>وفاق	ʋ ɪ f a: q
<|URD|>سواری	s ʋ a: ɽ iː
<|URD|>ختم	x ə t m
<|URD|>چربی	t͡ʃ ə ɽ b iː
<|URD|>مہربن	m ə ɦ r b ə n
<|URD|>کھلاڑی	kʰ l a: ɽ iː
<|URD|>برمنگھم	b ə ɽ m ɪ n ɡʰ ə m
<|URD|>بائیسکل	b a: iː s ɪ k ə l
<|URD|>کتا	k ʊ t t a:
<|URD|>بےہوش	b eː ɦ oː ʃ
<|URD|>کپاس	k ə p a: s
<|URD|>دیروز	d iː ɽ oː z
<|URD|>اجنبی	ə d͡ʒ n ə b iː
<|URD|>جلانا	d͡ʒ ə l a: n a:
<|URD|>لفظ	l ə f z
<|URD|>تمنچه	t ə m ə n t͡ʃ a:
<|URD|>دادا	d a: d a:
<|URD|>عبدالحمید	a b d ʊ l ɦ ə m iː d
<|URD|>اصطبل	ə s t ə b ə l
<|URD|>کہرا	k ʊ ɦ ɽ a:
<|URD|>گھڑی	ɡʰ ə ɽ iː
<|URD|>وزیرداخلہ	ʋ ə z iː r d a: x l ə
<|URD|>منڈا	m ʊ n ɖ a:
<|URD|>کھڑے	kʰ ə ɽ eː
<|URD|>منیجر	m ə n iː d͡ʒ ə r
<|URD|>وجیہ	ʋ ə d͡ʒ iː ɦ
<|URD|>ہائیکورٹ	ɦ aː iː k ɔː ɽ ʈ
<|URD|>پدما	p ə d m a:
<|URD|>مقررہ	m ʊ q ɽ a: ɽ ə
<|URD|>مر	m ə ɽ
<|URD|>ایٹا	eɪ ʈ a:
<|URD|>غزوۂ	ɣ ə z ʋ ə
<|URD|>پٹاخا	p ə ʈ a: x a:
<|URD|>سمن	s ʊ m ə n
<|URD|>راجستھان	ɽ a: d͡ʒ s tʰ a: n
