ငဝ်းလၢႆး	ŋ a w ˥ l aː j ˥
ငိူင်ႉဝႄႈ	ŋ ɤ ŋ ˦˨ˀ w ɛː ˧˧˨
ငူဝ်း	ŋ oː ˥
တင်ႇငူင်း	t a ŋ ˩ ŋ o ŋ ˥
တတ်း	t a t̚ ˥
တပ်ႉသိုၵ်း	t a p̚ ˦˨ˀ sʰ ɯ k̚ ˥
တမ်းပူႇ	t a m ˥ p uː ˩
တမ်ႇငႃႈ	t a m ˩ ŋ aː ˧˧˨
တမ်ႇတိူင်း	t a m ˩ t ɤ ŋ ˥
တလႅင်း	t a ˨˦ l ɛ ŋ ˥
တဝ်	t a w ˨˦
တဝ်ႉ	t a w ˦˨
တိင်ႇ	t i ŋ ˩
တိူၵ်ႇလိူၼ်	t ɤ k̚ ˩ l ɤ n ˨˦
တိူၵ်ႈ	t ɤ k̚ ˧˧˨
တိၼ်	t i n ˨˦
တီႇသႅမ်ႇပႃႇ	t iː ˩ sʰ ɛ m ˩ p aː ˩
တီႈ	t iː ˧˧˨
တီႈၶႃႈ	t iː ˧˧˨ kʰ aː ˧˧˨
တူင်ႉ	t o ŋ ˦˨
တူၵ်းလူင်း	t o k̚ ˥ l o ŋ ˥
တူၼ်ႈမႆႉ	t o n ˧˧˨ m a j ˦˨
တူၼ်ႈၵႃႈ	t o n ˧˧˨ k aː ˧˧˨
တေႃႉသူင်ႇ	t ɔː ˦˨ˀ sʰ o ŋ ˩
တွင်းလၢၼ်း	t ɔ ŋ ˥ l aː n ˥
တွင်ႉမႆႈသႆႈလိူတ်ႇ	t ɔ ŋ ˦˨ˀ m a j ˧˧˨ sʰ a j ˧˧˨ l ɤ t̚ ˩
တၢင်း	t aː ŋ ˥
တၢင်းႁူႉ	t aː ŋ ˥ h uː ˦˨
တၢင်ႇထီး	t aː ŋ ˩ tʰ iː ˥
တၢင်ႇၵုင်ႇ	t aː ŋ ˩ k u ŋ ˩
တၢၼ်း	t aː n ˥
တၢႆ	t aː j ˨˦
တၵႃႇ	t a ˨˦ k aː ˩
တၼင်းလႃႇ	t a ˨˦ n a ŋ ˥ l aː ˩
တၼင်းၼူၺ်ႇ	t a ˨˦ n a ŋ ˥ n o j ˩
တၼူႉ	t a ˨˦ n uː ˦˨
တႃ	t aː ˨˦
တႃႇတၢၵ်ႈ	t aː ˩ t aː k̚ ˧˧˨
တႃႈရူတ်ႉလဵၼ်း	t aː ˧˧˨ r o t̚ ˦˨ˀ l e n ˥
တႃႈႁိူဝ်း	t aː ˧˧˨ h ɤː ˥
တႅင်ၽၢင်	t ɛ ŋ ˨˦ pʰ aː ŋ ˨˦
တႆး	t a j ˥
ထမ်ႈ	tʰ a m ˧˧˨
ထုင်ႇ	tʰ u ŋ ˩
ထူ	tʰ uː ˨˦
ထူဝ်ႇ	tʰ oː ˩
ထူၺ်ႈၸႂ်	tʰ o j ˧˧˨ t͡ɕ a ɰ ˨˦
ထေႃးပၢတ်ႈ	tʰ ɔː ˥ p aː t̚ ˧˧˨
ထွင်ႇ	tʰ ɔ ŋ ˩
ထွင်ႉ	tʰ ɔ ŋ ˦˨
ထၢမ်	tʰ aː m ˨˦
ထၢၼ်	tʰ aː n ˨˦
ထၼူႉ	tʰ a ˨˦ n uː ˦˨
ထႃႇပၼႃႇ	tʰ aː ˩ p a ˨˦ n aː ˩
ပတ်ႈတႃး	p a t̚ ˧˧˨ t aː ˥
ပတ်ႉ	p a t̚ ˦˨
ပရုၵ်ႈ	p a ˨˦ r u k̚ ˧˧˨
ပလွင်ႈ	p a ˨˦ l ɔ ŋ ˧˧˨
ပဢူဝ်	p a ˨˦ ʔ oː ˨˦
ပဢူဝ်း	p a ˨˦ ʔ oː ˥
ပိတ်ႈတၵၢတ်ႈ	p i t̚ ˧˧˨ t a ˨˦ k aː t̚ ˧˧˨
ပိၵ်ႈမၢၼ်ႇ	p i k̚ ˧˧˨ m aː n ˩
ပီႉတၵၢတ်ႈ	p iː ˦˨ˀ t a ˨˦ k aː t̚ ˧˧˨
ပုင်ႇ	p u ŋ ˩
ပုင်ႇၵၢၼ်ႇ	p u ŋ ˩ k aː n ˩
ပုၵ်ႉထဝၢင်ႇ	p u k̚ ˦˨ˀ tʰ a ˨˦ w aː ŋ ˩
ပုၵ်ႉထႃႉၽႃႇသႃႇ	p u k̚ ˦˨ˀ tʰ aː ˦˨ˀ pʰ aː ˩ sʰ aː ˩
ပူၼ်ႉပႅၼ်	p o n ˦˨ˀ p ɛ n ˨˦
ပူႇ	p uː ˩
ပူႇၵၢင်ႉ	p uː ˩ k aː ŋ ˦˨
ပူႇၵႄႇ	p uː ˩ k ɛː ˩
ပူႉထူဝ်း	p uː ˦˨ˀ tʰ oː ˥
ပေႃႈ	p ɔː ˧˧˨
ပဵၼ်	p e n ˨˦
ပျၢတ်ႈသၢတ်ႈ	p j aː t̚ ˧˧˨ sʰ aː t̚ ˧˧˨
ပျႃႇတႃႇ	p j aː ˩ t aː ˩
ပွင်ႇၸႂ်	p ɔ ŋ ˩ t͡ɕ a ɰ ˨˦
ပွတ်းႁွင်ႇ	p ɔ t̚ ˥ h ɔ ŋ ˩
ပၢင်တိုၵ်း	p aː ŋ ˨˦ t ɯ k̚ ˥
ပၢၼ်းသေး	p aː n ˥ sʰ eː ˥
ပၢႆးမၢၵ်ႈမီး	p aː j ˥ m aː k̚ ˧˧˨ m iː ˥
ပၼ်ၵတိ	p a n ˨˦ k a ˨˦ t i ˨˦
ပၼ်ႁႅင်း	p a n ˨˦ h ɛ ŋ ˥
ပႃႇတီႇ	p aː ˩ t iː ˩
ပႃႈ	p aː ˧˧˨
ပႅတ်ႇ	p ɛ t̚ ˩
ပႆ	p a j ˨˦
မလႅင်ႇ	m a ˨˦ l ɛ ŋ ˩
မိုၼ်ႇ	m ɯ n ˩
မိူင်းမၢၼ်ႈ	m ɤ ŋ ˥ m aː n ˧˧˨
မိူင်းယူၼ်း	m ɤ ŋ ˥ j o n ˥
မိူင်းလၢဝ်း	m ɤ ŋ ˥ l aː w ˥
မိူင်းဢမေႇရီႉၵႃႉ	m ɤ ŋ ˥ ʔ a ˨˦ m eː ˩ r iː ˦˨ˀ k aː ˦˨
မိူင်းဢိင်ႇတီႉယႃႉ	m ɤ ŋ ˥ ʔ i ŋ ˩ t iː ˦˨ˀ j aː ˦˨
မိူင်းဢိင်ႇၵလၼ်ႇ	m ɤ ŋ ˥ ʔ i ŋ ˩ k a ˨˦ l a n ˩
မိူင်းၵလႃး	m ɤ ŋ ˥ k a ˨˦ l aː ˥
မိူင်းၵွၵ်ႇ	m ɤ ŋ ˥ k ɔ k̚ ˩
မိူင်းၽီးလၢတ်ႈ	m ɤ ŋ ˥ pʰ iː ˥ l aː t̚ ˧˧˨
မိူင်းႀမတႃႉ	m ɤ ŋ ˥ θ a ˨˦ m a ˨˦ t aː ˦˨
မိူဝ်ႈလႂ်သေဢမ်ႇဝႃႈ	m ɤː ˧˧˨ l a ɰ ˨˦ sʰ eː ˨˦ ʔ a m ˩ w aː ˧˧˨
မိူဝ်ႈၵႆႈ	m ɤː ˧˧˨ k a j ˧˧˨
မိူဝ်ႈၼႃႈထႃႇလိုၼ်း	m ɤː ˧˧˨ n aː ˧˧˨ tʰ aː ˩ l ɯ n ˥
မိူၵ်ႈ	m ɤ k̚ ˧˧˨
မိူၼ်	m ɤ n ˨˦
မီ	m iː ˨˦
မီးပၢၼ်း	m iː ˥ p aː n ˥
မီးယၢပ်ႈ	m iː ˥ j aː p̚ ˧˧˨
မုၵ်ႈ	m u k̚ ˧˧˨
မုၼ်း	m u n ˥
မုၼ်ၸဝ်ႈ	m u n ˨˦ t͡ɕ a w ˧˧˨
မုၼ်ၸဝ်ႈပူပ်ႉ	m u n ˨˦ t͡ɕ a w ˧˧˨ p o p̚ ˦˨
မူးသိူဝ်း	m uː ˥ sʰ ɤː ˥
မေႃယႃ	m ɔː ˨˦ j aː ˨˦
မေႃၽီ	m ɔː ˨˦ pʰ iː ˨˦
မေႇ	m eː ˩
မဵဝ်း	m e w ˥
မဵၼ်ႈ	m e n ˧˧˨
မွၼ်	m ɔ n ˨˦
မွၼ်း	m ɔ n ˥
မၢတ်ႉၶျ်	m aː t̚ ˦˨ˀ t͡ʃ
မၢဝ်း	m aː w ˥
မၢၵ်ႇ	m aː k̚ ˩
မၢၵ်ႇမူင်ႈ	m aː k̚ ˩ m o ŋ ˧˧˨
မၢၵ်ႇၼင်	m aː k̚ ˩ n a ŋ ˨˦
မၢၼ်ႈထၼူႉ	m aː n ˧˧˨ tʰ a ˨˦ n uː ˦˨
မၢၼ်ႈမႅင်း	m aː n ˧˧˨ m ɛ ŋ ˥
မၢၼ်ႈဢၢင်းလေး	m aː n ˧˧˨ ʔ aː ŋ ˥ l eː ˥
မၢၼ်ႈၼွင်	m aː n ˧˧˨ n ɔ ŋ ˨˦
မၢၼ်ႈႁၢႆးယႃႈ	m aː n ˧˧˨ h aː j ˥ j aː ˧˧˨
မႁႃႇသႃႇဝၵႃႉ	m a ˨˦ h aː ˩ sʰ aː ˩ w a ˨˦ k aː ˦˨
မႂ်	m a ɰ ˨˦
မႂ်း	m a ɰ ˥
မႃ	m aː ˨˦
မႃး	m aː ˥
မႃႇၼၢတ်ႈ	m aː ˩ n aː t̚ ˧˧˨
မႃႉ	m aː ˦˨
မႃႉၼမ်ႉ	m aː ˦˨ˀ n a m ˦˨
မႅဝ်း	m ɛ w ˥
မႅၵ်ႈၵၸိၼ်း	m ɛ k̚ ˧˧˨ k a ˨˦ t͡ɕ i n ˥
ယဝ်ႉ	j a w ˦˨
ယိပ်း	j i p̚ ˥
ယုင်း	j u ŋ ˥
ယူဝ်ႇ	j oː ˩
ယူၼ်း	j o n ˥
ယဵပ်ႉ	j e p̚ ˦˨
ယဵၼ်ႇ	j e n ˩
ယွၵ်ႈလိၼ်ႉပိၼ်ႈတႃ	j ɔ k̚ ˧˧˨ l i n ˦˨ˀ p i n ˧˧˨ t aː ˨˦
ယၢပ်ႇၽိုတ်ႇ	j aː p̚ ˩ pʰ ɯ t̚ ˩
ယၢမ်း	j aː m ˥
ယၢၼ်ႇသူႇ	j aː n ˩ sʰ uː ˩
ယၶႅင်ႇ	j a ˨˦ kʰ ɛ ŋ ˩
ယႃ	j aː ˨˦
ယႅၵ်ႉ	j ɛ k̚ ˦˨
ရေႃးၵႃႇ	r ɔː ˥ k aː ˩
ရၢၼ်ႇသူႇ	r aː n ˩ sʰ uː ˩
ရၶႅင်ႇ	r a ˨˦ kʰ ɛ ŋ ˩
ရႁၢၼ်း	r a ˨˦ h aː n ˥
ရႃႇဝၢင်ႇ	r aː ˩ w aː ŋ ˩
လပ်း	l a p̚ ˥
လမ်	l a m ˨˦
လိင်း	l i ŋ ˥
လိုမ်း	l ɯ m ˥
လိုၵ်ႉ	l ɯ k̚ ˦˨
လိူင်	l ɤ ŋ ˨˦
လိူၵ်ႈ	l ɤ k̚ ˧˧˨
လိူၼ်	l ɤ n ˨˦
လိၵ်ႈတႆး	l i k̚ ˧˧˨ t a j ˥
လိၼ်	l i n ˨˦
လုတ်ႈတေႃႇ	l u t̚ ˧˧˨ t ɔː ˩
လုမ်ႈၽႃႉ	l u m ˧˧˨ pʰ aː ˦˨
လုၵ်ႈႁဵၼ်း	l u k̚ ˧˧˨ h e n ˥
လုၵ်ႉ	l u k̚ ˦˨
လူင်း	l o ŋ ˥
လူမ်း	l o m ˥
လွင်း	l ɔ ŋ ˥
လွင်ႈလုၵ်ႉၽိုၼ်ႉ	l ɔ ŋ ˧˧ l u k ˥˩ pʰ ɯ n ˥˩
လွင်ႈၵိင်း	l ɔ ŋ ˧˧˨ k i ŋ ˥
လွင်ႈၵိုဝ်တႃ	l ɔ ŋ ˧˧˨ k ɯː ˨˦ t aː ˨˦
လွင်ႈၵိၼ်ႁႅင်း	k i n ˨˦ h ɛ ŋ ˥
လွင်ႈၵိၼ်ႇလႃႇ	l ɔ ŋ ˧˧˨ k i n ˩ l aː ˩
လွင်ႈၵူင်ႇ	l ɔ ŋ ˧˧˨ k o ŋ ˩
လွင်ႈၵႅမ်	l ɔ ŋ ˧˧˨ k ɛ m ˨˦
လွင်ႈၶီႈဢႄႇ	l ɔ ŋ ˧˧˨ kʰ iː ˧˧˨ ʔ ɛː ˩
လွင်ႈၶူင်ႉဝႆႉလူင်ႉၵူင်ႉ	l ɔ ŋ ˧˧˨ kʰ o ŋ ˦˨ˀ w a j ˦˨ˀ l o ŋ ˦˨ˀ k o ŋ ˦˨
လွင်ႈၶႃႉ	l ɔ ŋ ˧˧˨ kʰ aː ˦˨
လွႆ	l ɔ j ˨˦
လၢင်းတႃႉ	l aː ŋ ˥ t aː ˦˨
လၢတ်ႈၵႂၢမ်းၵၵ်း	l aː t̚ ˧˧˨ k w aː m ˥ k a k̚ ˥
လၢဝ်	l aː w ˨˦
လၢၵ်ႈထၢပ်ႈ	l aː k̚ ˧˧˨ tʰ aː p̚ ˧˧˨
လၢၵ်ႈသွင်ႇ	l aː k̚ ˧˧˨ sʰ ɔ ŋ ˩
လၢၵ်ႈၸွပ်ႈ	l aː k̚ ˧˧˨ t͡ɕ ɔ p̚ ˧˧˨
လၢၵ်ႈၼၢၵ်ႈ	l aː k̚ ˧˧˨ n aː k̚ ˧˧˨
လၢၵ်ႈၽွႆး	l aː k̚ ˧˧˨ pʰ ɔ j ˥
လၢၵ်ႈၽွႆႉ	l aː k̚ ˧˧˨ pʰ ɔ j ˦˨
လၢၼ်ႉၸဝ်ႈ	l aː n ˦˨ˀ t͡ɕ a w ˧˧˨
လၵ်းထၢၼ်	l a k̚ ˥ tʰ aː n ˨˦
လႄႈ	l ɛː ˧˧˨
လႅင်	l ɛ ŋ ˨˦
လႅၵ်ႈလၢႆႈ	l ɛ k̚ ˧˧˨ l aː j ˧˧˨
လႆ	l a j ˨˦
ဝီႇၶီႇၽီးတီးယႃး	w ì i
ဝီႉၺဵၼ်ႇ	w iː ˦˨ˀ ɲ e n ˩
ဝုတ်ႉထူႉ	w u t̚ ˦˨
ဝုၼ်ႇၵျီးၶျုၵ်ႈ	w u n ˩ d͡ʒ iː ˥ t͡ʃ u k̚ ˧˧˨
ဝၢၼ်ႈ	w aː n ˧˧˨
ဝၢႆ	w aː j ˨˦
ဝၢႆႇ	w aː j ˩
ဝၢႆႉ	w aː j ˦˨
ဝၼ်း	w a n ˥
ဝႂ်ၶၢမ်ႈမိူင်း	w a ɰ ˨˦ kʰ aː m ˧˧˨ m ɤ ŋ ˥
ဝႃႉ	w aː ˦˨
ဝႆ	w a j ˨˦
သတၢင်း	sʰ a ˨˦ t aː ŋ ˥
သပ်ႉပျႃႇ	sʰ a p̚ ˦˨ˀ p j aː ˩
သပျေႇ	sʰ a ˨˦ p j eː ˩
သမ်ႇမၼီႉ	sʰ a m ˩ m a ˨˦ n iː ˦˨
သမႅင်း	sʰ a ˨˦ m ɛ ŋ ˥
သရၽူႇ	sʰ a ˨˦ r a ˨˦ pʰ uː ˩
သိင်းၶူဝ်ႇ	sʰ i ŋ ˥ kʰ oː ˩
သိင်ႇဝႅတ်ႉလွမ်ႉ	sʰ i ŋ ˩ w ɛ t̚ ˦˨ˀ l ɔ m ˦˨
သိပ်း	sʰ i p̚ ˥
သိပ်းပႅတ်ႇ	sʰ i p̚ ˥ p ɛ t̚ ˩
သိပ်းသီႇ	sʰ i p̚ ˥ sʰ iː ˩
သိပ်းသွင်	sʰ i p̚ ˥ sʰ ɔ ŋ ˨˦
သိပ်းသၢမ်	sʰ i p̚ ˥ sʰ aː m ˨˦
သိပ်းဢဵတ်း	sʰ i p̚ ˥ ʔ e t̚ ˥
သိပ်းၸဵတ်း	sʰ i p̚ ˥ t͡ɕ e t̚ ˥
သိပ်းႁႃႈ	sʰ i p̚ ˥ h aː ˧˧˨
သိမ်ႇ	sʰ i m ˩
သိူဝ်	sʰ ɤː ˨˦
သီ	sʰ iː ˨˦
သီလမ်	sʰ iː ˨˦ l a m ˨˦
သီလိူင်သဝ်ႈ	sʰ iː ˨˦ l ɤ ŋ ˨˦ sʰ a w ˧˧˨
သီလိူင်ၼုမ်ႇ	sʰ iː ˨˦ l ɤ ŋ ˨˦ n u m ˩
သီလႅင်	sʰ iː ˨˦ l ɛ ŋ ˨˦
သီၵမ်ႇ	sʰ iː ˨˦ k a m ˩
သီၶဵဝ်	sʰ iː ˨˦ kʰ e w ˨˦
သီၽိူၵ်ႇ	sʰ iː ˨˦ pʰ ɤ k̚ ˩
သီႇ	sʰ iː ˩
သီႇရီႉလင်ႇၵႃႇ	sʰ iː ˩ r iː ˦˨ˀ l a ŋ ˩ k aː ˩
သီႇႁူဝ်ႇ	sʰ iː ˩ h oː ˩
သုင်	sʰ u ŋ ˨˦
သူင်ႇဢွၵ်ႇ	sʰ o ŋ ˩ ʔ ɔ k̚ ˩
သူမ်ႈပူ	sʰ o m ˧˧˨ p uː ˨˦
သူးၵွၵ်း	sʰ uː ˥ k ɔ k̚ ˥
သူၼ်သတ်း	sʰ o n ˨˦ sʰ a t̚ ˥
သေးယူင်ႇ	sʰ eː ˥ j o ŋ ˩
သေးလိၵ်ႉ	sʰ eː ˥ l i k̚ ˦˨
သဵင်	sʰ e ŋ ˨˦
သဵၼ်ႈ	sʰ e n ˧˧˨
သြႃႇတေႃႇ	sʰ r aː ˩ t ɔː ˩
သြႃႇဝုၼ်ႇ	sʰ r aː ˩ w u n ˩
သွင်	sʰ ɔ ŋ ˨˦
သွမ်း	sʰ ɔ m ˥
သွၵ်ႉၵျႃႇ	sʰ ɔ k̚ ˦˨ˀ k j aː ˩
သွၼ်	sʰ ɔ n ˨˦
သၢင်ႇဝၢင်ႇ	sʰ aː ŋ ˩ w aː ŋ ˩
သၢင်ႇသီႈ	sʰ aː ŋ ˩ sʰ iː ˧˧˨
သၢမ်	sʰ aː m ˨˦
သၢမ်လႅမ်ထွင်းၶမ်း	sʰ aː m ˨˦ l ɛ m ˨˦ tʰ ɔ ŋ ˥ kʰ a m ˥
သၢမ်ၸဵင်ႇ	sʰ aː m ˨˦ t͡ɕ e ŋ ˩
သၢဝ်း	sʰ aː w ˥
သၢဝ်းသွင်	sʰ aː w ˥ sʰ ɔ ŋ ˨˦
သၢဝ်းဢဵတ်း	sʰ aː w ˥ ʔ e t̚ ˥
သၢၵ်ႇသေ	sʰ aː k̚ ˩ sʰ eː ˨˦
သၢၵ်ႈ	sʰ aː k̚ ˧˧˨
သၢၵ်ႈသႃႇ	sʰ aː k̚ ˧˧˨ sʰ aː ˩
သၢႆး	sʰ aː j ˥
သၵျႃး	sʰ a ˨˦ k j aː ˥
သၼၢပ်ႈၶႃး	sʰ a ˨˦ n aː p̚ ˧˧˨ kʰ aː ˥
သႃႇထူႉ	sʰ aː ˩ tʰ uː ˦˨
သႃႇဝၵႃႉ	sʰ aː ˩ w a ˨˦ k aː ˦˨
သႅင်	sʰ ɛ ŋ ˨˦
သႅင်ႇ	sʰ ɛ ŋ ˩
သႅပ်ႇထႅမ်ႇပႃႇ	sʰ ɛ p̚ ˩ tʰ ɛ m ˩ p aː ˩
သႅၼ်	sʰ ɛ n ˨˦
ဢင်းၵိတ်ႉ	ʔ a ŋ ˥ k i t̚ ˦˨
ဢင်ႇၵႃႇ	ʔ a ŋ ˩ k aː ˩
ဢတူဝ်း	ʔ a ˨˦ t oː ˥
ဢတႂၢၵ်ႈ	ʔ a ˨˦ t w aː k̚ ˧˧˨
ဢပုမ်ႇ	ʔ a ˧˧˨ p u m ˩
ဢမိင်ႉ	ʔ a ˨˦ m i ŋ ˦˨
ဢမူၺ်ႇ	ʔ a ˨˦ m o j ˩
ဢမျွၵ်ႈ	ʔ a ˨˦ m j ɔ k̚ ˧˧˨
ဢမျၢၵ်ႈ	ʔ a ˨˦ m j aː k̚ ˧˧˨
ဢယူႇ	ʔ a ˨˦ j uː ˩
ဢလူဝ်ႇ	ʔ a ˨˦ l oː ˩
ဢလွင်း	ʔ a ˨˦ l ɔ ŋ ˥
ဢသၢၵ်ႈ	ʔ a ˧˧˨ sʰ aː k̚ ˧˧˨
ဢိင်းၵလဵတ်ႈ	ʔ i ŋ ˥ k a ˨˦ l e t̚ ˧˧˨
ဢုပ်ႇဢူဝ်း	ʔ u p̚ ˩ ʔ oː ˥
ဢုပ်ႉ	ʔ u p̚ ˦˨
ဢုပ်ႉပိူင်ႇ	ʔ u p̚ ˦˨ˀ p ɤ ŋ ˩
ဢုၼ်	ʔ u n ˨˦
ဢူၺ်းလီ	ʔ o j ˥ l iː ˨˦
ဢေႃႇၸတြေးလီးယိူဝ်း	ʔ ɔː ˩ t͡ɕ a ˨˦ t r eː ˥ l iː ˥ j ɤː ˥
ဢေႇ	ʔ eː ˩
ဢေႇပရႄႇ	ʔ eː ˩ p a ˨˦ r ɛː ˩
ဢဵတ်ႇ	ʔ e t̚ ˩
ဢွၵ်ႇထူဝ်ႇပႃႇ	ʔ ɔ k̚ ˩ tʰ oː ˩ p aː ˩
ဢၢင်း	ʔ aː ŋ ˥
ဢၢင်ႇ	ʔ aː ŋ ˩
ဢၢၼ်ႇ	ʔ aː n ˩
ဢၵွၵ်ႈ	ʔ a ˨˦ k ɔ k̚ ˧˧˨
ဢၽီႉထမ်ႇမႃႇ	ʔ a ˨˦ pʰ iː ˦˨ˀ tʰ a m ˩ m aː ˩
ဢႃးၶႃး	ʔ aː ˥ kʰ aː ˥
ဢႃးၼႃႇ	ʔ aː ˥ n aː ˩
ဢႃႇပေႃႇ	ʔ aː ˩ p ɔː ˩
ဢႃႇၵႃႇသႃႉ	ʔ aː ˩ k aː ˩ sʰ aː ˦˨
ဢႅဝ်	ʔ ɛ w ˨˦
ဢႅၵ်ႉၶရႃႇ	ʔ ɛ k̚ ˦˨ˀ kʰ a ˨˦ r aː ˩
ၵတိ	k a ˨˦ t i ˨˦
ၵတိမၼ်ႈ	k a ˨˦ t i ˨˦ m a n ˧˧˨
ၵတိသဵတ်ႉၸႃႇ	k a ˨˦ t i ˨˦ sʰ e t̚ ˦˨ˀ t͡ɕ aː ˩
ၵတ်ႉၶႅၼ်ႇ	k a t̚ ˦˨ˀ kʰ ɛ n ˩
ၵတၢၵ်း	k a ˨˦ t aː k̚ ˥
ၵရမ်ႇ	k a ˨˦ r a m ˩
ၵရဝေႇ	k a ˨˦ r a ˨˦ w eː ˩
ၵရိယႃႇ	k a ˨˦ r i ˨˦ j aː ˩
ၵလပ်ႉ	k a ˨˦ l a p̚ ˦˨
ၵလွင်ႇ	k a ˨˦ l ɔ ŋ ˩
ၵလၢင်ႇ	k a ˨˦ l aː ŋ ˩
ၵလႃး	k a ˨˦ l aː ˥
ၵလႃးဢူၵ်ႉ	k a ˨˦ l aː ˥ ʔ o k̚ ˦˨
ၵဝိ	k a ˨˦ w i ˨˦
ၵဝ်ႈ	k a w ˧˧˨
ၵဝ်ႈၶူၼ်ႁူဝ်	k a w ˧˧˨ kʰ o n ˨˦ h oː ˨˦
ၵသေး	k a ˨˦ sʰ eː ˥
ၵိင်း	k i ŋ ˥
ၵိင်ႇ	k i ŋ ˩
ၵိင်ႇမႆႉ	k i ŋ ˩ m a j ˦˨
ၵိင်ႇလူင်	k i ŋ ˩ l o ŋ ˨˦
ၵိင်ႇၵွႆႈ	k i ŋ ˩ k ɔ j ˧˧˨
ၵိင်ႈ	k i ŋ ˧˧˨
ၵိင်ႈတူၵ်း	k i ŋ ˧˧˨ t o k̚ ˨˦
ၵိင်ႈၵိူၵ်ႇ	k i ŋ ˧˧˨ k ɤ k̚ ˩
ၵိရိယႃႇ	k i ˨˦ r i ˨˦ j aː ˩
ၵိလေႇသႃႇ	k i ˨˦ l eː ˩ sʰ aː ˩
ၵိုင်ႇၵႃႈ	k ɯ ŋ ˩ k aː ˧˧˨
ၵိုတ်ႉလႆႈ	k ɯ t̚ ˦˨ˀ l a j ˧˧˨
ၵိုတ်ႉၽိူဝ်ႇပိူၼ်ႈ	k ɯ t̚ ˦˨ˀ pʰ ɤː ˩ p ɤ n ˧˧˨
ၵိုၵ်းပႃး	k ɯ k̚ ˥ p aː ˥
ၵိုၵ်းဝၢၼ်ႈၵိုၵ်းမိူင်း	k ɯ k̚ ˥ w aː n ˧˧˨ k ɯ k̚ ˥ m ɤ ŋ ˥
ၵိူင်းထွၵ်ႈ	k ɤ ŋ ˥ tʰ ɔ k̚ ˧˧˨
ၵိူင်းဢုပ်ႉ	k ɤ ŋ ˥ ʔ u p̚ ˦˨
ၵိူင်းၵႂႃႇၵိူင်းၶိုၼ်း	k ɤ ŋ ˥ k w aː ˩ k ɤ ŋ ˥ kʰ ɯ n ˥
ၵိူင်းၶျုၵ်ႈ	k ɤ ŋ ˥ kʰ j u k̚ ˧˧˨
ၵိူဝ်	k ɤː ˨˦
ၵိူဝ်ဝၢၼ်	k ɤː ˨˦ w aː n ˨˦
ၵိၼ်	k i n ˨˦
ၵိၼ်လူင်ၸၢႆႇလူင်	k i n ˨˦ l o ŋ ˨˦ t͡ɕ aː j ˩ l o ŋ ˨˦
ၵိၼ်ဢိမ်ႇၵိၼ်ဝၢၼ်	k i n ˨˦ ʔ i m ˩ k i n ˨˦ w aː n ˨˦
ၵိၼ်းၸႂ်	k i n ˥ t͡ɕ a ɰ ˨˦
ၵိၼ်ၵႅၼ်း	k i n ˨˦ k ɛ n ˥
ၵီႇ	k iː ˩
ၵီႇယႃႇ	k iː ˩ j aː ˩
ၵီႇလူဝ်ႇ	k iː ˩ l oː ˩
ၵီႇလူဝ်ႇမီႇတႃႇ	k iː ˩ l oː ˩ m iː ˩ t aː ˩
ၵီႇလူဝ်ႇၵရမ်ႇ	k iː ˩ l oː ˩ k a ˨˦ r a m ˩
ၵီႈ	k iː ˧˧˨
ၵုင်းလွႆ	k u ŋ ˥ l ɔ j ˨˦
ၵုင်ႇ	k u ŋ ˩
ၵုင်ႇတၢင်ႇ	k u ŋ ˩ t aː ŋ ˩
ၵုင်ႇၵုၼ်း	k u ŋ ˩ k u n ˥
ၵုင်ႇၶိုၼ်ႈ	k u ŋ ˩ kʰ ɯ n ˧˧˨
ၵုင်ႈ	k u ŋ ˧˧˨
ၵုင်ႈသူမ်ႈ	k u ŋ ˧˧˨ sʰ o m ˧˧˨
ၵုင်ႈႁႅင်ႈ	k u ŋ ˧˧˨ h ɛ ŋ ˧˧˨
ၵုမ်ႈ	k u m ˧˧˨
ၵုသူဝ်ႇ	k u ˨˦ sʰ oː ˩
ၵုၵ်ႈ	k u k̚ ˧˧˨
ၵုၵ်ႈမႃႉ	k u k̚ ˧˧˨ m aː ˦˨
ၵုၵ်ႉတေႇ	k u k̚ ˦˨ˀ t eː ˩
ၵုၵ်ႉၵီႈၵုၵ်ႉၵၵ်ႉ	k u k̚ ˦˨ˀ k iː ˧˧˨ k u k̚ ˦˨ˀ k a k̚ ˦˨
ၵုၺ်ၶွၼ်ႇ	k u j ˨˦ kʰ ɔ n ˩
ၵုၺ်ႉၽုၺ်ႇ	k u j ˦˨ˀ pʰ u j ˩
ၵူင်	k o ŋ ˨˦
ၵူင်တွင်ႉ	k o ŋ ˨˦ t ɔ ŋ ˦˨
ၵူင်လွႆ	k o ŋ ˨˦ l ɔ j ˨˦
ၵူင်း	k o ŋ ˥
ၵူင်းငိုၼ်း	k o ŋ ˥ ŋ ɯ n ˥
ၵူင်းၵႂၵ်း	k o ŋ ˥ k w a k̚ ˥
ၵူင်းၼမ်ႉ	k o ŋ ˥ n a m ˦˨
ၵူင်းႁူတ်း	k o ŋ ˥ h o t̚ ˥
ၵူင်ၵူင်	k o ŋ ˨˦ k o ŋ ˨˦
ၵူင်ၵွၼ်	k o ŋ ˨˦ k ɔ n ˨˦
ၵူင်ၵႂၼ်းၾႆး	k o ŋ ˨˦ k w a n ˥ f a j ˥
ၵူင်ၶေႃး	k o ŋ ˨˦ kʰ ɔː ˥
ၵူင်ႁူၺ်ႈ	k o ŋ ˨˦ h o j ˧˧˨
ၵူင်ႇ	k o ŋ ˩
ၵူင်ႇၵၢဝ်	k o ŋ ˩ k aː w ˨˦
ၵူင်ႇၵၢဝ်မီ	k o ŋ ˩ k aː w ˨˦ m iː ˨˦
ၵူင်ႇၵၢဝ်ၵၢင်ယႂ်း	k o ŋ ˩ k aː w ˨˦ k aː ŋ ˨˦ j a ɰ ˥
ၵူင်ႉ	k o ŋ ˦˨
ၵူပ်း	k o p̚ ˥
ၵူဝ်း	k oː ˥
ၵူဝ်ႇၵဵၼ်း	k oː ˩ k e n ˥
ၵူး	k uː ˥
ၵူးၶႅပ်းႁၢင်ႈ	k uː ˥ kʰ ɛ p̚ ˥ h aː ŋ ˧˧˨
ၵူၺ်ႇလဵၵ်း	k o j ˩ l e k̚ ˥
ၵူၺ်ႈ	k o j ˧˧˨
ၵူၼ်းငိူဝ်ႈ	k o n ˥ ŋ ɤː ˧˧˨
ၵူၼ်းတႅမ်ႈလိၵ်ႈ	k o n ˥ t ɛ m ˧˧˨ l i k̚ ˧˧˨
ၵူၼ်းထိင်းၼၢင်း	k o n ˥ tʰ i ŋ ˥ n aː ŋ ˥
ၵူၼ်းပႅတ်ႈလၢႆ	k o n ˥ p ɛ t̚ ˧˧˨ l aː j ˨˦
ၵူၼ်းမိူင်း	k o n ˥ m ɤ ŋ ˥
ၵူၼ်းသူၺ်းသႅင်	k o n ˥ sʰ o j ˥ sʰ ɛ ŋ ˨˦
ၵူၼ်းဢမ်ႇၶွပ်ႇဢမ်ႇၵၢင်	k o n ˥ ʔ a m ˩ kʰ ɔ p̚ ˩ ʔ a m ˩ k aː ŋ ˨˦
ၵူၼ်းၵတ်ႉ	k o n ˥ k a t̚ ˦˨
ၵူၼ်းၵုမ်း	k o n ˥ k u m ˥
ၵူၼ်းၵူႈငိုၼ်း	k o n ˥ k uː ˧˧˨ ŋ ɯ n ˥
ၵူၼ်းၵျၢမ်း	k o n ˥ d͡ʑ aː m ˥
ၵူၼ်းၶုတ်းတတ်ႉထူႉ	k o n ˥ kʰ u t̚ ˥ t a t̚ ˦˨ˀ tʰ uː ˦˨
ၵူၼ်းၶုတ်းမေႃႇ	k o n ˥ kʰ u t̚ ˥ m ɔː ˩
ၵူၼ်းၸၢႆးဢွၼ်ႇ	k o n ˥ t͡ɕ aː j ˥ ʔ ɔ n ˩
ၵူၼ်းၼႃႈလိူမ်ႈ	k o n ˥ n aː ˧˧˨ l ɤ m ˧˧˨
ၵူၼ်းႁဵတ်းၵၢၼ်	k o n ˥ h e t̚ ˥ k aː n ˨˦
ၵူၼ်းႁႅင်း	k o n ˥ h ɛ ŋ ˥
ၵူႇ	k uː ˩
ၵူႇတူပ်ႉ	k uː ˩ t o p̚ ˦˨
ၵူႇလိၵ်ႈ	k uː ˩ l i k̚ ˧˧˨
ၵူႇလုၵ်ႈဢွၼ်ႇ	k uː ˩ l u k̚ ˧˧˨ ʔ ɔ n ˩
ၵူႇၼွၼ်းသွင်ၵေႃႉ	k uː ˩ n ɔ n ˥ sʰ ɔ ŋ ˨˦ k ɔː ˦˨
ၵူႈ	k uː ˧˧˨
ၵူႈတီႈၵူႈတၢင်း	k uː ˧˧˨ t iː ˧˧˨ k uː ˧˧˨ t aː ŋ ˥
ၵူႈပွၵ်ႈ	k uː ˧˧˨ p ɔ k̚ ˧˧˨
ၵူႈမိုဝ်ႉၵူႈဝၼ်း	k uː ˧˧˨ m ɯː ˦˨ˀ k uː ˧˧˨ w a n ˥
ၵူႈမိူင်းမိူင်း	k uː ˧˧˨ m ɤ ŋ ˥ m ɤ ŋ ˥
ၵူႈဢၼ်	k uː ˧˧˨ ʔ a n ˨˦
ၵူႈၵေႃႉ	k uː ˧˧˨ k ɔː ˦˨
ၵူႈၶမ်ႈ	k uː ˧˧˨ kʰ a m ˧˧˨
ၵူႈၶိုၼ်း	k uː ˧˧˨ kʰ ɯ n ˥
ၵူႈၶူဝ်း	k uː ˧˧˨ kʰ oː ˥
ၵူႈၸဝ်ႉၼႂ်ဝၼ်းၶမ်ႈ	k uː ˧˧˨ t͡ɕ a w ˦˨ˀ n a ɰ ˨˦ w a n ˥ kʰ a m ˧˧˨
ၵူႈၸိူဝ်ႉၵူႈပိူင်	k uː ˧˧˨ t͡ɕ ɤː ˦˨ˀ k uː ˧˧˨ p ɤ ŋ ˨˦
ၵူႈၸူဝ်ႈၵူႈပၢၼ်	k uː ˧˧˨ t͡ɕ oː ˧˧˨ k uː ˧˧˨ p aː n ˨˦
ၵူႈၼႂ်	k uː ˧˧˨ n a ɰ ˨˦
ၵူႈၽၢႆႇၵူႈတၢင်း	k uː ˧˧˨ pʰ aː j ˩ k uː ˧˧˨ t aː ŋ ˥
ၵူႉလႃႉႀႃႉမႅၵ်ႉၵႃႉ	k uː ˦˨ˀ l aː ˦˨ˀ θ aː ˦˨ˀ m ɛ k̚ ˦˨ˀ k aː ˦˨
ၵေသႃ	k eː ˨˦ sʰ aː ˨˦
ၵေးလၢင်း	k eː ˥ l aː ŋ ˥
ၵေႃပူၵ်းပွင်ၶိုၼ်း	k ɔː ˨˦ p o k̚ ˥ p ɔ ŋ ˨˦ kʰ ɯ n ˥
ၵေႃပွင်ၵၢၼ်	k ɔː ˨˦ p ɔ ŋ ˨˦ k aː n ˨˦
ၵေႃမႆႉ	k ɔː ˨˦ m a j ˦˨
ၵေႃယိူဝ်ႈ	k ɔː ˨˦ j ɤː ˧˧˨
ၵေႃးၸႃႇ	k ɔː ˥ t͡ɕ aː ˩
ၵေႃၵူၺ်ႈ	k ɔː ˨˦ k o j ˧˧˨
ၵေႃၶဝ်ႈ	k ɔː ˨˦ kʰ a w ˧˧˨
ၵေႃၽူႈတၢင်တူဝ်	k ɔː ˨˦ pʰ uː ˧˧˨ t aː ŋ ˨˦ t oː ˨˦
ၵေႃႇတမႃႉ	k ɔː ˩ t a ˨˦ m aː ˦˨
ၵေႃႇမတီႇ	k ɔː ˩ m a ˨˦ t iː ˩
ၵေႃႇၵွင်	k ɔː ˩ k ɔ ŋ ˨˦
ၵေႃႈ	k ɔː ˧˧˨
ၵေႃႈယႃႇ	k ɔː ˧˧˨ j aː ˩
ၵေႃႈယႃႇမၼ်း	k ɔː ˧˧˨ j aː ˩ m a n ˥
ၵေႃႉ	k ɔː ˦˨
ၵေႃႉထုၵ်ႈပၼ်ငိုၼ်း	k ɔː ˦˨ˀ tʰ u k̚ ˧˧˨ p a n ˨˦ ŋ ɯ n ˥
ၵေႃႉထုၵ်ႈလိၵ်ႈ	k ɔː ˦˨ˀ tʰ u k̚ ˧˧˨ l i k̚ ˧˧˨
ၵေႃႉမိုတ်ႈၵေႃႉၵိုဝ်း	k ɔː ˦˨ˀ m ɯ t̚ ˧˧˨ k ɔː ˦˨ˀ k ɯː ˥
ၵေႃႉမိုဝ်ႉ	k ɔː ˦˨ˀ m ɯː ˦˨
ၵေႃႉမၢႆ	k ɔː ˦˨ˀ m aː j ˨˦
ၵေႃႉမၼ်ႈမၢႆ	k ɔː ˦˨ˀ m a n ˧˧˨ m aː j ˨˦
ၵေႃႉလဵဝ်	k ɔː ˦˨ˀ l e w ˨˦
ၵေႃႉလႂ်	k ɔː ˦˨ˀ l a ɰ ˨˦
ၵေႃႉလႂ်ၵေႃႉၼၼ်ႉ	k ɔː ˦˨ˀ l a ɰ ˨˦ k ɔː ˦˨ˀ n a n ˦˨
ၵေႃႉဢၼ်ၶၢမ်ႇတြႃး	k ɔː ˦˨ˀ ʔ a n ˨˦ kʰ aː m ˩ t r aː ˥
ၵေႃႉဢၼ်ႁဵတ်းတြႃး	k ɔː ˦˨ˀ ʔ a n ˨˦ h e t̚ ˥ t r aː ˥
ၵေႃႉၵၼ်	k ɔː ˦˨ˀ k a n ˨˦
ၵေႃႉၶၢမ်ႇဢမူၺ်ႇ	k ɔː ˦˨ˀ kʰ aː m ˩ ʔ a ˨˦ m o j ˩
ၵေႃႉၼၼ်ႉ	k ɔː ˦˨ˀ n a n ˦˨
ၵေႃႉၼႆႉ	k ɔː ˦˨ˀ n a j ˦˨
ၵေႃႉႁပ်ႉ	k ɔː ˦˨ˀ h a p̚ ˦˨
ၵေႃႉႁူႉၵေႃႉမိုတ်ႈ	k ɔː ˦˨ˀ h uː ˦˨ˀ k ɔː ˦˨ˀ m ɯ t̚ ˧˧˨
ၵေႃႉႁူႉၵေႃႉႁၼ်	k ɔː ˦˨ˀ h uː ˦˨ˀ k ɔː ˦˨ˀ h a n ˨˦
ၵေႃႉႁူႉၸၵ်း	k ɔː ˦˨ˀ h uː ˦˨ˀ t͡ɕ a k̚ ˥
ၵေႃႉႁၵ်ႉ	k ɔː ˦˨ˀ h a k̚ ˦˨
ၵေႇ	k eː ˩
ၵဵင်း	k e ŋ ˥
ၵဵင်းသၢမ်ၶႃ	k e ŋ ˥ sʰ aː m ˨˦ kʰ aː ˨˦
ၵဵင်ႈ	k e ŋ ˧˧˨
ၵဵင်ႈၵဵင်ႈ	k e ŋ ˧˧˨ k e ŋ ˧˧˨
ၵဵဝ်	k e w ˨˦
ၵဵဝ်ႈၵၢဝ်ႈ	k e w ˧˧˨ k aː w ˧˧˨
ၵျုၼ်ႇ	d͡ʒ u n ˩
ၵျူဝ်ႇ	k j oː ˩
ၵျူႇလၢႆႇ	d͡ʒ uː ˩ l aː j ˩
ၵျေႃင်း	k j ɔː ŋ ˥
ၵျွင်း	k j ɔ ŋ ˥
ၵျွၵ်ႈတၢၼ်ႇ	d͡ʑ ɔ k̚ ˧˧˨ t aː n ˩
ၵျႃႇသၢၼ်ႇ	k j aː ˩ sʰ aː n ˩
ၵွင်	k ɔ ŋ ˨˦
ၵွင်လင်	k ɔ ŋ ˨˦ l a ŋ ˨˦
ၵွင်လေႃး	k ɔ ŋ ˨˦ l ɔː ˥
ၵွင်းလင်	k ɔ ŋ ˥ l a ŋ ˨˦
ၵွင်ၶိုၼ်ႈ	k ɔ ŋ ˨˦ kʰ ɯ n ˧˧˨
ၵွင်ႇ	k ɔ ŋ ˩
ၵွင်ႇတၢင်း	k ɔ ŋ ˩ t aː ŋ ˥
ၵွင်ႇၵေႃႈ	k ɔ ŋ ˩ k ɔː ˧˧˨
ၵွင်ႇၸီႇ	k ɔ ŋ ˩ t͡ɕ iː ˩
ၵွင်ႈ	k ɔ ŋ ˧˧˨
ၵွင်ႈတွပ်း	k ɔ ŋ ˧˧˨ t ɔ p̚ ˥
ၵွင်ႈပွတ်း	k ɔ ŋ ˧˧˨ p ɔ t̚ ˥
ၵွင်ႈယိုဝ်းၶိူင်ႈမိၼ်	k ɔ ŋ ˧˧˨ j ɯː ˥ kʰ ɤ ŋ ˧˧˨ m i n ˨˦
ၵွင်ႈသုပ်းႁွၵ်ႇ	k ɔ ŋ ˧˧˨ sʰ u p̚ ˥ h ɔ k̚ ˩
ၵွင်ႈၵၢင်ႇ	k ɔ ŋ ˧˧˨ k aː ŋ ˩
ၵွင်ႈၸၢၵ်ႈ	k ɔ ŋ ˧˧˨ t͡ɕ aː k̚ ˧˧˨
ၵွင်ႈၾႆး	k ɔ ŋ ˧˧˨ f a j ˥
ၵွင်ႈၾႆးမႃႉ	k ɔ ŋ ˧˧˨ f a j ˥ m aː ˦˨
ၵွင်ႈၾႆးယၢဝ်း	k ɔ ŋ ˧˧˨ f a j ˥ j aː w ˥
ၵွင်ႈၾႆးယႃႈ	k ɔ ŋ ˧˧˨ f a j ˥ j aː ˧˧˨
ၵွတ်ႇ	k ɔ t̚ ˩
ၵွပ်ႈၸေး	k ɔ p̚ ˧˧˨ t͡ɕ eː ˥
ၵွၵ်း	k ɔ k̚ ˥
ၵွၵ်းငိုၼ်း	k ɔ k̚ ˥ ŋ ɯ n ˥
ၵွၵ်းတွင်းလိူင်	k ɔ k̚ ˥ t ɔ ŋ ˥ l ɤ ŋ ˨˦
ၵွၵ်းတွင်းလႅင်	k ɔ k̚ ˥ t ɔ ŋ ˥ l ɛ ŋ ˨˦
ၵွၵ်းထူမ်ႇ	k ɔ k̚ ˥ tʰ o m ˩
ၵွၵ်းပိူၵ်ႇ	k ɔ k̚ ˥ p ɤ k̚ ˩
ၵွၵ်းမၢၵ်ႇဢုၼ်	k ɔ k̚ ˥ m aː k̚ ˩ ʔ u n ˨˦
ၵွၵ်းလိၼ်	k ɔ k̚ ˥ l i n ˨˦
ၵွၵ်းလဵၵ်း	k ɔ k̚ ˥ l e k̚ ˥
ၵွၵ်းလဵၵ်းၽိူၵ်ႇ	k ɔ k̚ ˥ l e k̚ ˥ pʰ ɤ k̚ ˩
ၵွၵ်းသုၵ်ႈမိုဝ်း	k ɔ k̚ ˥ sʰ u k̚ ˧˧˨ m ɯː ˥
ၵွၵ်းသႅင်	k ɔ k̚ ˥ sʰ ɛ ŋ ˨˦
ၵွၵ်းၵိၼ်ၼမ်ႉ	k ɔ k̚ ˥ k i n ˨˦ n a m ˦˨
ၵွၵ်းၶမ်း	k ɔ k̚ ˥ kʰ a m ˥
ၵွၵ်းၼမ်ႉ	k ɔ k̚ ˥ n a m ˦˨
ၵွၵ်းၼမ်ႉမိုၵ်ႉ	k ɔ k̚ ˥ n a m ˦˨ˀ m ɯ k̚ ˦˨
ၵွၵ်းၽၢၼ်ႇ	k ɔ k̚ ˥ pʰ aː n ˩
ၵွၵ်းၾႆး	k ɔ k̚ ˥ f a j ˥
ၵွၵ်းႁူဝ်	k ɔ k̚ ˥ h oː ˨˦
ၵွၵ်ႇလိူတ်ႈ	k ɔ k̚ ˩ l ɤ t̚ ˧˧˨
ၵွၵ်ႇလၢင်း	k ɔ k̚ ˩ l aː ŋ ˥
ၵွၵ်ႇၵႅၵ်ႇ	k ɔ k̚ ˩ k ɛ k̚ ˩
ၵွၵ်ႇၸဵၵ်ႇ	k ɔ k̚ ˩ t͡ɕ e k̚ ˩
ၵွၵ်ႇႁွင်ႈ	k ɔ k̚ ˩ h ɔ ŋ ˧˧˨
ၵွၵ်ႈ	k ɔ k̚ ˧˧˨
ၵွၼ်းၶေႃ	k ɔ n ˥ kʰ ɔː ˨˦
ၵွၼ်းၽူႈႁၢၼ်	k ɔ n ˥ pʰ uː ˧˧˨ h aː n ˨˦
ၵွၼ်ၸွင်ႈ	k ɔ n ˨˦ t͡ɕ ɔ ŋ ˧˧˨
ၵွၼ်ႈလိၼ်	k ɔ n ˧˧˨ l i n ˨˦
ၵၢင်ဝၼ်းဢွၵ်ႇ	k aː ŋ ˨˦ w a n ˥ ʔ ɔ k̚ ˩
ၵၢင်း	k aː ŋ ˥
ၵၢင်းလွတ်ႈ	k aː ŋ ˥ l ɔ t̚ ˧˧˨
ၵၢင်းၵႆ	k aː ŋ ˥ k a j ˨˦
ၵၢင်ၶိုမ်း	k aː ŋ ˨˦ kʰ ɯ m ˥
ၵၢင်ႁႅဝ်ႉ	k aː ŋ ˨˦ h ɛ w ˦˨
ၵၢင်ႈပႃ	k aː ŋ ˧˧˨ p aː ˨˦
ၵၢင်ႉ	k aː ŋ ˦˨
ၵၢင်ႉပပ်ႉ	k aː ŋ ˦˨ˀ p a p̚ ˦˨
ၵၢင်ႉၵွင်ႈ	k aː ŋ ˦˨ˀ k ɔ ŋ ˧˧˨
ၵၢင်ႉၽိူင်း	k aː ŋ ˦˨ˀ pʰ ɤ ŋ ˥
ၵၢပ်ႇမိူဝ်ႈ	k aː p̚ ˩ m ɤː ˧˧˨
ၵၢပ်ႈ	k aː p̚ ˧˧˨
ၵၢမ်ႇ	k aː m ˩
ၵၢမ်ႇဢမ်ႇလီသေလႄႈ	k aː m ˩ ʔ a m ˩ l iː ˨˦ sʰ eː ˨˦ l ɛː ˧˧˨
ၵၢမ်ႇႁၢႆႉ	k aː m ˩ h aː j ˦˨
ၵၢၵ်ႇငႅမ်ႈ	k aː k̚ ˩ ŋ ɛ m ˧˧˨
ၵၢၵ်ႇမွၵ်း	k aː k̚ ˩ m ɔ k̚ ˥
ၵၢၵ်ႇဝွၵ်း	k aː k̚ ˩ w ɔ k̚ ˥
ၵၢၵ်ႇသေႃး	k aː k̚ ˩ sʰ ɔː ˥
ၵၢၵ်ႇၶွၵ်းၶီႈႁူ	k aː k̚ ˩ kʰ ɔ k̚ ˥ kʰ iː ˧˧˨ h uː ˨˦
ၵၢၼ်	k aː n ˨˦
ၵၵ်း	k a k̚ ˥
ၵၵ်းမိုဝ်းႁွင်ႉ	k a k̚ ˥ m ɯː ˥ h ɔ ŋ ˦˨
ၵၼ်ႁူဝ်	k a n ˨˦ h oː ˨˦
ၵၼၢၼ်း	k a ˨˦ n aː n ˥
ၵႂၢင်	k w aː ŋ ˨˦
ၵႂၢမ်းတႆး	k w aː m ˥ t a j ˥
ၵႂၢႆး	k w aː j ˥
ၵႃ	k aː ˨˦
ၵႃဝၢဝ်ႇ	k aː ˨˦ w aː w ˩
ၵႃသႅဝ်း	k aː ˨˦ sʰ ɛ w ˥
ၵႃဢိုဝ်ႈ	k aː ˨˦ ʔ ɯː ˧˧˨
ၵႃး	k aː ˥
ၵႃးတူႈ	k aː ˥ t uː ˧˧˨
ၵႃးတၢင်ႇယုၵ်းယၵ်း	k aː ˥ t aː ŋ ˩ j u k̚ ˥ j a k̚ ˥
ၵႃးတၢင်ႇၵုၼ်ႇ	k aː ˥ t aː ŋ ˩ k u n ˩
ၵႃးတၢင်ႇၵူၼ်း	k aː ˥ t aː ŋ ˩ k o n ˥
ၵႃးတၢင်ႇၵႃး	k aː ˥ t aː ŋ ˩ k aː ˥
ၵႃးတၢင်ႇၼမ်ႉမၼ်း	k aː ˥ t aː ŋ ˩ n a m ˦˨ˀ m a n ˥
ၵႃးတႅင်ႉ	k aː ˥ t ɛ ŋ ˦˨
ၵႃးထုၺ်လိၼ်	k aː ˥ tʰ u j ˨˦ l i n ˨˦
ၵႃးထႆ	k aː ˥ tʰ a j ˨˦
ၵႃးယုၵ်ႉၶူဝ်း	k aː ˥ j u k̚ ˦˨ˀ kʰ oː ˥
ၵႃးသလုၼ်း	k aː ˥ sʰ a ˨˦ l u n ˥
ၵႃးၶႄႉၶဵင်ႇ	k aː ˥ kʰ ɛː ˦˨ˀ kʰ e ŋ ˩
ၵႃးၸိပ်ႉ	k aː ˥ t͡ɕ i p̚ ˦˨
ၵႃးၸၢင်ႈ	k aː ˥ t͡ɕ aː ŋ ˧˧˨
ၵႃးႁူင်းႁဵၼ်း	k aː ˥ h o ŋ ˥ h e n ˥
ၵႃၶူဝ်ႇ	k aː ˨˦ kʰ oː ˩
ၵႃၶၢပ်ႇ	k aː ˨˦ kʰ aː p̚ ˩
ၵႃၸႆး	k aː ˨˦ t͡ɕ a j ˥
ၵႃႇထႃႇ	k aː ˩ tʰ aː ˩
ၵႃႇမ	k aː ˩ m a ˨˦
ၵႃႇမတၼ်ႇၼႃႇ	k aː ˩ m a ˨˦ t a n ˩ n aː ˩
ၵႃႇမၵုၼ်ႇ	k aː ˩ m a ˨˦ k u n ˩
ၵႃႇယ	k aː ˩ j a ˨˦
ၵႃႇယၵမ်ႇ	k aː ˩ j a ˨˦ k a m ˩
ၵႃႇလ	k aː ˩ l a ˨˦
ၵႃႇလၶေႃးၵႂ်ႈ	k aː ˩ l a ˨˦ kʰ ɔː ˥ k a ɰ ˧˧˨
ၵႃႇလၼ်ႇ	k aː ˩ l a n ˩
ၵႃႇလႃႉသႃး	k aː ˩ l aː ˦˨ˀ sʰ aː ˥
ၵႃႇၽီႇ	k aː ˩ pʰ iː ˩
ၵႃႈ	k aː ˧˧˨
ၵႃႈတီႈ	k aː ˧˧˨ t iː ˧˧˨
ၵႃႈတီႈတႂ်ႈ	k aː ˧˧˨ t iː ˧˧˨ t a ɰ ˧˧˨
ၵႃႈတူၵ်းၶၼ်ယွမ်း	k aː ˧˧˨ t o k̚ ˥ kʰ a n ˨˦ j ɔ m ˨˦
ၵႃႈတႂ်ႈ	k aː ˧˧˨ t a ɰ ˧˧˨
ၵႃႈတႃႈ	k aː ˧˧˨ t aː ˧˧˨
ၵႃႈထုၵ်ႇ	k aː ˧˧˨ tʰ u k̚ ˩
ၵႃႈပုၼ်ႉ	k aː ˧˧˨ p u n ˦˨
ၵႃႈပေႃး	k aː ˧˧˨ p ɔː ˥
ၵႃႈမၼ်း	k aː ˧˧˨ m a n ˥
ၵႃႈယွမ်း	k aː ˧˧˨ j ɔ m ˥
ၵႃႈယႂ်ႇ	k aː ˧˧˨ j a ɰ ˩
ၵႃႈၵေႇ	k aː ˧˧˨ k eː ˩
ၵႃႈၶိုၼ်ႈၶၼ်ၶိုၼ်ႈ	k aː ˧˧˨ kʰ ɯ n ˧˧˨ kʰ a n ˨˦ kʰ ɯ n ˧˧˨
ၵႃႈၶီႇ	k aː ˧˧˨ kʰ iː ˩
ၵႃႈၶီႈငိုၼ်း	k aː ˧˧˨ kʰ iː ˧˧˨ ŋ ɯ n ˥
ၵႃႈၶၢတ်ႈ	k aː ˧˧˨ kʰ aː t̚ ˧˧˨
ၵႃႈၶၼ်	k aː ˧˧˨ kʰ a n ˨˦
ၵႃႈၸၢင်ႈ	k aː ˧˧˨ t͡ɕ aː ŋ ˧˧˨
ၵႃႈၸၢတ်ႈ	k aː ˧˧˨ t͡ɕ aː t̚ ˧˧˨
ၵႃႈၼင်ႇဢၼ်	k aː ˧˧˨ n a ŋ ˩ ʔ a n ˨˦
ၵႃႈၼိူဝ်	k aː ˧˧˨ n ɤː ˨˦
ၵႃႈၼွၵ်ႈ	k aː ˧˧˨ n ɔ k̚ ˧˧˨
ၵႃႈၼႂ်း	k aː ˧˧˨ n a ɰ ˥
ၵႃႈၼႃႈ	k aː ˧˧˨ n aː ˧˧˨
ၵႃႈၼႆႈ	k aː ˧˧˨ n a j ˧˧˨
ၵႃႈၼႆႉ	k aː ˧˧˨ n a j ˦˨
ၵႃႈႁိုဝ်	k aː ˧˧˨ h ɯː ˨˦
ၵႃႉ	k aː ˦˨
ၵႃႉယွႆႈၵႃႉယႅမ်း	k aː ˦˨ˀ j ɔ j ˧˧˨ k aː ˦˨ˀ j ɛ m ˥
ၵႃႉၶၢႆ	k aː ˦˨ˀ kʰ aː j ˨˦
ၵႄးၼမ်ႉ	k ɛː ˥ n a m ˦˨
ၵႄႇ	k ɛː ˩
ၵႄႇထွင်ႇ	k ɛː ˩ tʰ ɔ ŋ ˩
ၵႄႇယဝ်ႉ	k ɛː ˩ j a w ˦˨
ၵႄႇလူင်	k ɛː ˩ l o ŋ ˨˦
ၵႄႇသၢင်းၽေႃး	k ɛː ˩ sʰ aː ŋ ˥ pʰ ɔː ˥
ၵႄႇသႄႇ	k ɛː ˩ sʰ ɛː ˩
ၵႄႇဢွၼ်ႇၸၢႆး	k ɛː ˩ ʔ ɔ n ˩ t͡ɕ aː j ˥
ၵႄႇၵၢင်ႉ	k ɛː ˩ k aː ŋ ˦˨
ၵႄႇၶျွတ်ႈ	k ɛː ˩ kʰ j ɔ t̚ ˧˧˨
ၵႄႇၸူၼ်	k ɛː ˩ t͡ɕ o n ˨˦
ၵႄႈ	k ɛː ˧˧˨
ၵႄႈပွႆႇထၢမ်လိၵ်ႈ	k ɛː ˧˧˨ p ɔ j ˩ tʰ aː m ˨˦ l i k̚ ˧˧˨
ၵႄႈလိတ်ႈ	k ɛː ˧˧˨ l i t̚ ˧˧˨
ၵႄႈဢူၵ်း	k ɛː ˧˧˨ ʔ o k̚ ˥
ၵႄႈၸဵင်ႇ	k ɛː ˧˧˨ t͡ɕ e ŋ ˩
ၵႄႉ	k ɛː ˦˨
ၵႅင်	k ɛ ŋ ˨˦
ၵႅင်းႁွမ်	k ɛ ŋ ˥ h ɔ m ˨˦
ၵႅင်ႈယဝ်ႉၵႅင်ႈယွၵ်ႇ	k ɛ ŋ ˧˧˨ j a w ˦˨ˀ k ɛ ŋ ˧˧˨ j ɔ k̚ ˩
ၵႅပ်ႉၼိုင်ႈ	k ɛ p̚ ˦˨ˀ n ɯ ŋ ˧˧˨
ၵႅမ်း	k ɛ m ˥
ၵႅၵ်း	k ɛ k̚ ˥
ၵႅၼ်မႆႉ	k ɛ n ˨˦ m a j ˦˨
ၵႅၼ်း	k ɛ n ˥
ၵႆးၵွင်ႈ	k a j ˥ k ɔ ŋ ˧˧˨
ၵႆႇ	k a j ˩
ၵႆႇၸၢင်ႉ	k a j ˩ t͡ɕ aː ŋ ˦˨
ၶမ်း	kʰ a m ˥
ၶယိၼ်းရိတ်ႉ	kʰ a ˨˦ j i n ˥ r i t̚ ˦˨
ၶဝ်ႈ	kʰ a w ˧˧˨
ၶဝ်ႈမိၼ်ႉ	kʰ a w ˧˧˨ m i n ˦˨
ၶဝ်ႈသွႆး	kʰ a w ˧˧˨ sʰ ɔ j ˥
ၶဝ်ႈၵၢပ်ႇ	kʰ a w ˧˧˨ k aː p̚ ˩
ၶိင်း	kʰ i ŋ ˥
ၶိင်ႇမႆႈ	kʰ i ŋ ˩ m a j ˧˧˨
ၶိုင်ႁႃၵၢၼ်	kʰ ɯ ŋ ˨˦ h aː ˨˦ k aː n ˨˦
ၶိုၵ်ႉၶိုၵ်ႉၶမ်ႈၶမ်ႈ	kʰ ɯ k̚ ˦˨ˀ kʰ ɯ k̚ ˦˨ˀ kʰ a m ˧˧˨ kʰ a m ˧˧˨
ၶိုၵ်ႉၶၵ်ႉ	kʰ ɯ k̚ ˦˨ˀ kʰ a k̚ ˦˨
ၶိူင်လမ်	kʰ ɤ ŋ ˨˦ l a m ˨˦
ၶိူင်ႈ	kʰ ɤ ŋ ˧˧˨
ၶီႇတၢင်ႇ	kʰ iː ˩ t aː ŋ ˩
ၶီႇမႃႇ	kʰ iː ˩ m aː ˩
ၶီႈငိုၼ်း	kʰ iː ˧˧˨ ŋ ɯ n ˥
ၶီႈၶင်ႈ	kʰ iː ˧˧˨ kʰ a ŋ ˧˧˨
ၶီႈၶၢၼ်ႉၶီႈဢိူၼ်	kʰ iː ˧˧˨ kʰ aː n ˦˨ˀ kʰ iː ˧˧˨ ʔ ɤ n ˨˦
ၶုင်ႇၼင်ႈ	kʰ u ŋ ˩ n a ŋ ˧˧˨
ၶုၵ်းၶၵ်း	kʰ u k̚ ˥ kʰ a k̚ ˥
ၶုၼ်မိူၵ်ႈ	kʰ u n ˨˦ m ɤ k̚ ˧˧˨
ၶူင်းၽီ	kʰ o ŋ ˥ pʰ iː ˨˦
ၶူဝ်လႆ	kʰ oː ˨˦ l a j ˨˦
ၶူးသွၼ်	kʰ uː ˥ sʰ ɔ n ˨˦
ၶေးၶေး	kʰ eː ˥ kʰ eː ˥
ၶေႃးပုမ်း	kʰ ɔː ˥ p u m ˥
ၶေႃးမေႃႈ	kʰ ɔː ˥ m ɔː ˧˧˨
ၶေႃးၶတ်းၶေႃးၶႅင်	kʰ ɔː ˥ kʰ a t̚ ˥ kʰ ɔː ˥ kʰ ɛ ŋ ˨˦
ၶေႃးၶူမ်	kʰ ɔː ˥ kʰ o m ˨˦
ၶေႃႉ	kʰ ɔː ˦˨
ၶေႇမွတ်ႇ	kʰ eː ˩ m ɔ t̚ ˩
ၶဵင်ႇပပ်ႉ	kʰ e ŋ ˩ p a p̚ ˦˨
ၶဵင်ႇမုင်ႈ	kʰ e ŋ ˩ m u ŋ ˧˧˨
ၶဵင်ႇႁၢမ်	kʰ e ŋ ˨˦ h aː m ˨˦
ၶဵင်ႈ	kʰ e ŋ ˧˧˨
ၶဵဝ်	kʰ e w ˨˦
ၶဵဝ်ႈ	kʰ e w ˧˧˨
ၶျၢင်း	kʰ j aː ŋ ˥
ၶျၢမ်းသႃႇ	kʰ j aː m ˥ sʰ aː ˩
ၶွင်ႇၼုမ်ႇ	kʰ ɔ ŋ ˩ n u m ˩
ၶွၵ်း	kʰ ɔ k̚ ˥
ၶွၼ်ႉတဝ်ႉ	kʰ ɔ n ˦˨ˀ t a w ˦˨
ၶၢင်	kʰ aː ŋ ˨˦
ၶၢင်ႇပွင်း	kʰ aː ŋ ˩ p ɔ ŋ ˥
ၶၢင်ႇလေႃး	kʰ aː ŋ ˩ l ɔː ˥
ၶၢဝ်	kʰ aː w ˨˦
ၶၢဝ်းတၢင်း	kʰ aː w ˥ t aː ŋ ˥
ၶႃ	kʰ aː ˨˦
ၶႃႉ	kʰ aː ˦˨
ၶႄႇ	kʰ ɛː ˩
ၸဝ်ႈမုၼ်	t͡ɕ a w ˧˧˨ m u n ˨˦
ၸဝ်ႈမုၼ်ပူပ်ႉ	t͡ɕ a w ˧˧˨ m u n ˨˦ p o p̚ ˦˨
ၸဝ်ႈၽြႃး	t͡ɕ a w ˧˧˨ pʰ r aː ˥
ၸိမ်း	t͡ɕ i m ˥
ၸိုင်ႈၶမ်းသၢမ်ၸဵင်ႇ	t͡ɕ ɯ ŋ ˧˧˨ kʰ a m ˥ sʰ aː m ˨˦ t͡ɕ e ŋ ˩
ၸီးၼႃႉ	t͡ɕ iː ˥ n aː ˦˨
ၸီႉၼႃႉ	t͡ɕ iː ˦˨ˀ n aː ˦˨
ၸုမ်းၵူၼ်း	t͡ɕ u m ˥ k o n ˥
ၸေႃႉငႅမ်ႈ	t͡ɕ ɔː ˦˨ˀ ŋ ɛ m ˧˧˨
ၸေႇတီႇ	t͡ɕ eː ˩ t iː ˩
ၸဵင်ႇလႅမ်	t͡ɕ e ŋ ˩ l ɛ m ˨˦
ၸဵင်ႇဝၢတ်ႈ	t͡ɕ e ŋ ˩ w aː t̚ ˧˧˨
ၸဵင်ႇၶိုင်ႈ	t͡ɕ e ŋ ˩ kʰ ɯ ŋ ˧˧˨
ၸွမ်ၸိုင်ႈ	t͡ɕ ɔ m ˨˦ t͡ɕ ɯ ŋ ˧˧˨
ၸွႆႈထႅမ်	t͡ɕ ɔ j ˧˧˨ tʰ ɛ m ˨˦
ၸၢင်	t͡ɕ aː ŋ ˨˦
ၸၢင်ႈ	t͡ɕ aː ŋ ˧˧˨
ၸၢင်ႉ	t͡ɕ aː ŋ ˦˨
ၸၢဝ်းၶိူဝ်း	t͡ɕ aː w ˥ kʰ ɤː ˥
ၸၼေႇ	t͡ɕ a ˨˦ n eː ˩
ၸၼ်ႁၢင်ႈ	t͡ɕ a n ˨˦ h aː ŋ ˧˧˨
ၸၼ်ႇဝႃႇရီႇ	t͡ɕ a n ˩ w aː ˩ r iː ˩
ၺၢမ်ႉ	ɲ aː m ˦˨
ၼင်	n a ŋ ˨˦
ၼင်ႈ	n a ŋ ˧˧˨
ၼမ်ႉ	n a m ˦˨
ၼမ်ႉမၼ်း	n a m ˦˨ˀ m a n ˥
ၼိုင်ႈ	n ɯ ŋ ˧˧˨
ၼူဝ်ႇဝႅမ်ႇပႃႇ	n oː ˩ w ɛ m ˩ p aː ˩
ၼူၵ်ႉ	n o k̚ ˦˨
ၼၢင်း	n aː ŋ ˥
ၼၢင်းတႃႉ	n aː ŋ ˥ t aː ˦˨
ၼၢင်းယိင်း	n aː ŋ ˥ j i ŋ ˥
ၼၢမ်ႇသႃႇ	n aː m ˩ sʰ aː ˩
ၼၢႆး	n aː j ˥
ၼၼ်ႉ	n a n ˦˨
ၼႃး	n aː ˥
ၼႆယဝ်ႉ	n a j ˨˦ j a w ˦˨
ၼႆႉ	n a j ˦˨
ၽဝႃႇ	pʰ a ˨˦ w aː ˩
ၽိဝ်ၼင်	pʰ i w ˨˦ n a ŋ ˨˦
ၽိူဝ်ႉ	pʰ ɤː ˦˨
ၽိၵ်ႈၶူႇ	pʰ i k̚ ˧˧˨ kʰ uː ˩
ၽိၼ်ႇ	pʰ i n ˩
ၽီလူး	pʰ iː ˨˦ l uː ˥
ၽုၵ်ႇ	pʰ u k̚ ˩
ၽုၺ်ႇ	pʰ u j ˩
ၽူၼ်	pʰ o n ˨˦
ၽူႈ	pʰ uː ˧˧˨
ၽျၢၼ်း	pʰ j aː n ˥
ၽြႃးဢလွင်း	pʰ r aː ˥ ʔ a ˨˦ l ɔ ŋ ˥
ၽၢၼ်ႇသၢင်း	pʰ aː n ˩ sʰ aː ŋ ˥
ၽၵ်းတူ	pʰ a k̚ ˥ t uː ˨˦
ၽၵ်းၵၢတ်ႇမွၵ်ႇ	pʰ a k̚ ˥ k aː t̚ ˩ m ɔ k̚ ˩
ၽၼ်ႇတႃႇၸူဝ်း	pʰ a n ˩ t aː ˩ t͡ɕ oː ˥
ၽႃႇသႃႇမၢၼ်ႈ	pʰ aː ˩ sʰ aː ˩ m aː n ˧˧˨
ၽႃႉ	pʰ aː ˦˨
ၾူၼ်	f o n ˨˦
ၾႆး	f a j ˥
ၾႆးၾႃႉ	f a j ˥ f aː ˦˨
ႀရၽူႇ	θ a ˨˦ r a ˨˦ pʰ uː ˩
ႀီႇႁူဝ်ႇ	θ iː ˩ h oː ˩
ႀူဝ်း	θ oː ˥
ႀၼၢပ်ႈၶႃး	θ a ˨˦ n aː p̚ ˧˧˨ kʰ aː ˥
ႁင်းသႃႇ	h a ŋ ˥ sʰ aː ˩
ႁဝ်းၶႃႈ	h a w ˥ kʰ aː ˧˧˨
ႁိင်ႇႁွႆႈ	h i ŋ ˩ h ɔ j ˧˧˨
ႁိူဝ်း	h ɤː ˥
ႁိၼ်	h i n ˨˦
ႁိၼ်သူမ်ႈ	h i n ˨˦ sʰ o m ˧˧˨
ႁုၼ်ႇ	h u n ˩
ႁူင်	h o ŋ ˨˦
ႁူင်းၼႄ	h o ŋ ˥ n ɛː ˨˦
ႁူင်းႁဵၼ်း	h o ŋ ˥ h e n ˥
ႁူပ်ႉထူပ်း	h o p̚ ˦˨ˀ tʰ o p̚ ˥
ႁူဝ်ၽၵ်းပိုၵ်ႉ	h oː ˨˦ pʰ a k̚ ˥ p ɯ k̚ ˦˨
ႁူၵ်း	h o k̚ ˥
ႁူႉ	h uː ˦˨
ႁေႃး	h ɔː ˥
ႁွၵ်ႇ	h ɔ k̚ ˩
ႁၢင်ႈလီ	h aː ŋ ˧˧˨ l iː ˨˦
ႁၢၼ်ႇ	h aː n ˩
ႁၵ်ႉ	h a k̚ ˦˨
ႁၼ်	h a n ˨˦
ႁႄႉၵင်ႈ	h ɛː ˦˨ˀ k a ŋ ˧˧˨
ႁႅမ်	h ɛ m ˨˦
