abaton	a b a t ɔ n
abażur	a b a ʐ u r
abdykacja	a b d ɨ k a t͡s j a
abiturientach	a b i t u r j ɛ n t a x
abonentowi	a b ɔ n ɛ n t ɔ v i
abrazyjny	a b r a z ɨ j n ɨ
absolut	a p s ɔ l u t
absyd	a p s ɨ t
adiutański	a d j u t a ɲ s k i
administratoria	a d m i ɲ i s t r a t ɔ r j a
adwokacikowi	a d v ɔ k a t͡ɕ i k ɔ v i
adwokactwem	a d v ɔ k a t͡s t f ɛ m
aeronomiczny	a ɛ r ɔ n ɔ m i t͡ʂ n ɨ
aerozolowano	a ɛ r ɔ z ɔ l ɔ v a n ɔ
afarski	a f a r s k i
afatycznymi	a f a t ɨ t͡ʂ n ɨ m i
agrafko	a ɡ r a f k ɔ
agrest	a ɡ r ɛ s t
agronomiczny	a ɡ r ɔ n ɔ m i t͡ʂ n ɨ
alarmująco	a l a r m u j ɔ n t͡s ɔ
albańskich	a l b a ɲ s k i x
aleksytymia	a l ɛ k s ɨ t ɨ m j a
algierczyk	a l ɡ j ɛ r t͡ʂ ɨ k
aliterackie	a l i t ɛ r a t͡s k j ɛ
aluzyjnie	a l u z ɨ j ɲ ɛ
ambarkowanie	a m b a r k ɔ v a ɲ ɛ
amerykanista	a m ɛ r ɨ k a ɲ i s t a
amfiboliczny	a m f i b ɔ l i t͡ʂ n ɨ
amfiktionia	a m f i k t j ɔ ɲ a
amiant	a m j a n t
amonicyja	a m ɔ ɲ i t͡s ɨ j ɒ
anafora	a n a f ɔ r a
anatoksyna	a n a t ɔ k s ɨ n a
angina	a ŋ ɡ i n a
animowanie	a ɲ i m ɔ v a ɲ ɛ
apostatyczny	a p ɔ s t a t ɨ t͡ʂ n ɨ
apostolstwo	a p ɔ s t ɔ l s t f ɔ
apteką	a p t ɛ k ɔ w̃
arbitraż	a r b i t r a ʂ
archiwalne	a r x i v a l n ɛ
archiwizujące	a r x i v i z u j ɔ n t͡s ɛ
armada	a r m a d a
arteriosklerozie	a r t ɛ r j ɔ s k l ɛ r ɔ ʑ ɛ
artykulacje	a r t ɨ k u l a t͡s j ɛ
asenizator	a s ɛ ɲ i z a t ɔ r
asocjatywność	a s ɔ t͡s j a t ɨ v n ɔ ɕ t͡ɕ
asteniczny	a s t ɛ ɲ i t͡ʂ n ɨ
astrowieżyczkami	a s t r ɔ v j ɛ ʐ ɨ t͡ʂ k a m i
atakujecie	a t a k u j ɛ t͡ɕ ɛ
autobiograficzny	a w t ɔ b j ɔ ɡ r a f i t͡ʂ n ɨ
autokataliza	a w t ɔ k a t a l i z a
autokratka	a w t ɔ k r a t k a
autolizujesz	a w t ɔ l i z u j ɛ ʂ
autoryzowany	a w t ɔ r ɨ z ɔ v a n ɨ
autoryzowałaś	a w t ɔ r ɨ z ɔ v a w a ɕ
awanturniczy	a v a n t u r ɲ i t͡ʂ ɨ
babią	b a b j ɔ w̃
bagażowe	b a ɡ a ʐ ɔ v ɛ
bajtko	b ɒ j t k ɔ
balanga	b a l a ŋ ɡ a
bandoski	b a n d ɔ s k i
baniopień	b a ɲ ɔ p j ɛ ɲ
banknotowy	b a ŋ k n ɔ t ɔ v ɨ
bankrutowali	b a ŋ k r u t ɔ v a l i
bareizm	b a r ɛ i z m
barków	b a r k u f
basałyk	b a s a w ɨ k
basistek	b a ɕ i s t ɛ k
baw	b a f
bawola	b a v ɔ l a
bałwanić	b a w v a ɲ i t͡ɕ
bejca	b ɛ j t͡s a
bezcześciliby	b ɛ s t͡ʂ ɛ ɕ t͡ɕ i l i b ɨ
bezpieniężny	b ɛ s p j ɛ ɲ ɛ w̃ ʐ n ɨ
bezprefiksalny	b ɛ s p r ɛ f i k s a l n ɨ
bezpłatna	b ɛ s p w a t n a
bezwolnie	b ɛ z v ɔ l ɲ ɛ
bezwstydny	b ɛ s f s t ɨ d n ɨ
bezłożyskowcu	b ɛ z w ɔ ʐ ɨ s k ɔ f t͡s u
bełchatowianina	b ɛ w x a t ɔ v j a ɲ i n a
bidetowy	b i d ɛ t ɔ v ɨ
bidną	b i d n ɔ w̃
biegała	b j ɛ ɡ a w a
biegłaś	b j ɛ ɡ w a ɕ
bielskiego	b j ɛ l s k j ɛ ɡ ɔ
bielą	b j ɛ l ɔ w̃
biodro	b j ɔ d r ɔ
biogurt	b j ɔ ɡ u r t
biznesik	b i z n ɛ ɕ i k
biżuteryjny	b i ʐ u t ɛ r ɨ j n ɨ
bluz	b l u s
bluzeczki	b l u z ɛ t͡ʂ k i
bohaterski	b ɔ x a t ɛ r s k i
bombić	b ɔ m b i t͡ɕ
borowik	b ɔ r ɔ v i k
brekcja	b r ɛ k t͡s j a
bywaj	b ɨ v a j
błahostkom	b w a x ɔ s t k ɔ m
błądziłabyś	b w ɔ ɲ d͡ʑ i w a b ɨ ɕ
błądziłeś	b w ɔ ɲ d͡ʑ i w ɛ ɕ
cedzidło	t͡s ɛ d͡ʑ i d w ɔ
cennik	t͡s ɛ n ɲ i k
chmurką	x m u r k ɔ w̃
chodziłabym	x ɔ d͡ʑ i w a b ɨ m
chude	x u d ɛ
chutliwiec	x u t l i v j ɛ t͡s
ciachami	t͡ɕ a x a m i
ciarce	t͡ɕ a r t͡s ɛ
ciekawsko	t͡ɕ ɛ k a f s k ɔ
ciemięzca	t͡ɕ ɛ m j ɛ w̃ s t͡s a
cieni	t͡ɕ ɛ ɲ i
cierpliwej	t͡ɕ ɛ r p l i v ɛ j
cipcia	t͡ɕ i p t͡ɕ a
ciężarowych	t͡ɕ ɛ w̃ ʐ a r ɔ v ɨ x
cnotach	t͡s n ɔ t a x
college	k ɔ l ɛ t͡ʂ
cudzie	t͡s u d͡ʑ ɛ
cyk	t͡s ɨ k
cyzelować	t͡s ɨ z ɛ l ɔ v a t͡ɕ
czekanami	t͡ʂ ɛ k a n a m i
czwartej	t͡ʂ f a r t ɛ j
czytany	t͡ʂ ɨ t a n ɨ
czyścioszek	t͡ʂ ɨ ɕ t͡ɕ ɔ ʂ ɛ k
czyżyk	t͡ʂ ɨ ʐ ɨ k
często	t͡ʂ ɛ̃ s t ɔ
córą	t͡s u r ɔ w̃
danego	d a n ɛ ɡ ɔ
dawali	d a v a l i
deklamator	d ɛ k l a m a t ɔ r
demontowałaś	d ɛ m ɔ n t ɔ v a w a ɕ
dezorientować	d ɛ z ɔ r j ɛ n t ɔ v a t͡ɕ
diagnozuje	d j a ɡ n ɔ z u j ɛ
dialektycznie	d j a l ɛ k t ɨ t͡ʂ ɲ ɛ
doje	d ɔ j ɛ
doktor	d ɔ k t ɔ r
doktorski	d ɔ k t ɔ r s k i
donejtami	d ɔ n ɛ j t a m i
donejtom	d ɔ n ɛ j t ɔ m
donica	d ɔ ɲ i t͡s a
dostatek	d ɔ s t a t ɛ k
dostrzegasz	d ɔ s t ʂ ɛ ɡ a ʂ
dowiedziałem	d ɔ v j ɛ d͡ʑ a w ɛ m
drednot	d r ɛ d n ɔ t
drgalibyście	d r ɡ a l i b ɨ ɕ t͡ɕ ɛ
drągom	d r ɔ ŋ ɡ ɔ m
dubiel	d u b j ɛ l
duma	d u m a
dumni	d u m ɲ i
duńskie	d u ɲ s k j ɛ
dworca	d v ɔ r t͡s a
dwudziestosześcioletni	d v u d͡ʑ ɛ s t ɔ ʂ ɛ ɕ t͡ɕ ɔ l ɛ t ɲ i
dygać	d ɨ ɡ a t͡ɕ
dziesięcioletni	d͡ʑ ɛ ɕ ɛ ɲ t͡ɕ ɔ l ɛ t ɲ i
dzieła	d͡ʑ ɛ w a
dęłoby	d ɛ w ɔ b ɨ
dłubanka	d w u b a ŋ k a
echo	ɛ x ɔ
edytorski	ɛ d ɨ t ɔ r s k i
egzekucyjnego	ɛ ɡ z ɛ k u t͡s ɨ j n ɛ ɡ ɔ
egzotyczny	ɛ ɡ z ɔ t ɨ t͡ʂ n ɨ
eksportujecie	ɛ k s p ɔ r t u j ɛ t͡ɕ ɛ
elektronarzędzie	ɛ l ɛ k t r ɔ n a ʐ ɛ ɲ d͡ʑ ɛ
emotek	ɛ m ɔ t ɛ k
epidemiami	ɛ p i d ɛ m j a m i
epistemologia	ɛ p i s t ɛ m ɔ l ɔ ɡ j a
europarlamentarzystka	ɛ w r ɔ p a r l a m ɛ n t a ʐ ɨ s t k a
eweńskiemu	ɛ v ɛ ɲ s k j ɛ m u
ewolucja	ɛ v ɔ l u t͡s j a
fanaberie	f a n a b ɛ r j ɛ
faworyta	f a v ɔ r ɨ t a
fałszach	f a w ʂ a x
fałszem	f a w ʂ ɛ m
filiżaneczek	f i l i ʐ a n ɛ t͡ʂ ɛ k
filozofio	f i l ɔ z ɔ f j ɔ
firmą	f i r m ɔ w̃
flagowiec	f l a ɡ ɔ v j ɛ t͡s
fortunny	f ɔ r t u n n ɨ
fretkę	f r ɛ t k ɛ
frytkom	f r ɨ t k ɔ m
fryzyjska	f r ɨ z ɨ j s k a
frędzlu	f r ɛ n d͡z l u
galopowałeś	ɡ a l ɔ p ɔ v a w ɛ ɕ
garbowałam	ɡ a r b ɔ v a w a m
garczek	ɡ a r t͡ʂ ɛ k
gałęziak	ɡ a w ɛ ɲ ʑ a k
genewskim	ɡ ɛ n ɛ f s k i m
genie	ɡ ɛ ɲ ɛ
gierka	ɡ j ɛ r k a
gigabajt	ɡ i ɡ a b a j t
gimnazjów	ɡ i m n a z j u f
glewia	ɡ l ɛ v j a
gnać	ɡ n a t͡ɕ
gnijecie	ɡ ɲ i j ɛ t͡ɕ ɛ
gorzowianinem	ɡ ɔ ʐ ɔ v j a ɲ i n ɛ m
gospodarstwem	ɡ ɔ s p ɔ d a r s t f ɛ m
grahamkom	ɡ r a x a m k ɔ m
grawerujcie	ɡ r a v ɛ r u j t͡ɕ ɛ
gromny	ɡ r ɔ m n ɨ
grotom	ɡ r ɔ t ɔ m
grubowarg	ɡ r u b ɔ v a r k
grusze	ɡ r u ʂ ɛ
gruszek	ɡ r u ʂ ɛ k
grzejniczek	ɡ ʐ ɛ j ɲ i t͡ʂ ɛ k
grzeszek	ɡ ʐ ɛ ʂ ɛ k
gwiezdnymi	ɡ v j ɛ z d n ɨ m i
gwiezdną	ɡ v j ɛ z d n ɔ w̃
gębacz	ɡ ɛ m b a t͡ʂ
głuchego	ɡ w u x ɛ ɡ ɔ
haktywistka	x a k t ɨ v i s t k a
hawajskiej	x a v a j s k j ɛ j
hindustański	x i n d u s t a ɲ s k i
hipotetycznie	x i p ɔ t ɛ t ɨ t͡ʂ ɲ ɛ
hojniejszy	x ɔ j ɲ ɛ j ʂ ɨ
house	x a w s
identyfikowałyśmy	i d ɛ n t ɨ f i k ɔ v a w ɨ ɕ m ɨ
imię	i m j ɛ̃
irytująco	i r ɨ t u j ɔ n t͡s ɔ
islamska	i s l a m s k a
iwanko	i v a ŋ k ɔ
jadła	j a d w a
jamajskiej	j a m a j s k j ɛ j
janielski	j a ɲ ɛ l s k i
japończyk	j a p ɔ ɲ t͡ʂ ɨ k
japońsku	j a p ɔ ɲ s k u
jawnemu	j a v n ɛ m u
jaworznickim	j a v ɔ ʐ ɲ i t͡s k i m
jednokładność	j ɛ d n ɔ k w a d n ɔ ɕ t͡ɕ
jurzą	j u ʐ ɔ w̃
jętce	j ɛ n t t͡s ɛ
kaczkach	k a t͡ʂ k a x
kandela	k a n d ɛ l a
kapelusik	k a p ɛ l u ɕ i k
karmia	k a r m j a
kartridż	k a r t r i t͡ʂ
kawalarz	k a v a l a ʂ
każą	k a ʐ ɔ w̃
kidali	k i d a l i
kielecki	k j ɛ l ɛ t͡s k i
kladowi	k l a d ɔ v i
klawesyn	k l a v ɛ s ɨ n
knajpce	k n a j p t͡s ɛ
knute	k n u t ɛ
knuć	k n u t͡ɕ
kobieciarstwie	k ɔ b j ɛ t͡ɕ a r s t f j ɛ
kobzę	k ɔ b z ɛ
kochało	k ɔ x a w ɔ
kocurów	k ɔ t͡s u r u f
koiło	k ɔ i w ɔ
kolejowy	k ɔ l ɛ j ɔ v ɨ
kolekcjonowałabyś	k ɔ l ɛ k t͡s j ɔ n ɔ v a w a b ɨ ɕ
koleżeński	k ɔ l ɛ ʐ ɛ ɲ s k i
kolisty	k ɔ l i s t ɨ
komedią	k ɔ m ɛ d j ɔ w̃
kompletnie	k ɔ m p l ɛ t ɲ ɛ
komplikacja	k ɔ m p l i k a t͡s j a
konasz	k ɔ n a ʂ
konsumpcja	k ɔ n s u m p t͡s j a
kontemplacyjnie	k ɔ n t ɛ m p l a t͡s ɨ j ɲ ɛ
kontrolujmy	k ɔ n t r ɔ l u j m ɨ
konwalijki	k ɔ n v a l i j k i
kooptować	k ɔ ɔ p t ɔ v a t͡ɕ
koperta	k ɔ p ɛ r t a
korespondencyjny	k ɔ r ɛ s p ɔ n d ɛ n t͡s ɨ j n ɨ
kormorany	k ɔ r m ɔ r a n ɨ
koszula	k ɔ ʂ u l a
kotwić	k ɔ t f i t͡ɕ
kołach	k ɔ w a x
krab	k r a p
krasego	k r a s ɛ ɡ ɔ
krasemu	k r a s ɛ m u
kresą	k r ɛ s ɔ w̃
krową	k r ɔ v ɔ w̃
kręgielnia	k r ɛ ŋ ɡ j ɛ l ɲ a
krętek	k r ɛ n t ɛ k
kseruj	k s ɛ r u j
który	k t o r ɨ
kuców	k u t͡s u f
kulminacja	k u l m i n a t͡s j a
kupą	k u p ɔ w̃
kurwom	k u r v ɔ m
kępą	k ɛ m p ɔ w̃
kładłyby	k w a d w ɨ b ɨ
kłucie	k w u t͡ɕ ɛ
kłócicie	k w u t͡ɕ i t͡ɕ ɛ
lankijscy	l a ŋ k i j s t͡s ɨ
lapońskim	l a p ɔ ɲ s k i m
laudacja	l a w d a t͡s j a
leciałabym	l ɛ t͡ɕ a w a b ɨ m
lenek	l ɛ n ɛ k
lgnąc	l ɡ n ɔ n t͡s
liberia	l i b ɛ r j a
ligom	l i ɡ ɔ m
lnica	l ɲ i t͡s a
lubimy	l u b i m ɨ
lżejszego	l ʐ ɛ j ʂ ɛ ɡ ɔ
manekin	m a n ɛ k i n
marokański	m a r ɔ k a ɲ s k i
martwak	m a r t f a k
mary	m a r ɨ
maskowaniami	m a s k ɔ v a ɲ a m i
matę	m a t ɛ
mdlący	m d l ɔ n t͡s ɨ
memłać	m ɛ m w a t͡ɕ
metresa	m ɛ t r ɛ s a
mieszkaniem	m j ɛ ʂ k a ɲ ɛ m
miglanc	m i ɡ l a n t͡s
mile	m i l ɛ
milusie	m i l u ɕ ɛ
minięcie	m i ɲ ɛ ɲ t͡ɕ ɛ
minoga	m i n ɔ ɡ a
mir	m i r
mizeriom	m i z ɛ r j ɔ m
monopolisty	m ɔ n ɔ p ɔ l i s t ɨ
moralniak	m ɔ r a l ɲ a k
moralnie	m ɔ r a l ɲ ɛ
mordowałby	m ɔ r d ɔ v a w b ɨ
mordowałem	m ɔ r d ɔ v a w ɛ m
mrówce	m r u f t͡s ɛ
mrąc	m r ɔ n t͡s
municypalny	m u ɲ i t͡s ɨ p a l n ɨ
muszkatołowcem	m u ʂ k a t ɔ w ɔ f t͡s ɛ m
muszkatołowcom	m u ʂ k a t ɔ w ɔ f t͡s ɔ m
muszkatołowiec	m u ʂ k a t ɔ w ɔ v j ɛ t͡s
muzułmańskiej	m u z u w m a ɲ s k j ɛ j
muzyków	m u z ɨ k u f
mycka	m ɨ t͡s k a
myszą	m ɨ ʂ ɔ w̃
myślałoby	m ɨ ɕ l a w ɔ b ɨ
mędrszego	m ɛ n t r ʂ ɛ ɡ ɔ
mękę	m ɛ ŋ k ɛ
młoteczek	m w ɔ t ɛ t͡ʂ ɛ k
nadciąć	n a t t͡ɕ ɔ ɲ t͡ɕ
nadsiębierny	n a t ɕ ɛ m b j ɛ r n ɨ
nadużyć	n a d u ʐ ɨ t͡ɕ
nagnieść	n a ɡ ɲ e ɕ t͡ɕ
naiwniutki	n a i v ɲ u t k i
najciężsi	n a j t͡ɕ ɛ w̃ ʂ ɕ i
najcięższa	n a j t͡ɕ ɛ w̃ ʂ ʂ a
najebka	n a j ɛ p k a
najmądrzej	n a j m ɔ n d ʐ ɛ j
najowocniejszej	n a j ɔ v ɔ t͡s ɲ ɛ j ʂ ɛ j
najrozmowniej	n a j r ɔ z m ɔ v ɲ ɛ j
najszlachetniejszy	n a j ʂ l a x ɛ t ɲ ɛ j ʂ ɨ
najtwardszy	n a j t f a r t ʂ ɨ
nalewacie	n a l ɛ v a t͡ɕ ɛ
należą	n a l ɛ ʐ ɔ w̃
namawiaj	n a m a v j a j
nanizać	n a ɲ i z a t͡ɕ
napoję	n a p ɔ j ɛ
naprawialiśmy	n a p r a v j a l i ɕ m ɨ
narciarskie	n a r t͡ɕ a r s k j ɛ
narowie	n a r ɔ v j ɛ
nawyknąć	n a v ɨ k n ɔ ɲ t͡ɕ
nazadnik	n a z a d ɲ i k
nazywałybyśmy	n a z ɨ v a w ɨ b ɨ ɕ m ɨ
naładowywać	n a w a d ɔ v ɨ v a t͡ɕ
naścieła	n a ɕ t͡ɕ ɛ w a
nianią	ɲ a ɲ ɔ w̃
nicią	ɲ i t͡ɕ ɔ w̃
niebieskie	ɲ ɛ b j ɛ s k j ɛ
niegrzecznym	ɲ ɛ ɡ ʐ ɛ t͡ʂ n ɨ m
niepodległy	ɲ ɛ p ɔ d l ɛ ɡ w ɨ
nieracjonalność	ɲ ɛ r a t͡s j ɔ n a l n ɔ ɕ t͡ɕ
nierzetelny	ɲ ɛ ʐ ɛ t ɛ l n ɨ
nieuchronnie	ɲ ɛ u x r ɔ n ɲ ɛ
nieuctwo	ɲ ɛ w u t͡s t f ɔ
nieudacznica	ɲ ɛ u d a t͡ʂ ɲ i t͡s a
niewolnictwu	ɲ ɛ v ɔ l ɲ i t͡s t f u
nieznaczni	ɲ ɛ z n a t͡ʂ ɲ i
niw	ɲ i f
nizał	ɲ i z a w
norami	n ɔ r a m i
notowalibyście	n ɔ t ɔ v a l i b ɨ ɕ t͡ɕ ɛ
nożowi	n ɔ ʐ ɔ v i
nucą	n u t͡s ɔ w̃
numizmatyka	n u m i z m a t ɨ k a
nóżce	n u ʂ t͡s ɛ
obcas	ɔ p t͡s a s
obelga	ɔ b ɛ l ɡ a
oberwanie	ɔ b ɛ r v a ɲ ɛ
obiadami	ɔ b j a d a m i
obije	ɔ b i j ɛ
obmacać	ɔ b m a t͡s a t͡ɕ
obozów	ɔ b ɔ z u f
obskurny	ɔ p s k u r n ɨ
obsyłać	ɔ p s ɨ ɫ a t͡ɕ
obwąchiwać	ɔ b v ɔ w̃ x i v a t͡ɕ
ocalone	ɔ t͡s a l ɔ n ɛ
odetrzeć	ɔ d ɛ t r̝ ɛ t͡ɕ
odjechanie	ɔ d j ɛ x a ɲ ɛ
odkryty	ɔ t k r ɨ t ɨ
odkładach	ɔ t k w a d a x
odradzało	ɔ d r a d͡z a w ɔ
odsiać	ɔ t ɕ a t͡ɕ
odsyłacz	ɔ t s ɨ w a t͡ʂ
odśnieżałam	ɔ t ɕ ɲ ɛ ʐ a w a m
odśpiewanie	ɔ t ɕ p j ɛ v a ɲ ɛ
oficjalnie	ɔ f i t͡s j a l ɲ ɛ
oglądałyście	ɔ ɡ l ɔ n d a w ɨ ɕ t͡ɕ ɛ
ogniskowy	ɔ ɡ ɲ i s k ɔ v ɨ
ojebać	ɔ j ɛ b a t͡ɕ
okapi	ɔ k a p i
okazjonalny	ɔ k a z j ɔ n a l n ɨ
okradajcie	ɔ k r a d a j t͡ɕ ɛ
okroi	ɔ k r ɔ i
oktawa	ɔ k t a v a
okładzik	ɔ k w a d͡ʑ i k
oleiście	ɔ l ɛ i ɕ t͡ɕ ɛ
opatentowałoby	ɔ p a t ɛ n t ɔ v a w ɔ b ɨ
opera	ɔ p ɛ r a
opiekę	ɔ p j ɛ k ɛ
opowiedacz	ɔ p ɔ v j ɛ d a t͡ʂ
oprowadzało	ɔ p r ɔ v a d͡z a w ɔ
opłacać	ɔ p w a t͡s a t͡ɕ
orda	ɔ r d a
organizuje	ɔ r ɡ a ɲ i z u j ɛ
osa	ɔ s a
oskoły	ɔ s k ɔ w ɨ
ostrzegały	ɔ s t ʂ ɛ ɡ a w ɨ
oszałamiać	ɔ ʂ a w a m j a t͡ɕ
osączenie	ɔ s ɔ n t͡ʂ ɛ ɲ ɛ
osłuchać	ɔ s w u x a t͡ɕ
ot	ɔ t
otaczający	ɔ t a t͡ʂ a j ɔ n t͡s ɨ
otwartą	ɔ t f a r t ɔ w̃
ozorom	ɔ z ɔ r ɔ m
oślego	ɔ ɕ l ɛ ɡ ɔ
oświetlałybyście	ɔ ɕ f j ɛ t l a w ɨ b ɨ ɕ t͡ɕ ɛ
pacniecie	p a t͡s ɲ ɛ t͡ɕ ɛ
pad	p a t
padem	p a d ɛ m
padło	p a d w ɔ
parapsychologia	p a r a p s ɨ x ɔ l ɔ ɡ j a
pareidolia	p a r ɛ i d ɔ l j a
park	p a r k
pasmu	p a s m u
pastami	p a s t a m i
pastuch	p a s t u x
paszczur	p a ʂ t͡ʂ u r
pasłam	p a s w a m
pchlimi	p x l i m i
peonia	p ɛ ɔ ɲ j a
perskim	p ɛ r s k i m
persz	p ɛ r ʂ
pewniak	p ɛ v ɲ a k
pełzacz	p ɛ w z a t͡ʂ
pełła	p ɛ w w a
pełłam	p ɛ w w a m
piknąć	p i k n ɔ ɲ t͡ɕ
pilnowały	p i l n ɔ v a w ɨ
pirotechnika	p i r ɔ t ɛ x ɲ i k a
pisankę	p i s a ŋ k ɛ
pisało	p i s a w ɔ
pitę	p i t ɛ
pięcioksiąg	p j ɛ ɲ t͡ɕ ɔ k ɕ ɔ ŋ k
piętnastego	p j ɛ n t n a s t ɛ ɡ ɔ
piłodziób	p i w ɔ d͡ʑ u p
plandeka	p l a n d ɛ k a
pobrany	p ɔ b r a n ɨ
pochylać	p ɔ x ɨ l a t͡ɕ
pociot	p ɔ t͡ɕ ɔ t
podejrzewałybyście	p ɔ d ɛ j ʐ ɛ v a w ɨ b ɨ ɕ t͡ɕ ɛ
podgrzewać	p ɔ d ɡ ʐ ɛ v a t͡ɕ
podli	p ɔ d l i
podtlenek	p ɔ t t l ɛ n ɛ k
podówczas	p ɔ d u f t͡ʂ a s
pogardzałaby	p ɔ ɡ a r d͡z a w a b ɨ
pokrzepianie	p ɔ k ʂ ɛ p j a ɲ ɛ
polek	p ɔ l ɛ k
politowanie	p ɔ l i t ɔ v a ɲ ɛ
pomagamy	p ɔ m a ɡ a m ɨ
pomocniczko	p ɔ m ɔ t͡s ɲ i t͡ʂ k ɔ
poprzedni	p ɔ p ʂ ɛ d ɲ i
pornografie	p ɔ r n ɔ ɡ r a f j ɛ
porze	p ɔ ʐ ɛ
posikać	p ɔ ɕ i k a t͡ɕ
postach	p ɔ s t a x
posłużyć	p ɔ s w u ʐ ɨ t͡ɕ
powiedz	p ɔ v j ɛ t͡s
powiewać	p ɔ v j ɛ v a t͡ɕ
powtarzający	p ɔ f t a ʐ a j ɔ n t͡s ɨ
pozbywać	p ɔ z b ɨ v a t͡ɕ
pozorny	p ɔ z ɔ r n ɨ
pozostali	p ɔ z ɔ s t a l i
pozwalam	p ɔ z v a l a m
pozwolić	p ɔ z v ɔ l i t͡ɕ
połykają	p ɔ w ɨ k a j ɔ w̃
poślubiać	p ɔ ɕ l u b j a t͡ɕ
pożyczkobiorca	p ɔ ʐ ɨ t͡ʂ k ɔ b j ɔ r t͡s a
pradolina	p r a d ɔ l i n a
pragębowiec	p r a ɡ ɛ m b ɔ v j ɛ t͡s
prawdziwek	p r a v d͡ʑ i v ɛ k
prezenty	p r ɛ z ɛ n t ɨ
produkowała	p r ɔ d u k ɔ v a w a
produkowałyśmy	p r ɔ d u k ɔ v a w ɨ ɕ m ɨ
programowała	p r ɔ ɡ r a m ɔ v a w a
pryskać	p r ɨ s k a t͡ɕ
pryszczyki	p r ɨ ʂ t͡ʂ ɨ k i
przebijanie	p ʂ ɛ b i j a ɲ ɛ
przeciwnie	p ʂ ɛ t͡ɕ i v ɲ ɛ
przekroję	p ʂ ɛ k r ɔ j ɛ
przekąska	p ʂ ɛ k ɔ w̃ s k a
przekładowość	p ʂ ɛ k w a d ɔ v ɔ ɕ t͡ɕ
przeleźć	p ʂ ɛ l ɛ ɕ t͡ɕ
przestępczyni	p ʂ ɛ s t ɛ m p t͡ʂ ɨ ɲ i
przeważać	p ʂ ɛ v a ʐ a t͡ɕ
przybierać	p ʂ ɨ b j ɛ r a t͡ɕ
przydługi	p ʂ ɨ d w u ɡ i
przyjacielski	p ʂ ɨ j a t͡ɕ ɛ l s k i
przyjąć	p ʂ ɨ j ɔ ɲ t͡ɕ
przymierzyć	p ʂ ɨ m j ɛ ʐ ɨ t͡ɕ
przypominali	p ʂ ɨ p ɔ m i n a l i
przyskrzyniać	p ʂ ɨ s k ʂ ɨ ɲ a t͡ɕ
przystrzyc	p ʂ ɨ s t ʂ ɨ t͡s
próbowało	p r u b ɔ v a w ɔ
psiskiem	p ɕ i s k j ɛ m
psuje	p s u j ɛ
psychol	p s ɨ x ɔ l
publicystycznie	p u b l i t͡s ɨ s t ɨ t͡ʂ ɲ ɛ
pulsacyjny	p u l s a t͡s ɨ j n ɨ
pustułko	p u s t u w k ɔ
puszkować	p u ʂ k ɔ v a t͡ɕ
północnik	p u w n ɔ t͡s ɲ i k
pękaliście	p ɛ ŋ k a l i ɕ t͡ɕ ɛ
raczy	r a t͡ʂ ɨ
radosne	r a d ɔ s n ɛ
raki	r a k i
rakla	r a k l a
rdestówka	r d ɛ s t u f k a
receptura	r ɛ t͡s ɛ p t u r a
rekompensata	r ɛ k ɔ m p ɛ n s a t a
reling	r ɛ l i ŋ k
renegocjacja	r ɛ n ɛ ɡ ɔ t͡s j a t͡s j a
rezerwowałybyśmy	r ɛ z ɛ r v ɔ v a w ɨ b ɨ ɕ m ɨ
rezerwując	r ɛ z ɛ r v u j ɔ n t͡s
rezjański	r ɛ z j a ɲ s k i
rozciągłość	r ɔ s t͡ɕ ɔ ŋ ɡ w ɔ ɕ t͡ɕ
rozkurcz	r ɔ s k u r t͡ʂ
rozpaczałyście	r ɔ s p a t͡ʂ a w ɨ ɕ t͡ɕ ɛ
rozpakowywać	r ɔ s p a k ɔ v ɨ v a t͡ɕ
rozpoczęłoby	r ɔ s p ɔ t͡ʂ ɛ w ɔ b ɨ
rozpuszczenie	r ɔ s p u ʂ t͡ʂ ɛ ɲ ɛ
rozrobienie	r ɔ z r ɔ b j ɛ ɲ ɛ
rozważało	r ɔ z v a ʐ a w ɔ
rwandyjski	r v a n d ɨ j s k i
rwandyjskie	r v a n d ɨ j s k j ɛ
rysowałem	r ɨ s ɔ v a w ɛ m
rytach	r ɨ t a x
ryłach	r ɨ w a x
rzeki	ʐ ɛ k i
rzeźbiarkę	ʐ ɛ ʑ b j a r k ɛ
rzutnik	ʐ u t ɲ i k
równania	r u v n a ɲ a
rączka	r ɔ n t͡ʂ k a
rżą	r ʐ ɔ w̃
sadzić	s a d͡ʑ i t͡ɕ
sadziła	s a d͡ʑ i w a
samico	s a m i t͡s ɔ
sampel	s a m p ɛ l
samym	s a m ɨ m
seminaryjny	s ɛ m i n a r ɨ j n ɨ
siaja	ɕ a j a
siarkę	ɕ a r k ɛ
siejba	ɕ ɛ j b a
siądzie	ɕ ɔ ɲ d͡ʑ ɛ
sięgnąć	ɕ ɛ ŋ ɡ n ɔ ɲ t͡ɕ
skaut	s k a w t
skazana	s k a z a n a
skończą	s k ɔ ɲ t͡ʂ ɔ w̃
skrajnie	s k r a j ɲ ɛ
skręcenie	s k r ɛ n t͡s ɛ ɲ ɛ
składałyśmy	s k w a d a w ɨ ɕ m ɨ
smarknąć	s m a r k n ɔ ɲ t͡ɕ
smarując	s m a r u j ɔ n t͡s
snajper	s n a j p ɛ r
sobolim	s ɔ b ɔ l i m
spadał	s p a d a w
sparszeć	s p a r ʂ ɛ t͡ɕ
spasanie	s p a s a ɲ ɛ
spawam	s p a v a m
spaście	s p a ɕ t͡ɕ ɛ
spinacz	s p i n a t͡ʂ
spiłować	s p i w ɔ v a t͡ɕ
spontanicznie	s p ɔ n t a ɲ i t͡ʂ ɲ ɛ
sprawię	s p r a v j ɛ
sprawniejszy	s p r a v ɲ ɛ j ʂ ɨ
sprzysiężenie	s p ʂ ɨ ɕ ɛ w̃ ʐ ɛ ɲ ɛ
spłowieć	s p w ɔ v j ɛ t͡ɕ
stacje	s t a t͡s j ɛ
staja	s t a j a
stanowczo	s t a n ɔ f t͡ʂ ɔ
starcze	s t a r t͡ʂ ɛ
stawać	s t a v a t͡ɕ
sterane	s t ɛ r a n ɛ
stopami	s t ɔ p a m i
strachliwie	s t r a x l i v j ɛ
straszniejszy	s t r a ʂ ɲ ɛ j ʂ ɨ
straw	s t r a f
strefa	s t r ɛ f a
stroić	s t r ɔ i t͡ɕ
strumyczek	s t r u m ɨ t͡ʂ ɛ k
studiowałyście	s t u d j ɔ v a w ɨ ɕ t͡ɕ ɛ
stężeń	s t ɛ w̃ ʐ ɛ ɲ
sudański	s u d a ɲ s k i
surogat	s u r ɔ ɡ a t
surówkami	s u r u f k a m i
suszą	s u ʂ ɔ w̃
swawole	s f a v ɔ l ɛ
syllabus	s ɨ l l a b u s
sympozjum	s ɨ m p ɔ z j u m
synkopa	s ɨ ŋ k ɔ p a
szachistkach	ʂ a x i s t k a x
szarawym	ʂ a r a v ɨ m
szczujnia	ʂ t͡ʂ u j ɲ a
szczęśliwe	ʂ t͡ʂ ɛ ɲ ɕ l i v ɛ
szklanka	ʂ k l a ŋ k a
szmelc	ʂ m ɛ l t͡s
szpaczek	ʂ p a t͡ʂ ɛ k
szukani	ʂ u k a ɲ i
szumówka	ʂ u m u f k a
szwajcarska	ʂ f a j t͡s a r s k a
szwy	ʂ f ɨ
szyfrujący	ʂ ɨ f r u j ɔ n t͡s ɨ
sępów	s ɛ m p u f
tajfun	t a j f u n
tajność	t a j n ɔ ɕ t͡ɕ
taniej	t a ɲ ɛ j
taninowy	t a ɲ i n ɔ v ɨ
taternik	t a t ɛ r ɲ i k
tatuowałyście	t a t u ɔ v a w ɨ ɕ t͡ɕ ɛ
telewizornia	t ɛ l ɛ v i z ɔ r ɲ a
teraźniejszemu	t ɛ r a ʑ ɲ ɛ j ʂ ɛ m u
todze	t ɔ d͡z ɛ
toku	t ɔ k u
tomikach	t ɔ m i k a x
toporom	t ɔ p ɔ r ɔ m
torturować	t ɔ r t u r ɔ v a t͡ɕ
towarzyska	t ɔ v a ʐ ɨ s k a
tramp	t r a m p
troskliwa	t r ɔ s k l i v a
trzmieli	t ʂ m j ɛ l i
trzmielimi	t ʂ m j ɛ l i m i
trzydziesta	t ʂ ɨ d͡ʑ ɛ s t a
tunezyjskiej	t u n ɛ z ɨ j s k j ɛ j
twierdzę	t f j ɛ r d͡z ɛ
tygrysiego	t ɨ ɡ r ɨ ɕ ɛ ɡ ɔ
tyra	t ɨ r a
tyłeczek	t ɨ w ɛ t͡ʂ ɛ k
uczęszczać	u t͡ʂ ɛ w̃ ʂ t͡ʂ a t͡ɕ
ufając	u f a j ɔ n t͡s
ufający	u f a j ɔ n t͡s ɨ
ufundować	u f u n d ɔ v a t͡ɕ
ujmo	u j m ɔ
ujmą	u j m ɔ w̃
ująć	u j ɔ ɲ t͡ɕ
ukrainizacja	u k r a i ɲ i z a t͡s j a
umili	u m i l i
umilknąć	u m i l k n ɔ ɲ t͡ɕ
umkniecie	u m k ɲ ɛ t͡ɕ ɛ
umoralnić	u m ɔ r a l ɲ i t͡ɕ
umyć	u m ɨ t͡ɕ
unieśmiertelnić	u ɲ ɛ ɕ m j ɛ r t ɛ l ɲ i t͡ɕ
uosobić	u ɔ s ɔ b i t͡ɕ
upartym	u p a r t ɨ m
upłynniać	u p w ɨ n ɲ a t͡ɕ
urocze	u r ɔ t͡ʂ ɛ
uroczystość	u r ɔ t͡ʂ ɨ s t ɔ ɕ t͡ɕ
urzucić	u ʐ u t͡ɕ i t͡ɕ
ustabilizować	u s t a b i l i z ɔ v a t͡ɕ
usteczka	u s t ɛ t͡ʂ k a
utraci	u t r a t͡ɕ i
uwypuklać	u v ɨ p u k l a t͡ɕ
wanilii	v a ɲ i l j i
warko	v a r k ɔ
warszawiakach	v a r ʂ a v j a k a x
wbudować	v b u d ɔ v a t͡ɕ
wdarcie	v d a r t͡ɕ ɛ
wegetariańskiego	v ɛ ɡ ɛ t a r j a ɲ s k j ɛ ɡ ɔ
wejdziemy	v ɛ j d͡ʑ ɛ m ɨ
wersalikowi	v ɛ r s a l i k ɔ v i
wiertłom	v j ɛ r t w ɔ m
wiewiórach	v j ɛ v j u r a x
wileńskiemu	v i l ɛ ɲ s k j ɛ m u
winniczek	v i n ɲ i t͡ʂ ɛ k
wirkach	v i r k a x
witałyście	v i t a w ɨ ɕ t͡ɕ ɛ
wodoleczniczy	v ɔ d ɔ l ɛ t͡ʂ ɲ i t͡ʂ ɨ
worywać	v ɔ r ɨ v a t͡ɕ
wspinać	f s p i n a t͡ɕ
wszczepić	f ʂ t͡ʂ ɛ p i t͡ɕ
wtrząchnąć	f t ʂ ɔ w̃ x n ɔ ɲ t͡ɕ
wulgarnie	v u l ɡ a r ɲ ɛ
wuwuzela	v u v u z ɛ l a
wychwalać	v ɨ x f a l a t͡ɕ
wyciągnięcie	v ɨ t͡ɕ ɔ ŋ ɡ ɲ ɛ ɲ t͡ɕ ɛ
wyczucie	v ɨ t͡ʂ u t͡ɕ ɛ
wyizolować	v ɨ i z ɔ l ɔ v a t͡ɕ
wyjaśnialibyście	v ɨ j a ɕ ɲ a l i b ɨ ɕ t͡ɕ ɛ
wyjmowałam	v ɨ j m ɔ v a w a m
wyjmujmy	v ɨ j m u j m ɨ
wykarczować	v ɨ k a r t͡ʂ ɔ v a t͡ɕ
wylaszczyć	v ɨ l a ʂ t͡ʂ ɨ t͡ɕ
wyleczenie	v ɨ l ɛ t͡ʂ ɛ ɲ ɛ
wymalowanie	v ɨ m a l ɔ v a ɲ ɛ
wymówienie	v ɨ m o v j ɛ ɲ e
wypolerowanie	v ɨ p ɔ l ɛ r ɔ v a ɲ ɛ
wypryskanie	v ɨ p r ɨ s k a ɲ ɛ
wypróżnienie	v ɨ p r u ʐ ɲ ɛ ɲ ɛ
wypłacalny	v ɨ p w a t͡s a l n ɨ
wyrazy	v ɨ r a z ɨ
wyrolować	v ɨ r ɔ l ɔ v a t͡ɕ
wysokim	v ɨ s ɔ k i m
wysyłali	v ɨ s ɨ w a l i
wytypować	v ɨ t ɨ p ɔ v a t͡ɕ
wytłumaczyć	v ɨ t w u m a t͡ʂ ɨ t͡ɕ
wąsa	v ɔ w̃ s a
wędrowałyby	v ɛ n d r ɔ v a w ɨ b ɨ
władać	v w a d a t͡ɕ
włoskim	v w ɔ s k i m
włączałyście	v w ɔ n t͡ʂ a w ɨ ɕ t͡ɕ ɛ
zaciąży	z a t͡ɕ ɔ w̃ ʐ ɨ
zaczęli	z a t͡ʂ ɛ l i
zagnie	z a ɡ ɲ ɛ
zajazd	z a j a s t
zajęcze	z a j ɛ n t͡ʂ ɛ
zależne	z a l ɛ ʐ n ɛ
zamaczać	z a m a t͡ʂ a t͡ɕ
zamienny	z a m j ɛ n n ɨ
zamęt	z a m ɛ n t
zapadam	z a p a d a m
zaparty	z a p a r t ɨ
zapraszałbyś	z a p r a ʂ a w b ɨ ɕ
zaprzeczyć	z a p ʂ ɛ t͡ʂ ɨ t͡ɕ
zaprzęg	z a p ʂ ɛ ŋ k
zaradzić	z a r a d͡ʑ i t͡ɕ
zarżnąć	z a r ʐ n ɔ ɲ t͡ɕ
zasługiwanie	z a s w u ɡ i v a ɲ ɛ
zatok	z a t ɔ k
zatrać	z a t r a t͡ɕ
zatrzask	z a t ʂ a s k
zaufajcie	z a w f a j t͡ɕ ɛ
zaufali	z a w f a l i
zaufaliby	z a w f a l i b ɨ
zaufałbym	z a w f a w b ɨ m
zautoryzowałyby	z a w t ɔ r ɨ z ɔ v a w ɨ b ɨ
zawszę	z a f ʂ ɛ
zazielenianie	z a ʑ ɛ l ɛ ɲ a ɲ ɛ
zaśpiewanie	z a ɕ p j ɛ v a ɲ ɛ
zażegnywać	z a ʐ ɛ ɡ n ɨ v a t͡ɕ
zbaczać	z b a t͡ʂ a t͡ɕ
zbożu	z b ɔ ʐ u
zdubbingowały	z d a b i ŋ ɡ ɔ v a w ɨ
zgój	z ɡ u j
ziewałaby	ʑ ɛ v a w a b ɨ
zlepienie	z l ɛ p j ɛ ɲ ɛ
zmechacić	z m ɛ x a t͡ɕ i t͡ɕ
zmiatać	z m j a t a t͡ɕ
zmywarki	z m ɨ v a r k i
znajdowałybyście	z n a j d ɔ v a w ɨ b ɨ ɕ t͡ɕ ɛ
znakomitość	z n a k ɔ m i t ɔ ɕ t͡ɕ
zono	z ɔ n ɔ
zsyłać	s s ɨ w a t͡ɕ
zszywka	s ʂ ɨ f k a
zwani	z v a ɲ i
zwiedzałabym	z v j ɛ d͡z a w a b ɨ m
zwinnie	z v i n ɲ ɛ
złożeniom	z w ɔ ʐ ɛ ɲ ɔ m
złożonemu	z w ɔ ʐ ɔ n ɛ m u
łacha	w a x a
łachę	w a x ɛ
łagier	w a ɡ j ɛ r
łapią	w a p j ɔ w̃
łasce	w a s t͡s ɛ
łezka	w ɛ s k a
łonie	w ɔ ɲ ɛ
łono	w ɔ n ɔ
łotewsku	w ɔ t ɛ f s k u
łowie	w ɔ v j ɛ
łupiną	w u p i n ɔ w̃
łódź	w u t͡ɕ
ń	ɲ
Światłowicz	ɕ f j a t w ɔ v i t͡ʂ
ścierające	ɕ t͡ɕ ɛ r a j ɔ n t͡s ɛ
ścieraliby	ɕ t͡ɕ ɛ r a l i b ɨ
śnieguła	ɕ ɲ ɛ ɡ u w a
środku	ɕ r ɔ t k u
świerzbiec	ɕ f j ɛ ʐ b j ɛ t͡s
świntuch	ɕ f i n t u x
Żagań	ʐ a ɡ a ɲ
żabki	ʐ a p k i
żalu	ʐ a l u
żarnami	ʐ a r n a m i
żyjecie	ʐ ɨ j ɛ t͡ɕ ɛ
żyję	ʐ ɨ j ɛ
żyletko	ʐ ɨ l ɛ t k ɔ
żyrant	ʐ ɨ r a n t
żytu	ʐ ɨ t u
żyłeś	ʐ ɨ w ɛ ɕ
żądaniami	ʐ ɔ n d a ɲ a m i
żęłam	ʐ ɛ w a m
