ruralidad	r u ɾ a l i d a d
difónicas	d i f o n i k a s
cautelados	k a u t e l a d o s
proclamados	p ɾ o k l a m a d o s
abajáremos	a b a x a ɾ e m o s
paracaidista	p a ɾ a k a i d i s t a
comprará	k o m p ɾ a ɾ a
Cordillera	k o ɾ d i ʝ e ɾ a
desfogados	d e s f o ɡ a d o s
esprín	e s p ɾ i n
amigdalectomía	a m i ɡ d a l e ɡ t o m i a
Cardona	k a ɾ d o n a
insumir	i n s u m i ɾ
jugadas	x u ɡ a d a s
substituidos	s u b s t i t w i d o s
regido	r e x i d o
repostear	r e p o s t e a ɾ
disputáramos	d i s p u t a ɾ a m o s
libreta	l i b ɾ e t a
apellidada	a p e ʝ i d a d a
disputable	d i s p u t a b l e
solaré	s o l a ɾ e
notro	n o t ɾ o
estrígiles	e s t ɾ i x i l e s
tomatico	t o m a t i k o
leninistas	l e n i n i s t a s
angelino	a n x e l i n o
sopladas	s o p l a d a s
ahusados	a u s a d o s
onde	o n d e
desafecta	d e s a f e ɡ t a
fotografiados	f o t o ɡ ɾ a f j a d o s
traficante	t ɾ a f i k a n t e
parafraseadas	p a ɾ a f ɾ a s e a d a s
clic	k l i k
taponear	t a p o n e a ɾ
catalogadora	k a t a l o ɡ a d o ɾ a
andén	a n d e n
depredados	d e p ɾ e d a d o s
colectivista	k o l e ɡ t i b i s t a
trapera	t ɾ a p e ɾ a
deformar	d e f o ɾ m a ɾ
runa	r u n a
taquito	t a k i t o
fijar	f i x a ɾ
castigados	k a s t i ɡ a d o s
Tomasa	t o m a s a
monitorear	m o n i t o ɾ e a ɾ
cuasidelito	k w a s i d e l i t o
fosforilaras	f o s f o ɾ i l a ɾ a s
contrarrestadas	k o n t ɾ a r e s t a d a s
biodinámicos	b i o d i n a m i k o s
desintegrar	d e s i n t e ɡ ɾ a ɾ
malévolo	m a l e b o l o
autarquía	a u t a ɾ k i a
trapito	t ɾ a p i t o
germanio	x e ɾ m a n j o
hanguear	a n ɡ e a ɾ
fariano	f a ɾ j a n o
digestible	d i x e s t i b l e
adores	a d o ɾ e s
contrariado	k o n t ɾ a ɾ j a d o
presupuestario	p ɾ e s u p w e s t a ɾ j o
extrusiva	e ɡ s t ɾ u s i b a
bagual	b a ɡ w a l
Fani	f a n i
chapurreados	t͡ʃ a p u r e a d o s
baeneras	b a e n e ɾ a s
disparado	d i s p a ɾ a d o
nihilismo	n i i l i s m o
empoderadas	e m p o d e ɾ a d a s
putrefactas	p u t ɾ e f a ɡ t a s
anhedonia	a n e d o n j a
aduana	a d w a n a
sobresaltar	s o b ɾ e s a l t a ɾ
formaldehido	f o ɾ m a l d e i d o
ensalada	e n s a l a d a
abluidas	a b l w i d a s
ventoseado	b e n t o s e a d o
amillararemos	a m i ʝ a ɾ a ɾ e m o s
taheño	t a e ɲ o
Shanghái	ʃ a n ɡ a i
bebienda	b e b j e n d a
preaviso	p ɾ e a b i s o
calesa	k a l e s a
lamentaste	l a m e n t a s t e
hollado	o ʝ a d o
yudoca	ʝ u d o k a
nanorrobot	n a n o r o b o t
ilegitimidad	i l e x i t i m i d a d
detectados	d e t e ɡ t a d o s
indumentaria	i n d u m e n t a ɾ j a
alcano	a l k a n o
abastada	a b a s t a d a
comandados	k o m a n d a d o s
argüíais	a ɾ ɡ w i a i s
góndola	ɡ o n d o l a
puterío	p u t e ɾ i o
brótola	b ɾ o t o l a
resolladas	r e s o ʝ a d a s
artrósico	a ɾ t ɾ o s i k o
desagradadas	d e s a ɡ ɾ a d a d a s
agüé	a ɡ w e
farero	f a ɾ e ɾ o
reintensificado	r e i n t e n s i f i k a d o
pisamos	p i s a m o s
bolómetros	b o l o m e t ɾ o s
cantalupo	k a n t a l u p o
premeditar	p ɾ e m e d i t a ɾ
Araujo	a ɾ a u x o
mosquear	m o s k e a ɾ
agostino	a ɡ o s t i n o
pegón	p e ɡ o n
dinamita	d i n a m i t a
Pireo	p i ɾ e o
lama	l a m a
espectrómetros	e s p e ɡ t ɾ o m e t ɾ o s
alavesista	a l a b e s i s t a
Yoro	ʝ o ɾ o
emirato	e m i ɾ a t o
empapelar	e m p a p e l a ɾ
lisosómico	l i s o s o m i k o
ladrido	l a d ɾ i d o
jurídico	x u ɾ i d i k o
llamarlos	ʝ a m a ɾ l o s
cantándoos	k a n t a n d o o s
infiltrante	i n f i l t ɾ a n t e
atribular	a t ɾ i b u l a ɾ
prever	p ɾ e b e ɾ
chucho	t͡ʃ u t͡ʃ o
temblequeado	t e m b l e k e a d o
torrada	t o r a d a
indignidad	i n d i ɡ n i d a d
Marsella	m a ɾ s e ʝ a
alojara	a l o x a ɾ a
fisgoneados	f i s ɡ o n e a d o s
pavo	p a b o
rascador	r a s k a d o ɾ
aireadas	a i ɾ e a d a s
Cauquenes	k a u k e n e s
profundidad	p ɾ o f u n d i d a d
policromas	p o l i k ɾ o m a s
variables	b a ɾ j a b l e s
esponjaren	e s p o n x a ɾ e n
carcanapire	k a ɾ k a n a p i ɾ e
designado	d e s i ɡ n a d o
procrastinar	p ɾ o k ɾ a s t i n a ɾ
lobulillar	l o b u l i ʝ a ɾ
triptongo	t ɾ i b t o n ɡ o
garabateada	ɡ a ɾ a b a t e a d a
Majagua	m a x a ɡ w a
desnudamiento	d e s n u d a m j e n t o
vermiculadas	b e ɾ m i k u l a d a s
bodegonista	b o d e ɡ o n i s t a
choquear	t͡ʃ o k e a ɾ
avenarán	a b e n a ɾ a n
seriada	s e ɾ j a d a
programada	p ɾ o ɡ ɾ a m a d a
autobombeados	a u t o b o m b e a d o s
brasileñas	b ɾ a s i l e ɲ a s
otolito	o t o l i t o
m'ijo	m i x o
mielodisplasia	m j e l o d i s p l a s j a
consensuar	k o n s e n s w a ɾ
fileteada	f i l e t e a d a
resplandor	r e s p l a n d o ɾ
deletreada	d e l e t ɾ e a d a
deambuladas	d e a m b u l a d a s
oncohematológico	o n k o e m a t o l o x i k o
amentoflavona	a m e n t o f l a b o n a
empreñador	e m p ɾ e ɲ a d o ɾ
juguetonamente	x u ɡ e ˌt o n a m e n t e
monoaural	m o n o a u ɾ a l
labial	l a b j a l
operativo	o p e ɾ a t i b o
autónomos	a u t o n o m o s
capuchina	k a p u t͡ʃ i n a
desvirtuados	d e s b i ɾ t w a d o s
fornicamos	f o ɾ n i k a m o s
salteado	s a l t e a d o
alargamiento	a l a ɾ ɡ a m j e n t o
penúltima	p e n u l t i m a
elegible	e l e x i b l e
desglose	d e s ɡ l o s e
rapsoda	r a b s o d a
fontanería	f o n t a n e ɾ i a
semisedentario	s e m i s e d e n t a ɾ j o
patchwork	p a t͡ʃ w o ɾ k
flaubertianas	f l o b e ɾ t j a n a s
plantares	p l a n t a ɾ e s
imperará	i m p e ɾ a ɾ a
orbitadas	o ɾ b i t a d a s
ecléctico	e k l e ɡ t i k o
durados	d u ɾ a d o s
venerables	b e n e ɾ a b l e s
caed	k a e d
volcadas	b o l k a d a s
devotas	d e b o t a s
prestatario	p ɾ e s t a t a ɾ j o
hackearás	x a k e a ɾ a s
coreografiar	k o ɾ e o ɡ ɾ a f j a ɾ
esquivares	e s k i b a ɾ e s
okapi	o k a p i
tricoto	t ɾ i k o t o
riñón	r i ɲ o n
enfocados	e n f o k a d o s
reargüidas	r e a ɾ ɡ w i d a s
votará	b o t a ɾ a
disputador	d i s p u t a d o ɾ
tonos	t o n o s
remara	r e m a ɾ a
bilabial	b i l a b j a l
chequeados	t͡ʃ e k e a d o s
reinona	r e i n o n a
catadas	k a t a d a s
compartimentados	k o m p a ɾ t i m e n t a d o s
dentaria	d e n t a ɾ j a
encantadores	e n k a n t a d o ɾ e s
quebracho	k e b ɾ a t͡ʃ o
tirémoslas	t i ɾ e m o s l a s
galio	ɡ a l j o
limosneado	l i m o s n e a d o
babélica	b a b e l i k a
superaremos	s u p e ɾ a ɾ e m o s
cojinúa	k o x i n u a
mal	m a l
beguina	b e ɡ i n a
acábalos	a k a b a l o s
amenguados	a m e n ɡ w a d o s
pielero	p j e l e ɾ o
comprensivo	k o m p ɾ e n s i b o
opinas	o p i n a s
hipsómetros	i b s o m e t ɾ o s
panarabista	p a n a ɾ a b i s t a
chele	t͡ʃ e l e
elaborados	e l a b o ɾ a d o s
continuando	k o n t i n w a n d o
jactá	x a ɡ t a
derribar	d e r i b a ɾ
glaseado	ɡ l a s e a d o
mirla	m i ɾ l a
hidrométricas	i d ɾ o m e t ɾ i k a s
posesivos	p o s e s i b o s
espongiforme	e s p o n x i f o ɾ m e
twittero	t w i t e ɾ o
hidrográfico	i d ɾ o ɡ ɾ a f i k o
vieran	b j e ɾ a n
cuico	k w i k o
subida	s u b i d a
litigares	l i t i ɡ a ɾ e s
retirado	r e t i ɾ a d o
paliada	p a l j a d a
redimidos	r e d i m i d o s
solerlo	s o l e ɾ l o
divinado	d i b i n a d o
banqueteada	b a n k e t e a d a
hubimos	u b i m o s
cal	k a l
definiríamos	d e f i n i ɾ i a m o s
transparente	t ɾ a n s p a ɾ e n t e
torpedeados	t o ɾ p e d e a d o s
criopreservadas	k ɾ j o p ɾ e s e ɾ b a d a s
escalonar	e s k a l o n a ɾ
haríamos	a ɾ i a m o s
chontaduro	t͡ʃ o n t a d u ɾ o
gramatical	ɡ ɾ a m a t i k a l
skúa	e s k u a
engallar	e n ɡ a ʝ a ɾ
bonarda	b o n a ɾ d a
coexistir	k o e ɡ s i s t i ɾ
oncológica	o n k o l o x i k a
vístanlo	b i s t a n l o
afanosas	a f a n o s a s
andaos	a n d a o s
vengados	b e n ɡ a d o s
caligrafiados	k a l i ɡ ɾ a f j a d o s
descuajar	d e s k w a x a ɾ
depilar	d e p i l a ɾ
sauna	s a u n a
amoldable	a m o l d a b l e
padrear	p a d ɾ e a ɾ
surreal	s u r e a l
trovero	t ɾ o b e ɾ o
dialogadas	d j a l o ɡ a d a s
alcantarillar	a l k a n t a ɾ i ʝ a ɾ
Enka	e n k a
tántalo	t a n t a l o
sudanés	s u d a n e s
tened	t e n e d
atutía	a t u t i a
sobrescribir	s o b ɾ e s k ɾ i b i ɾ
enferma	e n f e ɾ m a
Donaire	d o n a i ɾ e
aborregabais	a b o r e ɡ a b a i s
Natan	n a t a n
aviará	a b j a ɾ a
interna	i n t e ɾ n a
Helios	e l j o s
hábito	a b i t o
metros	m e t ɾ o s
biflagelado	b i f l a x e l a d o
arquear	a ɾ k e a ɾ
soleros	s o l e ɾ o s
nada	n a d a
multáramos	m u l t a ɾ a m o s
alongadas	a l o n ɡ a d a s
numerable	n u m e ɾ a b l e
abadernabais	a b a d e ɾ n a b a i s
permutarás	p e ɾ m u t a ɾ a s
correaje	k o r e a x e
vesicante	b e s i k a n t e
oleados	o l e a d o s
calares	k a l a ɾ e s
matula	m a t u l a
ayuno	a ʝ u n o
Goliat	ɡ o l j a t
tardadas	t a ɾ d a d a s
sacristía	s a k ɾ i s t i a
eslalon	e s l a l o n
aglomeradas	a ɡ l o m e ɾ a d a s
raídas	r a i d a s
homofóbico	o m o f o b i k o
desbarrancadas	d e s b a r a n k a d a s
churruscar	t͡ʃ u r u s k a ɾ
adherir	a d e ɾ i ɾ
sunroof	s a n r u f
aglutinar	a ɡ l u t i n a ɾ
gastrina	ɡ a s t ɾ i n a
fornicada	f o ɾ n i k a d a
pausadas	p a u s a d a s
peligro	p e l i ɡ ɾ o
colofón	k o l o f o n
embarulladas	e m b a ɾ u ʝ a d a s
conjurar	k o n x u ɾ a ɾ
vedarme	b e d a ɾ m e
Jaca	x a k a
arraigar	a r a i ɡ a ɾ
alante	a l a n t e
dalia	d a l j a
jacau	x a k a u
codifiques	k o d i f i k e s
lisar	l i s a ɾ
IFE	i f e
colegido	k o l e x i d o
cultivo	k u l t i b o
escavar	e s k a b a ɾ
girado	x i ɾ a d o
escamotear	e s k a m o t e a ɾ
angulados	a n ɡ u l a d o s
avenasen	a b e n a s e n
lastimar	l a s t i m a ɾ
yukpa	ʝ u ɡ p a
argentina	a ɾ x e n t i n a
autómata	a u t o m a t a
parasailing	p a ɾ a s e i l i n
difractada	d i f ɾ a ɡ t a d a
hipocraterimorfo	i p o k ɾ a t e ɾ i m o ɾ f o
condenado	k o n d e n a d o
mentecatos	m e n t e k a t o s
cardíaco	k a ɾ d i a k o
enseñado	e n s e ɲ a d o
contristado	k o n t ɾ i s t a d o
padouca	p a d o u k a
koala	k o a l a
compensadas	k o m p e n s a d a s
desincorporar	d e s i n k o ɾ p o ɾ a ɾ
pluvioso	p l u b j o s o
confesora	k o n f e s o ɾ a
victoreada	b i ɡ t o ɾ e a d a
villalbés	b i ʝ a l b e s
impetrado	i m p e t ɾ a d o
alcaldada	a l k a l d a d a
tascó	t a s k o
yuxtaponer	ʝ u ɡ s t a p o n e ɾ
archivado	a ɾ t͡ʃ i b a d o
achorar	a t͡ʃ o ɾ a ɾ
abañadas	a b a ɲ a d a s
posibles	p o s i b l e s
depósitos	d e p o s i t o s
tiritada	t i ɾ i t a d a
abarrares	a b a r a ɾ e s
costearíamos	k o s t e a ɾ i a m o s
amohinadas	a m o i n a d a s
sobresalir	s o b ɾ e s a l i ɾ
Almaguer	a l m a ɡ e ɾ
tururú	t u ɾ u ɾ u
atravesar	a t ɾ a b e s a ɾ
sobresaltadas	s o b ɾ e s a l t a d a s
abacoras	a b a k o ɾ a s
intrigados	i n t ɾ i ɡ a d o s
desasosegado	d e s a s o s e ɡ a d o
alojar	a l o x a ɾ
bahaísmo	b a a i s m o
minúscula	m i n u s k u l a
extendidas	e ɡ s t e n d i d a s
aserrados	a s e r a d o s
solad	s o l a d
forjadura	f o ɾ x a d u ɾ a
compurgar	k o m p u ɾ ɡ a ɾ
ascua	a s k w a
extermino	e ɡ s t e ɾ m i n o
regladas	r e ɡ l a d a s
retreparse	r e t ɾ e p a ɾ s e
chingongo	t͡ʃ i n ɡ o n ɡ o
fondeados	f o n d e a d o s
modifico	m o d i f i k o
Canuto	k a n u t o
Tagle	t a ɡ l e
tijereteo	t i x e ɾ e t e o
nacas	n a k a s
supuesto	s u p w e s t o
presa	p ɾ e s a
amartillado	a m a ɾ t i ʝ a d o
acostaste	a k o s t a s t e
súcubo	s u k u b o
alumnado	a l u m n a d o
intervalo	i n t e ɾ b a l o
semiarco	s e m j a ɾ k o
refrendadas	r e f ɾ e n d a d a s
psicofisiología	s i k o f i s j o l o x i a
encanijar	e n k a n i x a ɾ
desgarrante	d e s ɡ a r a n t e
agusánese	a ɡ u s a n e s e
coescriptas	k o e s k ɾ i b t a s
Blas	b l a s
bamba	b a m b a
Torralba	t o r a l b a
ventilar	b e n t i l a ɾ
Rojas	r o x a s
trastabillear	t ɾ a s t a b i ʝ e a ɾ
tortures	t o ɾ t u ɾ e s
anestesiados	a n e s t e s j a d o s
estadísticamente	e s t a ˌd i s t i k a m e n t e
roca	r o k a
columbrado	k o l u m b ɾ a d o
lamela	l a m e l a
lavando	l a b a n d o
soldadesco	s o l d a d e s k o
grato	ɡ ɾ a t o
penco	p e n k o
envolver	e m b o l b e ɾ
mixturamos	m i ɡ s t u ɾ a m o s
fibroso	f i b ɾ o s o
hiladora	i l a d o ɾ a
vivaqueada	b i b a k e a d a
bufónico	b u f o n i k o
chocoano	t͡ʃ o k o a n o
caricatures	k a ɾ i k a t u ɾ e s
granjeada	ɡ ɾ a n x e a d a
adquirible	a d k i ɾ i b l e
Laurel	l a u ɾ e l
enviar	e m b j a ɾ
hipogastrio	i p o ɡ a s t ɾ j o
periquitos	p e ɾ i k i t o s
playas	p l a ʝ a s
abreviara	a b ɾ e b j a ɾ a
desclasificado	d e s k l a s i f i k a d o
follable	f o ʝ a b l e
desembrujada	d e s e m b ɾ u x a d a
aguador	a ɡ w a d o ɾ
palatino	p a l a t i n o
estriada	e s t ɾ j a d a
guiñadas	ɡ i ɲ a d a s
hemínico	e m i n i k o
gobernados	ɡ o b e ɾ n a d o s
pendíamos	p e n d i a m o s
ponchadora	p o n t͡ʃ a d o ɾ a
hilandera	i l a n d e ɾ a
conjuntadas	k o n x u n t a d a s
atemos	a t e m o s
Yara	ʝ a ɾ a
enagua	e n a ɡ w a
trancado	t ɾ a n k a d o
concuñada	k o n k u ɲ a d a
hipertensión	i p e ɾ t e n s j o n
Fuerteventura	f w e ɾ t e b e n t u ɾ a
administráramos	a d m i n i s t ɾ a ɾ a m o s
pájaros	p a x a ɾ o s
optrónico	o b t ɾ o n i k o
emolientero	e m o l j e n t e ɾ o
alguien	a l ɡ j e n
cabreada	k a b ɾ e a d a
Alexandrescu	a l e ɡ s a n d ɾ e s k u
amplificado	a m p l i f i k a d o
bifurcado	b i f u ɾ k a d o
colador	k o l a d o ɾ
náuticas	n a u t i k a s
revalidadas	r e b a l i d a d a s
ballesta	b a ʝ e s t a
cagona	k a ɡ o n a
varsoviano	b a ɾ s o b j a n o
completamos	k o m p l e t a m o s
monárquica	m o n a ɾ k i k a
consultar	k o n s u l t a ɾ
licopodio	l i k o p o d j o
pastes	p a s t e s
diana	d j a n a
lacón	l a k o n
extracto	e ɡ s t ɾ a ɡ t o
apararás	a p a ɾ a ɾ a s
polirritmia	p o l i r i d m j a
decolorados	d e k o l o ɾ a d o s
sucursalista	s u k u ɾ s a l i s t a
singular	s i n ɡ u l a ɾ
influjo	i n f l u x o
dietilo	d j e t i l o
abate	a b a t e
tricotaren	t ɾ i k o t a ɾ e n
abaluartar	a b a l w a ɾ t a ɾ
desprotegida	d e s p ɾ o t e x i d a
sublimado	s u b l i m a d o
coordinadas	k o o ɾ d i n a d a s
detergidas	d e t e ɾ x i d a s
afluir	a f l w i ɾ
frentista	f ɾ e n t i s t a
limpiador	l i m p j a d o ɾ
remoloneada	r e m o l o n e a d a
petipuá	p e t i p w a
has	a s
evangelio	e b a n x e l j o
tético	t e t i k o
arbitramento	a ɾ b i t ɾ a m e n t o
presentes	p ɾ e s e n t e s
añadir	a ɲ a d i ɾ
Némesis	n e m e s i s
fosforosa	f o s f o ɾ o s a
mensurar	m e n s u ɾ a ɾ
chaquetita	t͡ʃ a k e t i t a
copada	k o p a d a
arraigado	a r a i ɡ a d o
consultaremos	k o n s u l t a ɾ e m o s
estruja	e s t ɾ u x a
provicario	p ɾ o b i k a ɾ j o
Argentina	a ɾ x e n t i n a
trilema	t ɾ i l e m a
brie	b ɾ i
oyó	o ʝ o
almiar	a l m j a ɾ
cosmópolis	k o s m o p o l i s
kineses	k i n e s e s
afirmemos	a f i ɾ m e m o s
psicoterapias	s i k o t e ɾ a p j a s
sajón	s a x o n
pun	p u n
legítima	l e x i t i m a
rabiada	r a b j a d a
fonda	f o n d a
díganla	d i ɡ a n l a
alboreada	a l b o ɾ e a d a
mentirosa	m e n t i ɾ o s a
matas	m a t a s
radiculopatías	r a d i k u l o p a t i a s
confirmareis	k o n f i ɾ m a ɾ e i s
envainadoras	e m b a i n a d o ɾ a s
allí	a ʝ i
etnologías	e d n o l o x i a s
nectáreas	n e ɡ t a ɾ e a s
vételo	b e t e l o
coexista	k o e ɡ s i s t a
italófonos	i t a l o f o n o s
sanguinolentos	s a n ɡ i n o l e n t o s
indefenso	i n d e f e n s o
gatear	ɡ a t e a ɾ
tratamos	t ɾ a t a m o s
exageres	e ɡ s a x e ɾ e s
inquisidora	i n k i s i d o ɾ a
saquete	s a k e t e
encarnados	e n k a ɾ n a d o s
adrenalínico	a d ɾ e n a l i n i k o
restauraste	r e s t a u ɾ a s t e
gráfico	ɡ ɾ a f i k o
pronósticos	p ɾ o n o s t i k o s
resondrar	r e s o n d ɾ a ɾ
moraste	m o ɾ a s t e
afiebrada	a f j e b ɾ a d a
fundidas	f u n d i d a s
argumentes	a ɾ ɡ u m e n t e s
cánones	k a n o n e s
englobadas	e n ɡ l o b a d a s
adiando	a d j a n d o
argüimos	a ɾ ɡ w i m o s
biotecnóloga	b j o t e ɡ n o l o ɡ a
parlas	p a ɾ l a s
inhabitable	i n a b i t a b l e
funicular	f u n i k u l a ɾ
invernaderos	i m b e ɾ n a d e ɾ o s
hipovolémicas	i p o b o l e m i k a s
reparemos	r e p a ɾ e m o s
fenghuang	f e n x w a n
haríais	a ɾ i a i s
esotéricas	e s o t e ɾ i k a s
endrogado	e n d ɾ o ɡ a d o
adehesar	a d e e s a ɾ
ronda	r o n d a
próximo	p ɾ o ɡ s i m o
marihuanas	m a ɾ i w a n a s
estrafalario	e s t ɾ a f a l a ɾ j o
portera	p o ɾ t e ɾ a
diría	d i ɾ i a
laudados	l a u d a d o s
conejito	k o n e x i t o
toloache	t o l o a t͡ʃ e
vestidura	b e s t i d u ɾ a
endocrino	e n d o k ɾ i n o
donada	d o n a d a
reseñada	r e s e ɲ a d a
venteadas	b e n t e a d a s
ahechados	a e t͡ʃ a d o s
exhalar	e ɡ s a l a ɾ
respaldados	r e s p a l d a d o s
abortar	a b o ɾ t a ɾ
benigna	b e n i ɡ n a
amputadas	a m p u t a d a s
acotolados	a k o t o l a d o s
complique	k o m p l i k e
horneadas	o ɾ n e a d a s
sinoestadounidense	s i n o e s t a d o u n i d e n s e
Tato	t a t o
Ybarra	i b a r a
gorrón	ɡ o r o n
desabejar	d e s a b e x a ɾ
vedarte	b e d a ɾ t e
angostados	a n ɡ o s t a d o s
hablémoos	a b l e m o o s
rockismo	r o k i s m o
tintineo	t i n t i n e o
suyos	s u ʝ o s
repoblar	r e p o b l a ɾ
tatuada	t a t w a d a
protesta	p ɾ o t e s t a
descocada	d e s k o k a d a
atrayente	a t ɾ a ʝ e n t e
plastificaríamos	p l a s t i f i k a ɾ i a m o s
mercurio	m e ɾ k u ɾ j o
culito	k u l i t o
Putumayo	p u t u m a ʝ o
embebidos	e m b e b i d o s
enjertal	e n x e ɾ t a l
enfriadas	e n f ɾ j a d a s
estratigrafía	e s t ɾ a t i ɡ ɾ a f i a
amaestrados	a m a e s t ɾ a d o s
habrás	a b ɾ a s
prontito	p ɾ o n t i t o
retromandibular	r e t ɾ o m a n d i b u l a ɾ
guardoso	ɡ w a ɾ d o s o
apabullados	a p a b u ʝ a d o s
antropomórficas	a n t ɾ o p o m o ɾ f i k a s
inopia	i n o p j a
lenón	l e n o n
calvito	k a l b i t o
diletante	d i l e t a n t e
anfipáticos	a n f i p a t i k o s
radal	r a d a l
atenido	a t e n i d o
alérgeno	a l e ɾ x e n o
comilón	k o m i l o n
alegal	a l e ɡ a l
gloriareis	ɡ l o ɾ j a ɾ e i s
acondroplasia	a k o n d ɾ o p l a s j a
Crono	k ɾ o n o
tripolitano	t ɾ i p o l i t a n o
reasentar	r e a s e n t a ɾ
astrosas	a s t ɾ o s a s
debías	d e b i a s
abstuviste	a b s t u b i s t e
subdividir	s u b d i b i d i ɾ
Luis	l w i s
obsoleta	o b s o l e t a
subactuar	s u b a ɡ t w a ɾ
esculpida	e s k u l p i d a
normativismo	n o ɾ m a t i b i s m o
honores	o n o ɾ e s
soltamos	s o l t a m o s
abordadas	a b o ɾ d a d a s
laso	l a s o
falisco	f a l i s k o
pesqueras	p e s k e ɾ a s
guayadas	ɡ w a ʝ a d a s
pajúos	p a x u o s
cantémoslos	k a n t e m o s l o s
lijadas	l i x a d a s
atestar	a t e s t a ɾ
melotrón	m e l o t ɾ o n
ulco	u l k o
corneadas	k o ɾ n e a d a s
denotaríamos	d e n o t a ɾ i a m o s
prologal	p ɾ o l o ɡ a l
desentender	d e s e n t e n d e ɾ
trasegador	t ɾ a s e ɡ a d o ɾ
abaluartares	a b a l w a ɾ t a ɾ e s
intelectualismo	i n t e l e ɡ t w a l i s m o
acompañante	a k o m p a ɲ a n t e
viéndote	b j e n d o t e
pinate	p i n a t e
auto	a u t o
asolada	a s o l a d a
alimaña	a l i m a ɲ a
andémoste	a n d e m o s t e
libadas	l i b a d a s
eritema	e ɾ i t e m a
trajinados	t ɾ a x i n a d o s
senador	s e n a d o ɾ
indómitas	i n d o m i t a s
rematado	r e m a t a d o
desdoblado	d e s d o b l a d o
erre	e r e
autosaboteados	a u t o s a b o t e a d o s
fiteogeográfico	f i t e o x e o ɡ ɾ a f i k o
contactes	k o n t a ɡ t e s
abaldonases	a b a l d o n a s e s
hemispingo	e m i s p i n ɡ o
presididos	p ɾ e s i d i d o s
copernicanos	k o p e ɾ n i k a n o s
babosada	b a b o s a d a
inexplicables	i n e ɡ s p l i k a b l e s
aseverado	a s e b e ɾ a d o
destocadas	d e s t o k a d a s
amurar	a m u ɾ a ɾ
anguladas	a n ɡ u l a d a s
mostrará	m o s t ɾ a ɾ a
robre	r o b ɾ e
articulado	a ɾ t i k u l a d o
sófora	s o f o ɾ a
explayados	e ɡ s p l a ʝ a d o s
expansionar	e ɡ s p a n s j o n a ɾ
bicroma	b i k ɾ o m a
histoquímicas	i s t o k i m i k a s
procurares	p ɾ o k u ɾ a ɾ e s
respiras	r e s p i ɾ a s
crocodiliforme	k ɾ o k o d i l i f o ɾ m e
abandonista	a b a n d o n i s t a
endodérmico	e n d o d e ɾ m i k o
investigadoras	i m b e s t i ɡ a d o ɾ a s
extraacadémica	e ɡ s t ɾ a a k a d e m i k a
yaracuyano	ʝ a ɾ a k u ʝ a n o
Atlanta	a t l a n t a
ahondada	a o n d a d a
avasallados	a b a s a ʝ a d o s
animaras	a n i m a ɾ a s
lubrificá	l u b ɾ i f i k a
liberta	l i b e ɾ t a
guitarra	ɡ i t a r a
mártaga	m a ɾ t a ɡ a
cartografiados	k a ɾ t o ɡ ɾ a f j a d o s
reflectadas	r e f l e ɡ t a d a s
costoso	k o s t o s o
troglodítica	t ɾ o ɡ l o d i t i k a
pastito	p a s t i t o
dihueñe	d i w e ɲ e
huaca	w̝ a k a
nigroestriados	n i ɡ ɾ o e s t ɾ j a d o s
otaku	o t a k u
confortamos	k o n f o ɾ t a m o s
involutivos	i m b o l u t i b o s
sedes	s e d e s
búlgara	b u l ɡ a ɾ a
skopiote	e s k o p j o t e
microendémico	m i k ɾ o e n d e m i k o
agendada	a x e n d a d a
trasliteradas	t ɾ a s l i t e ɾ a d a s
neoplateresco	n e o p l a t e ɾ e s k o
sugestionable	s u x e s t j o n a b l e
decretadas	d e k ɾ e t a d a s
reverberaréis	r e b e ɾ b e ɾ a ɾ e i s
limada	l i m a d a
pyme	p i m e
siútico	s j u t i k o
anglocatólica	a n ɡ l o k a t o l i k a
regeneras	r e x e n e ɾ a s
bebería	b e b e ɾ i a
recalificada	r e k a l i f i k a d a
aparado	a p a ɾ a d o
bonificadas	b o n i f i k a d a s
pocheadas	p o t͡ʃ e a d a s
ufanados	u f a n a d o s
mate	m a t e
sagitada	s a x i t a d a
persistidas	p e ɾ s i s t i d a s
enfurruñados	e n f u r u ɲ a d o s
tabicadas	t a b i k a d a s
connatural	k o n n a t u ɾ a l
desvividas	d e s b i b i d a s
demolidos	d e m o l i d o s
pipada	p i p a d a
ateísmo	a t e i s m o
alcapurria	a l k a p u r j a
abaldóneles	a b a l d o n e l e s
psicosomático	s i k o s o m a t i k o
donas	d o n a s
lapo	l a p o
enumerado	e n u m e ɾ a d o
protesto	p ɾ o t e s t o
indivisibilidad	i n d i b i s i b i l i d a d
trebolito	t ɾ e b o l i t o
abrevadero	a b ɾ e b a d e ɾ o
impulsivas	i m p u l s i b a s
aquilón	a k i l o n
desolladora	d e s o ʝ a d o ɾ a
palladiano	p a ʝ a d j a n o
abacoraseis	a b a k o ɾ a s e i s
padrino	p a d ɾ i n o
salón	s a l o n
susurrar	s u s u r a ɾ
sicofanta	s i k o f a n t a
playeras	p l a ʝ e ɾ a s
ey	e i
deleitadas	d e l e i t a d a s
hubiese	u b j e s e
cajón	k a x o n
humita	u m i t a
disuadida	d i s w a d i d a
actitudinal	a ɡ t i t u d i n a l
masculina	m a s k u l i n a
astragalinos	a s t ɾ a ɡ a l i n o s
samba	s a m b a
indisimulada	i n d i s i m u l a d a
abandonamiento	a b a n d o n a m j e n t o
vagaríamos	b a ɡ a ɾ i a m o s
hipoclorador	i p o k l o ɾ a d o ɾ
enherbolar	e n e ɾ b o l a ɾ
aminopeptidasa	a m i n o p e b t i d a s a
propendida	p ɾ o p e n d i d a
recurvadas	r e k u ɾ b a d a s
égloga	e ɡ l o ɡ a
acholados	a t͡ʃ o l a d o s
aculados	a k u l a d o s
debámosla	d e b a m o s l a
polígloto	p o l i ɡ l o t o
respiré	r e s p i ɾ e
socarronería	s o k a r o n e ɾ i a
carpinteril	k a ɾ p i n t e ɾ i l
chip	t͡ʃ i p
destituidos	d e s t i t w i d o s
bregue	b ɾ e ɡ e
bohrio	b o ɾ j o
metra	m e t ɾ a
angloamericanas	a n ɡ l o a m e ɾ i k a n a s
intentada	i n t e n t a d a
michoacanos	m i t͡ʃ o a k a n o s
audible	a u d i b l e
pedorreadas	p e d o r e a d a s
multitudinaria	m u l t i t u d i n a ɾ j a
igualado	i ɡ w a l a d o
fonsadera	f o n s a d e ɾ a
paremos	p a ɾ e m o s
minicomponente	m i n i k o m p o n e n t e
substitutivo	s u b s t i t u t i b o
cantándoles	k a n t a n d o l e s
piados	p j a d o s
pinball	p i m b a l
voltaicos	b o l t a i k o s
amariconado	a m a ɾ i k o n a d o
cantarlos	k a n t a ɾ l o s
tajantemente	t a ˌx a n t e m e n t e
ánsara	a n s a ɾ a
alumbre	a l u m b ɾ e
pedrisco	p e d ɾ i s k o
general	x e n e ɾ a l
flojo	f l o x o
grande	ɡ ɾ a n d e
perfume	p e ɾ f u m e
Ximena	x i m e n a
conuco	k o n u k o
fosforilaríamos	f o s f o ɾ i l a ɾ i a m o s
mangoneada	m a n ɡ o n e a d a
régimen	r e x i m e n
abacoraremos	a b a k o ɾ a ɾ e m o s
calibrada	k a l i b ɾ a d a
sangra	s a n ɡ ɾ a
autoantónimo	a u t o a n t o n i m o
pendejeadas	p e n d e x e a d a s
tests	t e s t s
bala	b a l a
carintia	k a ɾ i n t j a
Alexópulos	a l e ɡ s o p u l o s
caudillo	k a u d i ʝ o
corte	k o ɾ t e
nasosinusales	n a s o s i n u s a l e s
metronómico	m e t ɾ o n o m i k o
vestido	b e s t i d o
animosas	a n i m o s a s
contestatario	k o n t e s t a t a ɾ j o
cromatográficos	k ɾ o m a t o ɡ ɾ a f i k o s
conecte	k o n e ɡ t e
inaudible	i n a u d i b l e
mironeo	m i ɾ o n e o
superares	s u p e ɾ a ɾ e s
Pegaso	p e ɡ a s o
escudriñadores	e s k u d ɾ i ɲ a d o ɾ e s
abnegamos	a b n e ɡ a m o s
valentona	b a l e n t o n a
prístinas	p ɾ i s t i n a s
subsumido	s u b s u m i d o
ejemplo	e x e m p l o
desordenar	d e s o ɾ d e n a ɾ
pavonearse	p a b o n e a ɾ s e
hasta	a s t a
germanísticos	x e ɾ m a n i s t i k o s
enemistar	e n e m i s t a ɾ
trofoblasto	t ɾ o f o b l a s t o
regalada	r e ɡ a l a d a
patovica	p a t o b i k a
Lisandro	l i s a n d ɾ o
jeringadas	x e ɾ i n ɡ a d a s
afectaste	a f e ɡ t a s t e
arlequinado	a ɾ l e k i n a d o
seríamos	s e ɾ i a m o s
islandeses	i s l a n d e s e s
oviraptorosaurio	o b i ɾ a b t o ɾ o s a u ɾ j o
abrupto	a b ɾ u b t o
trianguladas	t ɾ j a n ɡ u l a d a s
transcurrido	t ɾ a n s k u r i d o
dríade	d ɾ i a d e
envión	e m b j o n
amén	a m e n
camarín	k a m a ɾ i n
mara	m a ɾ a
abjurando	a b x u ɾ a n d o
carroñero	k a r o ɲ e ɾ o
eufemísticas	e u f e m i s t i k a s
laudo	l a u d o
ansiada	a n s j a d a
semblar	s e m b l a ɾ
incautadas	i n k a u t a d a s
pacará	p a k a ɾ a
falafel	f a l a f e l
acunados	a k u n a d o s
cosido	k o s i d o
poderío	p o d e ɾ i o
relojería	r e l o x e ɾ i a
pornificar	p o ɾ n i f i k a ɾ
Tarso	t a ɾ s o
fichados	f i t͡ʃ a d o s
Merino	m e ɾ i n o
usuluteca	u s u l u t e k a
campar	k a m p a ɾ
Inesita	i n e s i t a
afroestadounidenses	a f ɾ o e s t a d o u n i d e n s e s
barriera	b a r j e ɾ a
contento	k o n t e n t o
glicosídico	ɡ l i k o s i d i k o
utrera	u t ɾ e ɾ a
aojada	a o x a d a
admire	a d m i ɾ e
acuanautas	a k w a n a u t a s
embrujada	e m b ɾ u x a d a
listado	l i s t a d o
lacaya	l a k a ʝ a
dañados	d a ɲ a d o s
titiladas	t i t i l a d a s
terral	t e r a l
carteadas	k a ɾ t e a d a s
correísmo	k o r e i s m o
Remigio	r e m i x j o
mandril	m a n d ɾ i l
cuatribanda	k w a t ɾ i b a n d a
vivada	b i b a d a
muerteabas	m w e ɾ t e a b a s
llevar	ʝ e b a ɾ
linkbuilding	l i n ɡ b i l d i n
incorpóreos	i n k o ɾ p o ɾ e o s
titiriteadlo	t i t i ɾ i t e a d l o
malentendida	m a l e n t e n d i d a
lúbrico	l u b ɾ i k o
carlinga	k a ɾ l i n ɡ a
constatable	k o n s t a t a b l e
leído	l e i d o
edentado	e d e n t a d o
baremado	b a ɾ e m a d o
perpetrador	p e ɾ p e t ɾ a d o ɾ
deslustrada	d e s l u s t ɾ a d a
consellera	k o n s e ʝ e ɾ a
nosología	n o s o l o x i a
afectaras	a f e ɡ t a ɾ a s
acatados	a k a t a d o s
banqueteadas	b a n k e t e a d a s
arbusto	a ɾ b u s t o
inventes	i m b e n t e s
legitimando	l e x i t i m a n d o
empatada	e m p a t a d a
quimioterápico	k i m j o t e ɾ a p i k o
aviando	a b j a n d o
forradito	f o r a d i t o
profanidad	p ɾ o f a n i d a d
ludido	l u d i d o
supracondílea	s u p ɾ a k o n d i l e a
simplificareis	s i m p l i f i k a ɾ e i s
locutivo	l o k u t i b o
torturadas	t o ɾ t u ɾ a d a s
muerte	m w e ɾ t e
engelamiento	e n x e l a m j e n t o
paniaguado	p a n j a ɡ w a d o
palindrómico	p a l i n d ɾ o m i k o
pinillos	p i n i ʝ o s
charquito	t͡ʃ a ɾ k i t o
temerá	t e m e ɾ a
hablaste	a b l a s t e
gantés	ɡ a n t e s
cloroalquino	k l o ɾ o a l k i n o
quitadas	k i t a d a s
virareis	b i ɾ a ɾ e i s
espíritu	e s p i ɾ i t u
yuracaré	ʝ u ɾ a k a ɾ e
hemorragia	e m o r a x j a
pulcros	p u l k ɾ o s
fiques	f i k e s
avíape	a b i a p e
consejera	k o n s e x e ɾ a
santeros	s a n t e ɾ o s
glosásemos	ɡ l o s a s e m o s
bestseller	b e s t s e l e ɾ
nefríticos	n e f ɾ i t i k o s
erosionable	e ɾ o s j o n a b l e
dominiquesa	d o m i n i k e s a
descarboxiladas	d e s k a ɾ b o ɡ s i l a d a s
anfipática	a n f i p a t i k a
neoyorquino	n e o ʝ o ɾ k i n o
fenomenológica	f e n o m e n o l o x i k a
alienante	a l j e n a n t e
colegida	k o l e x i d a
flan	f l a n
tenías	t e n i a s
condene	k o n d e n e
habiéndoos	a b j e n d o o s
mortificado	m o ɾ t i f i k a d o
sondeados	s o n d e a d o s
globalismos	ɡ l o b a l i s m o s
Radulescu	r a d u l e s k u
rictus	r i ɡ t u s
tirrena	t i r e n a
punibilidad	p u n i b i l i d a d
Salaverria	s a l a b e r j a
skyline	e s k a i l a i n
reprogramados	r e p ɾ o ɡ ɾ a m a d o s
odontológicas	o d o n t o l o x i k a s
nativos	n a t i b o s
travestidos	t ɾ a b e s t i d o s
planeada	p l a n e a d a
esteparia	e s t e p a ɾ j a
junte	x u n t e
asperjados	a s p e ɾ x a d o s
fagosoma	f a ɡ o s o m a
soros	s o ɾ o s
pésimo	p e s i m o
desbaratadas	d e s b a ɾ a t a d a s
acompañada	a k o m p a ɲ a d a
respuesta	r e s p w e s t a
quisiste	k i s i s t e
rebuscado	r e b u s k a d o
complicadas	k o m p l i k a d a s
disgustado	d i s ɡ u s t a d o
deludir	d e l u d i ɾ
hablándoles	a b l a n d o l e s
modificativas	m o d i f i k a t i b a s
tañedora	t a ɲ e d o ɾ a
vendimiados	b e n d i m j a d o s
destacados	d e s t a k a d o s
ñera	ɲ e ɾ a
orladas	o ɾ l a d a s
animada	a n i m a d a
residente	r e s i d e n t e
evitar	e b i t a ɾ
cochambre	k o t͡ʃ a m b ɾ e
Carbajal	k a ɾ b a x a l
naturalidad	n a t u ɾ a l i d a d
paliatorio	p a l j a t o ɾ j o
fitomorfa	f i t o m o ɾ f a
hermeneútica	e ɾ m e n e u t i k a
encharcado	e n t͡ʃ a ɾ k a d o
árbol	a ɾ b o l
narval	n a ɾ b a l
seamos	s e a m o s
ricos	r i k o s
aplicable	a p l i k a b l e
algometría	a l ɡ o m e t ɾ i a
argüiríais	a ɾ ɡ w i ɾ i a i s
hiperpotasemias	i p e ɾ p o t a s e m j a s
abreviadas	a b ɾ e b j a d a s
carpetana	k a ɾ p e t a n a
vagues	b a ɡ e s
vallada	b a ʝ a d a
expresados	e ɡ s p ɾ e s a d o s
consenso	k o n s e n s o
mefistofélico	m e f i s t o f e l i k o
tartamudeada	t a ɾ t a m u d e a d a
rotular	r o t u l a ɾ
psicopompo	s i k o p o m p o
chisporroteado	t͡ʃ i s p o r o t e a d o
gerontología	x e ɾ o n t o l o x i a
nefarias	n e f a ɾ j a s
arromo	a r o m o
fastidiosas	f a s t i d j o s a s
anacarado	a n a k a ɾ a d o
pergeñado	p e ɾ x e ɲ a d o
unir	u n i ɾ
prometida	p ɾ o m e t i d a
develado	d e b e l a d o
desprendida	d e s p ɾ e n d i d a
antiindustrial	a n t i i n d u s t ɾ j a l
adiabático	a d j a b a t i k o
mediodía	m e d j o d i a
medallita	m e d a ʝ i t a
aditividad	a d i t i b i d a d
aniquilar	a n i k i l a ɾ
tardar	t a ɾ d a ɾ
pterodactiloide	t e ɾ o d a ɡ t i l o i d e
Carreño	k a r e ɲ o
desayunada	d e s a ʝ u n a d a
pelirrojo	p e l i r o x o
Montellano	m o n t e ʝ a n o
misionero	m i s j o n e ɾ o
empoderante	e m p o d e ɾ a n t e
rehusados	r e u s a d o s
menoscabadas	m e n o s k a b a d a s
recua	r e k w a
derretida	d e r e t i d a
trasparentadas	t ɾ a s p a ɾ e n t a d a s
soberbia	s o b e ɾ b j a
desintegrativos	d e s i n t e ɡ ɾ a t i b o s
silfo	s i l f o
tamboril	t a m b o ɾ i l
escoltada	e s k o l t a d a
despeinado	d e s p e i n a d o
implementadas	i m p l e m e n t a d a s
igualadas	i ɡ w a l a d a s
filfa	f i l f a
polisintéticos	p o l i s i n t e t i k o s
desbandá	d e s b a n d a
proamericanas	p ɾ o a m e ɾ i k a n a s
acojonada	a k o x o n a d a
Turín	t u ɾ i n
resguardo	r e s ɡ w a ɾ d o
martinelli	m a ɾ t i n e l i
horado	o ɾ a d o
fútil	f u t i l
lamelar	l a m e l a ɾ
fincares	f i n k a ɾ e s
abogades	a b o ɡ a d e s
aerocubierta	a e ɾ o k u b j e ɾ t a
equilibrador	e k i l i b ɾ a d o ɾ
gotita	ɡ o t i t a
sobrepeso	s o b ɾ e p e s o
heroica	e ɾ o i k a
desgana	d e s ɡ a n a
banquetear	b a n k e t e a ɾ
sensibilidad	s e n s i b i l i d a d
desamparar	d e s a m p a ɾ a ɾ
íncola	i n k o l a
comarca	k o m a ɾ k a
cronométrico	k ɾ o n o m e t ɾ i k o
tansé	t a n s e
cadaverina	k a d a b e ɾ i n a
personadas	p e ɾ s o n a d a s
banco	b a n k o
psicoactivo	s i k o a ɡ t i b o
deslustrar	d e s l u s t ɾ a ɾ
manométricas	m a n o m e t ɾ i k a s
depurando	d e p u ɾ a n d o
espingarda	e s p i n ɡ a ɾ d a
tópico	t o p i k o
resfriamos	r e s f ɾ j a m o s
miasma	m j a s m a
adestrará	a d e s t ɾ a ɾ a
endospora	e n d o s p o ɾ a
ininteligibilidad	i n i n t e l i x i b i l i d a d
diosa	d j o s a
solarás	s o l a ɾ a s
acabás	a k a b a s
chapoteados	t͡ʃ a p o t e a d o s
hablémoslos	a b l e m o s l o s
gravísimas	ɡ ɾ a b i s i m a s
jarana	x a ɾ a n a
parduscas	p a ɾ d u s k a s
butacón	b u t a k o n
dijeren	d i x e ɾ e n
pentavalente	p e n t a b a l e n t e
portadas	p o ɾ t a d a s
ser	s e ɾ
sustantiva	s u s t a n t i b a
baldado	b a l d a d o
despierta	d e s p j e ɾ t a
limados	l i m a d o s
cutrona	k u t ɾ o n a
acontentar	a k o n t e n t a ɾ
workshop	w o ɾ ɡ ʃ o p
degradada	d e ɡ ɾ a d a d a
despabilado	d e s p a b i l a d o
conservadorismo	k o n s e ɾ b a d o ɾ i s m o
Aruba	a ɾ u b a
impactada	i m p a ɡ t a d a
sagrado	s a ɡ ɾ a d o
ganjifa	ɡ a n x i f a
tristura	t ɾ i s t u ɾ a
disfemia	d i s f e m j a
antenal	a n t e n a l
anden	a n d e n
polonesas	p o l o n e s a s
genuino	x e n w i n o
significamos	s i ɡ n i f i k a m o s
personalmente	p e ɾ ˌs o n a l m e n t e
menudeados	m e n u d e a d o s
guíes	ɡ i e s
dieron	d j e ɾ o n
tuiteados	t w i t e a d o s
guijarro	ɡ i x a r o
caros	k a ɾ o s
mitin	m i t i n
profanadas	p ɾ o f a n a d a s
alfaque	a l f a k e
metonimia	m e t o n i m j a
bisemanal	b i s e m a n a l
despeñados	d e s p e ɲ a d o s
ventilada	b e n t i l a d a
despistado	d e s p i s t a d o
puerquita	p w e ɾ k i t a
sincopar	s i n k o p a ɾ
bucólico	b u k o l i k o
garrapiñado	ɡ a r a p i ɲ a d o
percute	p e ɾ k u t e
sustentar	s u s t e n t a ɾ
aventada	a b e n t a d a
matoneadas	m a t o n e a d a s
congelar	k o n x e l a ɾ
Gamba	ɡ a m b a
xerofítico	s e ɾ o f i t i k o
incrementada	i n k ɾ e m e n t a d a
peraltadas	p e ɾ a l t a d a s
desencabestrado	d e s e n k a b e s t ɾ a d o
bailotear	b a i l o t e a ɾ
amillaráremos	a m i ʝ a ɾ a ɾ e m o s
cuchuchear	k u t͡ʃ u t͡ʃ e a ɾ
comámosles	k o m a m o s l e s
meloso	m e l o s o
coexistidos	k o e ɡ s i s t i d o s
argayar	a ɾ ɡ a ʝ a ɾ
santaneco	s a n t a n e k o
pertrechados	p e ɾ t ɾ e t͡ʃ a d o s
demente	d e m e n t e
pulsado	p u l s a d o
proveídos	p ɾ o b e i d o s
enganchadas	e n ɡ a n t͡ʃ a d a s
sufragados	s u f ɾ a ɡ a d o s
rastrojo	r a s t ɾ o x o
impracticabilidad	i m p ɾ a ɡ t i k a b i l i d a d
gravitada	ɡ ɾ a b i t a d a
cuadril	k w a d ɾ i l
sobrevaluado	s o b ɾ e b a l w a d o
expectorados	e ɡ s p e ɡ t o ɾ a d o s
machadiana	m a t͡ʃ a d j a n a
alcana	a l k a n a
humanas	u m a n a s
deliradas	d e l i ɾ a d a s
lechuguero	l e t͡ʃ u ɡ e ɾ o
diminutos	d i m i n u t o s
neofobia	n e o f o b j a
sí	s i
estambulita	e s t a m b u l i t a
derribo	d e r i b o
cocodrila	k o k o d ɾ i l a
posdoctoral	p o s d o ɡ t o ɾ a l
marinado	m a ɾ i n a d o
guasón	ɡ w a s o n
serigrafiado	s e ɾ i ɡ ɾ a f j a d o
bloguear	b l o ɡ e a ɾ
yodurar	ʝ o d u ɾ a ɾ
odre	o d ɾ e
siamesas	s j a m e s a s
Parodi	p a ɾ o d i
fantasmagóricos	f a n t a s m a ɡ o ɾ i k o s
ojeado	o x e a d o
amurallada	a m u ɾ a ʝ a d a
frustres	f ɾ u s t ɾ e s
autoaislarse	a u t o a i s l a ɾ s e
encasquillada	e n k a s k i ʝ a d a
partido	p a ɾ t i d o
hoyoso	o ʝ o s o
cromosoma	k ɾ o m o s o m a
arramblados	a r a m b l a d o s
trascrita	t ɾ a s k ɾ i t a
amarteladas	a m a ɾ t e l a d a s
jocosamente	x o ˌk o s a m e n t e
incoar	i n k o a ɾ
moribunda	m o ɾ i b u n d a
auditivos	a u d i t i b o s
cabás	k a b a s
sapa	s a p a
genitales	x e n i t a l e s
apachurrada	a p a t͡ʃ u r a d a
sindical	s i n d i k a l
apenaréis	a p e n a ɾ e i s
sextina	s e s t i n a
raigrás	r a i ɡ ɾ a s
subependimomas	s u b e p e n d i m o m a s
deltana	d e l t a n a
contraatacar	k o n t ɾ a a t a k a ɾ
novelístico	n o b e l i s t i k o
urbano	u ɾ b a n o
pluralidades	p l u ɾ a l i d a d e s
cabe	k a b e
maracuyá	m a ɾ a k u ʝ a
enfriadero	e n f ɾ j a d e ɾ o
sudadas	s u d a d a s
audión	a u d j o n
avarienta	a b a ɾ j e n t a
recontadas	r e k o n t a d a s
multidispositivo	m u l t i d i s p o s i t i b o
aleteadas	a l e t e a d a s
pelillo	p e l i ʝ o
panhelénico	p a n e l e n i k o
achacoso	a t͡ʃ a k o s o
medianil	m e d j a n i l
chapó	t͡ʃ a p o
catecúmena	k a t e k u m e n a
impala	i m p a l a
nítidas	n i t i d a s
gasas	ɡ a s a s
ovejera	o b e x e ɾ a
autoalimentados	a u t o a l i m e n t a d o s
amnésica	a m n e s i k a
güiña	ɡ w i ɲ a
chistorra	t͡ʃ i s t o r a
retractados	r e t ɾ a ɡ t a d o s
patriótico	p a t ɾ j o t i k o
banfileños	b a n f i l e ɲ o s
estaré	e s t a ɾ e
panal	p a n a l
sobrerrepresentaría	s o b ɾ e r e p ɾ e s e n t a ɾ i a
chorrillana	t͡ʃ o r i ʝ a n a
desbancada	d e s b a n k a d a
segurados	s e ɡ u ɾ a d o s
beldar	b e l d a ɾ
oxidaras	o ɡ s i d a ɾ a s
aumentadas	a u m e n t a d a s
blando	b l a n d o
malherida	m a l e ɾ i d a
hinchar	i n t͡ʃ a ɾ
totopo	t o t o p o
fanfarrones	f a n f a r o n e s
prevaricadoras	p ɾ e b a ɾ i k a d o ɾ a s
acudí	a k u d i
vidriero	b i d ɾ j e ɾ o
jamelga	x a m e l ɡ a
abductor	a b d u ɡ t o ɾ
perdigón	p e ɾ d i ɡ o n
glorificares	ɡ l o ɾ i f i k a ɾ e s
casuales	k a s w a l e s
compensaras	k o m p e n s a ɾ a s
sajado	s a x a d o
birminghense	b i ɾ m i n ɡ e n s e
maltratar	m a l t ɾ a t a ɾ
fotografiado	f o t o ɡ ɾ a f j a d o
Nebraska	n e b ɾ a s k a
dinerario	d i n e ɾ a ɾ j o
jacobita	x a k o b i t a
desmontados	d e s m o n t a d o s
boyero	b o ʝ e ɾ o
envalentonadas	e m b a l e n t o n a d a s
arponados	a ɾ p o n a d o s
desaprovechada	d e s a p ɾ o b e t͡ʃ a d a
chinicuil	t͡ʃ i n i k w i l
acopla	a k o p l a
ruido	r w i d o
vasca	b a s k a
reme	r e m e
abejorro	a b e x o r o
troquelar	t ɾ o k e l a ɾ
caballeresco	k a b a ʝ e ɾ e s k o
seriaremos	s e ɾ j a ɾ e m o s
buró	b u ɾ o
inconcreto	i n k o n k ɾ e t o
culminado	k u l m i n a d o
antineutrino	a n t i n e u t ɾ i n o
llegue	ʝ e ɡ e
sistemáticas	s i s t e m a t i k a s
alfaques	a l f a k e s
florales	f l o ɾ a l e s
golpeteasen	ɡ o l p e t e a s e n
catuaba	k a t w a b a
obstruidos	o b s t ɾ w i d o s
idolatrados	i d o l a t ɾ a d o s
irritadas	i r i t a d a s
cuidando	k w i d a n d o
codón	k o d o n
transfeminismo	t ɾ a n s f e m i n i s m o
leoninos	l e o n i n o s
mineróloga	m i n e ɾ o l o ɡ a
badalonesa	b a d a l o n e s a
iglesita	i ɡ l e s i t a
Nursultán	n u ɾ s u l t a n
caucásico	k a u k a s i k o
incruenta	i n k ɾ w e n t a
rutina	r u t i n a
taco	t a k o
premiaríamos	p ɾ e m j a ɾ i a m o s
diabólicos	d j a b o l i k o s
fermentaríamos	f e ɾ m e n t a ɾ i a m o s
sangría	s a n ɡ ɾ i a
usulutecas	u s u l u t e k a s
empleador	e m p l e a d o ɾ
rescatadas	r e s k a t a d a s
conejillo	k o n e x i ʝ o
conmutados	k o m m u t a d o s
barda	b a ɾ d a
androide	a n d ɾ o i d e
mandatoria	m a n d a t o ɾ j a
codificado	k o d i f i k a d o
becarias	b e k a ɾ j a s
suplementado	s u p l e m e n t a d o
acopiada	a k o p j a d a
enología	e n o l o x i a
ordeno	o ɾ d e n o
galés	ɡ a l e s
viudita	b j u d i t a
desinteresado	d e s i n t e ɾ e s a d o
fiestones	f j e s t o n e s
belfo	b e l f o
ultrajados	u l t ɾ a x a d o s
trol	t ɾ o l
védate	b e d a t e
irradiante	i r a d j a n t e
pituco	p i t u k o
degradados	d e ɡ ɾ a d a d o s
opaca	o p a k a
eslabonamiento	e s l a b o n a m j e n t o
sobrevalorada	s o b ɾ e b a l o ɾ a d a
transparentada	t ɾ a n s p a ɾ e n t a d a
fincados	f i n k a d o s
estrechas	e s t ɾ e t͡ʃ a s
monocromáticas	m o n o k ɾ o m a t i k a s
identificada	i d e n t i f i k a d a
byte	b a i t
agremiados	a ɡ ɾ e m j a d o s
refulgidas	r e f u l x i d a s
canoero	k a n o e ɾ o
miráculo	m i ɾ a k u l o
ubérrimos	u b e r i m o s
termine	t e ɾ m i n e
liberar	l i b e ɾ a ɾ
chompa	t͡ʃ o m p a
topónimo	t o p o n i m o
tacleado	t a k l e a d o
semimeridiano	s e m i m e ɾ i d j a n o
desatendidas	d e s a t e n d i d a s
sobrevalorados	s o b ɾ e b a l o ɾ a d o s
tautología	t a u t o l o x i a
miositis	m j o s i t i s
obsequiada	o b s e k j a d a
atenuantes	a t e n w a n t e s
cagarse	k a ɡ a ɾ s e
decano	d e k a n o
smoking	e s m o k i n
henchida	e n t͡ʃ i d a
cablegrafiadas	k a b l e ɡ ɾ a f j a d a s
terraplenados	t e r a p l e n a d o s
sarga	s a ɾ ɡ a
frustrando	f ɾ u s t ɾ a n d o
yokut	ʝ o k u t
parsec	p a ɾ s e k
estarles	e s t a ɾ l e s
verija	b e ɾ i x a
destupir	d e s t u p i ɾ
seísmo	s e i s m o
arará	a ɾ a ɾ a
abundas	a b u n d a s
chinchilla	t͡ʃ i n t͡ʃ i ʝ a
grapo	ɡ ɾ a p o
compulsivas	k o m p u l s i b a s
fufada	f u f a d a
Espinal	e s p i n a l
revestí	r e b e s t i
normoevolutivo	n o ɾ m o e b o l u t i b o
apelas	a p e l a s
distensible	d i s t e n s i b l e
patotero	p a t o t e ɾ o
hollejo	o ʝ e x o
auscultares	a u s k u l t a ɾ e s
primate	p ɾ i m a t e
ubérrimo	u b e r i m o
fenaquistoscopio	f e n a k i s t o s k o p j o
sonados	s o n a d o s
catán	k a t a n
improvisar	i m p ɾ o b i s a ɾ
opositora	o p o s i t o ɾ a
mucho	m u t͡ʃ o
anfíbol	a n f i b o l
alcaide	a l k a i d e
estallable	e s t a ʝ a b l e
endeudado	e n d e u d a d o
abaldonaros	a b a l d o n a ɾ o s
redargüidas	r e d a ɾ ɡ w i d a s
rabel	r a b e l
atusadas	a t u s a d a s
pesquise	p e s k i s e
extensas	e ɡ s t e n s a s
vosotras	b o s o t ɾ a s
bastir	b a s t i ɾ
resaltar	r e s a l t a ɾ
alquitranados	a l k i t ɾ a n a d o s
tribanda	t ɾ i b a n d a
errarás	e r a ɾ a s
trancares	t ɾ a n k a ɾ e s
candelabro	k a n d e l a b ɾ o
épicorreligioso	e p i k o r e l i x j o s o
sofisticares	s o f i s t i k a ɾ e s
tirón	t i ɾ o n
generado	x e n e ɾ a d o
adquirida	a d k i ɾ i d a
tomografía	t o m o ɡ ɾ a f i a
contenidos	k o n t e n i d o s
oncogénesis	o n k o x e n e s i s
aspectada	a s p e ɡ t a d a
Higüey	i ɡ w e i
envidioso	e m b i d j o s o
dividimos	d i b i d i m o s
abdicará	a b d i k a ɾ a
prosterná	p ɾ o s t e ɾ n a
nativa	n a t i b a
arrecostar	a r e k o s t a ɾ
llamaremos	ʝ a m a ɾ e m o s
opulento	o p u l e n t o
competidor	k o m p e t i d o ɾ
rumbeados	r u m b e a d o s
tímalo	t i m a l o
comiéndolo	k o m j e n d o l o
buriláramos	b u ɾ i l a ɾ a m o s
blanqueados	b l a n k e a d o s
anidados	a n i d a d o s
desgarradas	d e s ɡ a r a d a s
detergidos	d e t e ɾ x i d o s
copilota	k o p i l o t a
habiéndole	a b j e n d o l e
paulino	p a u l i n o
rafagueados	r a f a ɡ e a d o s
polimorfa	p o l i m o ɾ f a
Emanuel	e m a n w e l
aperadora	a p e ɾ a d o ɾ a
aligerados	a l i x e ɾ a d o s
afirmativo	a f i ɾ m a t i b o
lanchero	l a n t͡ʃ e ɾ o
redescubierto	r e d e s k u b j e ɾ t o
vertida	b e ɾ t i d a
don	d o n
ondina	o n d i n a
tolteca	t o l t e k a
estudio	e s t u d j o
prendidos	p ɾ e n d i d o s
vertedor	b e ɾ t e d o ɾ
petrológico	p e t ɾ o l o x i k o
Hipnos	i b n o s
amblados	a m b l a d o s
chasqueado	t͡ʃ a s k e a d o
supervalorada	s u p e ɾ b a l o ɾ a d a
reverberar	r e b e ɾ b e ɾ a ɾ
bulón	b u l o n
rasgueado	r a s ɡ e a d o
triangula	t ɾ j a n ɡ u l a
dominicas	d o m i n i k a s
babor	b a b o ɾ
secretada	s e k ɾ e t a d a
reelegido	r e e l e x i d o
andáis	a n d a i s
ska	s k a
cosmovisión	k o s m o b i s j o n
tituláramos	t i t u l a ɾ a m o s
superpotente	s u p e ɾ p o t e n t e
marchadas	m a ɾ t͡ʃ a d a s
pasota	p a s o t a
ola	o l a
monda	m o n d a
pop	p o p
admitir	a d m i t i ɾ
asamblea	a s a m b l e a
desgarres	d e s ɡ a r e s
fisgoneo	f i s ɡ o n e o
emigrados	e m i ɡ ɾ a d o s
sobrevolada	s o b ɾ e b o l a d a
estaque	e s t a k e
abstuvieren	a b s t u b j e ɾ e n
quintacolumnista	k i n t a k o l u m n i s t a
ova	o b a
talego	t a l e ɡ o
aclimata	a k l i m a t a
veneraremos	b e n e ɾ a ɾ e m o s
embragadas	e m b ɾ a ɡ a d a s
obliterareis	o b l i t e ɾ a ɾ e i s
babeado	b a b e a d o
estereotípicos	e s t e ɾ e o t i p i k o s
deprisa	d e p ɾ i s a
aparatología	a p a ɾ a t o l o x i a
guitarristas	ɡ i t a r i s t a s
demoremos	d e m o ɾ e m o s
futuro	f u t u ɾ o
Borja	b o ɾ x a
poli	p o l i
habláramos	a b l a ɾ a m o s
otosclerosis	o t o s k l e ɾ o s i s
váyanla	b a ʝ a n l a
abisagrado	a b i s a ɡ ɾ a d o
yaresaní	ʝ a ɾ e s a n i
discordada	d i s k o ɾ d a d a
programa	p ɾ o ɡ ɾ a m a
lentificado	l e n t i f i k a d o
perpetua	p e ɾ p e t w a
guío	ɡ i o
Brayan	b ɾ a ʝ a n
Kosovo	k o s o b o
xenófobo	s e n o f o b o
resquebrar	r e s k e b ɾ a ɾ
espantoso	e s p a n t o s o
tirémoslo	t i ɾ e m o s l o
enfangados	e n f a n ɡ a d o s
verberada	b e ɾ b e ɾ a d a
administraste	a d m i n i s t ɾ a s t e
sobretensión	s o b ɾ e t e n s j o n
sutilidad	s u t i l i d a d
Guáimaro	ɡ w a i m a ɾ o
levitado	l e b i t a d o
elamita	e l a m i t a
convocados	k o m b o k a d o s
exportaste	e ɡ s p o ɾ t a s t e
autenticadas	a u t e n t i k a d a s
sopetón	s o p e t o n
desbotonar	d e s b o t o n a ɾ
gavetero	ɡ a b e t e ɾ o
escaparate	e s k a p a ɾ a t e
tetradimensionales	t e t ɾ a d i m e n s j o n a l e s
austera	a u s t e ɾ a
desmesurada	d e s m e s u ɾ a d a
soleada	s o l e a d a
heredar	e ɾ e d a ɾ
ruteo	r u t e o
borrega	b o r e ɡ a
tajante	t a x a n t e
maquinistas	m a k i n i s t a s
rayo	r a ʝ o
usuaria	u s w a ɾ j a
rogará	r o ɡ a ɾ a
casto	k a s t o
definimos	d e f i n i m o s
ufanadas	u f a n a d a s
galvánico	ɡ a l b a n i k o
pernoctar	p e ɾ n o ɡ t a ɾ
colocado	k o l o k a d o
fauna	f a u n a
interétnicos	i n t e ɾ e d n i k o s
cautiva	k a u t i b a
masturbador	m a s t u ɾ b a d o ɾ
grupo	ɡ ɾ u p o
eufemísticos	e u f e m i s t i k o s
administrareis	a d m i n i s t ɾ a ɾ e i s
botil	b o t i l
geranio	x e ɾ a n j o
titulaste	t i t u l a s t e
Septuaginta	s e b t w a x i n t a
asesora	a s e s o ɾ a
soma	s o m a
colapso	k o l a b s o
cuatrimestral	k w a t ɾ i m e s t ɾ a l
rehogar	r e o ɡ a ɾ
transplantada	t ɾ a n s p l a n t a d a
honrilla	o n r i ʝ a
ambivalente	a m b i b a l e n t e
bordillo	b o ɾ d i ʝ o
motilón	m o t i l o n
forramos	f o r a m o s
nalidíxico	n a l i d i ɡ s i k o
reverendo	r e b e ɾ e n d o
legalidad	l e ɡ a l i d a d
desosada	d e s o s a d a
comentados	k o m e n t a d o s
oncología	o n k o l o x i a
salidora	s a l i d o ɾ a
gernikarra	x e ɾ n i k a r a
estampa	e s t a m p a
inesperado	i n e s p e ɾ a d o
camerístico	k a m e ɾ i s t i k o
derecho	d e ɾ e t͡ʃ o
acabémosla	a k a b e m o s l a
lerdo	l e ɾ d o
acústicas	a k u s t i k a s
catadióptrico	k a t a d j o b t ɾ i k o
Batlle	b a ʝ e
nerviosamente	n e ɾ ˌb j o s a m e n t e
precavido	p ɾ e k a b i d o
oportuno	o p o ɾ t u n o
recalculamos	r e k a l k u l a m o s
hipersexualidad	i p e ɾ s e ɡ s w a l i d a d
anatomía	a n a t o m i a
estenos	e s t e n o s
muertitas	m w e ɾ t i t a s
suegra	s w e ɡ ɾ a
hevea	e b e a
esgrimidor	e s ɡ ɾ i m i d o ɾ
hipocomplementemia	i p o k o m p l e m e n t e m j a
malherido	m a l e ɾ i d o
abaratados	a b a ɾ a t a d o s
arropado	a r o p a d o
comidilla	k o m i d i ʝ a
neumoconiosis	n e u m o k o n j o s i s
batistianas	b a t i s t j a n a s
atresia	a t ɾ e s j a
antinomia	a n t i n o m j a
pseudohistoria	s e u d o i s t o ɾ j a
cantante	k a n t a n t e
mesentérico	m e s e n t e ɾ i k o
arrollados	a r o ʝ a d o s
tonadilla	t o n a d i ʝ a
gratinaste	ɡ ɾ a t i n a s t e
trasmutados	t ɾ a s m u t a d o s
yago	ʝ a ɡ o
despercudir	d e s p e ɾ k u d i ɾ
emisión	e m i s j o n
goleadas	ɡ o l e a d a s
encontraras	e n k o n t ɾ a ɾ a s
potasemia	p o t a s e m j a
tuberosidad	t u b e ɾ o s i d a d
musicología	m u s i k o l o x i a
aventurares	a b e n t u ɾ a ɾ e s
purgado	p u ɾ ɡ a d o
prohibitorios	p ɾ o i b i t o ɾ j o s
ventriloquia	b e n t ɾ i l o k j a
cumplimentados	k u m p l i m e n t a d o s
respeto	r e s p e t o
trincadas	t ɾ i n k a d a s
pantalones	p a n t a l o n e s
romboide	r o m b o i d e
aldónico	a l d o n i k o
modelando	m o d e l a n d o
abaldónense	a b a l d o n e n s e
empatados	e m p a t a d o s
fechemos	f e t͡ʃ e m o s
acabareis	a k a b a ɾ e i s
ambientadores	a m b j e n t a d o ɾ e s
piquito	p i k i t o
habladla	a b l a d l a
rebobinar	r e b o b i n a ɾ
quebradita	k e b ɾ a d i t a
comprador	k o m p ɾ a d o ɾ
Bretaña	b ɾ e t a ɲ a
eclipsará	e k l i b s a ɾ a
autonomista	a u t o n o m i s t a
abastardé	a b a s t a ɾ d e
sofocamiento	s o f o k a m j e n t o
postobligatorios	p o s t o b l i ɡ a t o ɾ j o s
orlará	o ɾ l a ɾ a
distinto	d i s t i n t o
tascas	t a s k a s
golpismo	ɡ o l p i s m o
pelador	p e l a d o ɾ
abocar	a b o k a ɾ
cartesianos	k a ɾ t e s j a n o s
porrito	p o r i t o
atrevimiento	a t ɾ e b i m j e n t o
sopor	s o p o ɾ
fincado	f i n k a d o
triangulará	t ɾ j a n ɡ u l a ɾ a
espejado	e s p e x a d o
gilipollas	x i l i p o ʝ a s
notadas	n o t a d a s
ostión	o s t j o n
perturbados	p e ɾ t u ɾ b a d o s
hidroeléctrico	i d ɾ o e l e ɡ t ɾ i k o
diablita	d j a b l i t a
ruines	r w i n e s
Antón	a n t o n
coartados	k o a ɾ t a d o s
augurada	a u ɡ u ɾ a d a
crie	k ɾ j e
agotado	a ɡ o t a d o
sed	s e d
arponeadas	a ɾ p o n e a d a s
lechoso	l e t͡ʃ o s o
endocraneano	e n d o k ɾ a n e a n o
desenchufadas	d e s e n t͡ʃ u f a d a s
suplicamos	s u p l i k a m o s
trombina	t ɾ o m b i n a
bolardo	b o l a ɾ d o
imantadas	i m a n t a d a s
titiritéele	t i t i ɾ i t e e l e
conmutatividad	k o m m u t a t i b i d a d
caballera	k a b a ʝ e ɾ a
absolveríais	a b s o l b e ɾ i a i s
endovascular	e n d o b a s k u l a ɾ
cavador	k a b a d o ɾ
bosar	b o s a ɾ
paleáramos	p a l e a ɾ a m o s
vetaste	b e t a s t e
tranqui	t ɾ a n k i
premonitoria	p ɾ e m o n i t o ɾ j a
contractualista	k o n t ɾ a ɡ t w a l i s t a
Irenea	i ɾ e n e a
prospectora	p ɾ o s p e ɡ t o ɾ a
psíquico	s i k i k o
periné	p e ɾ i n e
desgranada	d e s ɡ ɾ a n a d a
toltecas	t o l t e k a s
algodonadas	a l ɡ o d o n a d a s
cleriguito	k l e ɾ i ɡ i t o
poso	p o s o
peloteado	p e l o t e a d o
meditareis	m e d i t a ɾ e i s
suélenla	s w e l e n l a
Vaupés	b a u p e s
tonificadas	t o n i f i k a d a s
acobardara	a k o b a ɾ d a ɾ a
predictibilidad	p ɾ e d i ɡ t i b i l i d a d
oh	o
cuartito	k w a ɾ t i t o
gusto	ɡ u s t o
denotara	d e n o t a ɾ a
extrasistólicos	e ɡ s t ɾ a s i s t o l i k o s
hables	a b l e s
fermentaras	f e ɾ m e n t a ɾ a s
voleo	b o l e o
neologismo	n e o l o x i s m o
jamelgo	x a m e l ɡ o
anuario	a n w a ɾ j o
bastitanas	b a s t i t a n a s
xerografiados	s e ɾ o ɡ ɾ a f j a d o s
baremados	b a ɾ e m a d o s
coventículo	k o b e n t i k u l o
higüero	i ɡ w e ɾ o
crónica	k ɾ o n i k a
rabanito	r a b a n i t o
débil	d e b i l
oliente	o l j e n t e
temeos	t e m e o s
relampaguee	r e l a m p a ɡ e e
enroca	e n r o k a
diseminar	d i s e m i n a ɾ
discrepadas	d i s k ɾ e p a d a s
linfoides	l i n f o i d e s
reposados	r e p o s a d o s
indexar	i n d e ɡ s a ɾ
necrólisis	n e k ɾ o l i s i s
Góngora	ɡ o n ɡ o ɾ a
empinemos	e m p i n e m o s
almarrá	a l m a r a
posromántico	p o s r o m a n t i k o
saudade	s a u d a d e
oiréis	o i ɾ e i s
remojadas	r e m o x a d a s
ladrones	l a d ɾ o n e s
guadaña	ɡ w a d a ɲ a
cunques	k u n k e s
balasto	b a l a s t o
desajustada	d e s a x u s t a d a
jachapuri	x a t͡ʃ a p u ɾ i
blusón	b l u s o n
ornitólogo	o ɾ n i t o l o ɡ o
austral	a u s t ɾ a l
Valdemar	b a l d e m a ɾ
hervida	e ɾ b i d a
vidriadas	b i d ɾ j a d a s
axiológico	a ɡ s j o l o x i k o
recopilador	r e k o p i l a d o ɾ
apuntillado	a p u n t i ʝ a d o
apeles	a p e l e s
afecta	a f e ɡ t a
ternero	t e ɾ n e ɾ o
comprensible	k o m p ɾ e n s i b l e
granada	ɡ ɾ a n a d a
buscando	b u s k a n d o
estrelladas	e s t ɾ e ʝ a d a s
afiladera	a f i l a d e ɾ a
exagera	e ɡ s a x e ɾ a
anómalo	a n o m a l o
adúltera	a d u l t e ɾ a
traedora	t ɾ a e d o ɾ a
humilladero	u m i ʝ a d e ɾ o
sobrepujaremos	s o b ɾ e p u x a ɾ e m o s
entrevistadores	e n t ɾ e b i s t a d o ɾ e s
velaste	b e l a s t e
Mantua	m a n t w a
sorpresita	s o ɾ p ɾ e s i t a
antigua	a n t i ɡ w a
pretendida	p ɾ e t e n d i d a
monocromo	m o n o k ɾ o m o
rayuela	r a ʝ w e l a
abarrotado	a b a r o t a d o
enterrares	e n t e r a ɾ e s
abajar	a b a x a ɾ
blanquillo	b l a n k i ʝ o
escuincle	e s k w i n k l e
suma	s u m a
declarares	d e k l a ɾ a ɾ e s
elabora	e l a b o ɾ a
cohetón	k o e t o n
fomentémoste	f o m e n t e m o s t e
poliamoroso	p o l i a m o ɾ o s o
desembolsadas	d e s e m b o l s a d a s
Chile	t͡ʃ i l e
litronas	l i t ɾ o n a s
cracoviano	k ɾ a k o b j a n o
peneanos	p e n e a n o s
Lavapiés	ˌl a b a p j e s
ilinoisiano	i l i n o i s j a n o
latino	l a t i n o
esgrimir	e s ɡ ɾ i m i ɾ
abatatada	a b a t a t a d a
lídar	l i d a ɾ
eludes	e l u d e s
distintiva	d i s t i n t i b a
rumorados	r u m o ɾ a d o s
finco	f i n k o
vituperar	b i t u p e ɾ a ɾ
litio	l i t j o
expansivo	e ɡ s p a n s i b o
desmorir	d e s m o ɾ i ɾ
chufado	t͡ʃ u f a d o
reconfiguradas	r e k o n f i ɡ u ɾ a d a s
enjugador	e n x u ɡ a d o ɾ
deltoidal	d e l t o i d a l
cacahuete	k a k a w e t e
propano	p ɾ o p a n o
retrucaste	r e t ɾ u k a s t e
lalada	l a l a d a
reparas	r e p a ɾ a s
confluir	k o n f l w i ɾ
motito	m o t i t o
márfega	m a ɾ f e ɡ a
falsarios	f a l s a ɾ j o s
virará	b i ɾ a ɾ a
desportillar	d e s p o ɾ t i ʝ a ɾ
encasquetado	e n k a s k e t a d o
Escobar	e s k o b a ɾ
comierais	k o m j e ɾ a i s
cansada	k a n s a d a
tener	t e n e ɾ
mostraste	m o s t ɾ a s t e
ecología	e k o l o x i a
chachapoya	t͡ʃ a t͡ʃ a p o ʝ a
anticucho	a n t i k u t͡ʃ o
viable	b j a b l e
suntuosidad	s u n t w o s i d a d
escaladas	e s k a l a d a s
habitadora	a b i t a d o ɾ a
vetustense	b e t u s t e n s e
predestinado	p ɾ e d e s t i n a d o
limitadora	l i m i t a d o ɾ a
jalapeño	x a l a p e ɲ o
pajarera	p a x a ɾ e ɾ a
pélvica	p e l b i k a
membranoproliferativo	m e m b ɾ a n o p ɾ o l i f e ɾ a t i b o
tentativa	t e n t a t i b a
actividades	a ɡ t i b i d a d e s
chutaríamos	t͡ʃ u t a ɾ i a m o s
enripiadas	e n r i p j a d a s
agolpado	a ɡ o l p a d o
tumor	t u m o ɾ
quinario	k i n a ɾ j o
jimia	x i m j a
capirote	k a p i ɾ o t e
estudiado	e s t u d j a d o
televisor	t e l e b i s o ɾ
dictaminadora	d i ɡ t a m i n a d o ɾ a
puntilloso	p u n t i ʝ o s o
amputado	a m p u t a d o
resanar	r e s a n a ɾ
suscrito	s u s k ɾ i t o
usurero	u s u ɾ e ɾ o
lentillo	l e n t i ʝ o
altivo	a l t i b o
dictablanda	d i ɡ t a b l a n d a
aduláramos	a d u l a ɾ a m o s
sorpresivo	s o ɾ p ɾ e s i b o
achicopalaos	a t͡ʃ i k o p a l a o s
coqueteado	k o k e t e a d o
morir	m o ɾ i ɾ
suinos	s w i n o s
dimisionar	d i m i s j o n a ɾ
septiembre	s e b t j e m b ɾ e
derrochador	d e r o t͡ʃ a d o ɾ
escamocha	e s k a m o t͡ʃ a
enramada	e n r a m a d a
autótrofo	a u t o t ɾ o f o
anestesiaremos	a n e s t e s j a ɾ e m o s
epodo	e p o d o
focal	f o k a l
absuelto	a b s w e l t o
pegar	p e ɡ a ɾ
caben	k a b e n
tejita	t e x i t a
extrasistólica	e ɡ s t ɾ a s i s t o l i k a
burdeos	b u ɾ d e o s
alcachofera	a l k a t͡ʃ o f e ɾ a
alijaste	a l i x a s t e
elequeme	e l e k e m e
extracapilares	e ɡ s t ɾ a k a p i l a ɾ e s
oportunísimo	o p o ɾ t u n i s i m o
cocotes	k o k o t e s
pekinesas	p e k i n e s a s
autodestruidas	a u t o d e s t ɾ w i d a s
autocorregido	a u t o k o r e x i d o
grillar	ɡ ɾ i ʝ a ɾ
emulsionada	e m u l s j o n a d a
aparo	a p a ɾ o
Reye	r e ʝ e
partamos	p a ɾ t a m o s
reintensificada	r e i n t e n s i f i k a d a
ofrenda	o f ɾ e n d a
husmeada	u s m e a d a
embargadas	e m b a ɾ ɡ a d a s
diseñar	d i s e ɲ a ɾ
tirará	t i ɾ a ɾ a
autoconvocarse	a u t o k o m b o k a ɾ s e
botáramos	b o t a ɾ a m o s
domareis	d o m a ɾ e i s
peleados	p e l e a d o s
palmita	p a l m i t a
trastabilleadas	t ɾ a s t a b i ʝ e a d a s
duche	d u t͡ʃ e
sorpresivamente	s o ɾ p ɾ e ˌs i b a m e n t e
amañada	a m a ɲ a d a
andándoles	a n d a n d o l e s
entallador	e n t a ʝ a d o ɾ
jauría	x a u ɾ i a
regrabados	r e ɡ ɾ a b a d o s
arquitecto	a ɾ k i t e ɡ t o
onagro	o n a ɡ ɾ o
reprochamos	r e p ɾ o t͡ʃ a m o s
regresadas	r e ɡ ɾ e s a d a s
Boluarte	b o l w a ɾ t e
farmacológico	f a ɾ m a k o l o x i k o
combinare	k o m b i n a ɾ e
languor	l a n ɡ w o ɾ
colombina	k o l o m b i n a
columbradas	k o l u m b ɾ a d a s
esponjosos	e s p o n x o s o s
nacatamal	n a k a t a m a l
lampasados	l a m p a s a d o s
mandacaru	m a n d a k a ɾ u
ficado	f i k a d o
guerrilla	ɡ e r i ʝ a
degenerativa	d e x e n e ɾ a t i b a
satisfechísimo	s a t i s f e t͡ʃ i s i m o
premedita	p ɾ e m e d i t a
escolar	e s k o l a ɾ
herbolarias	e ɾ b o l a ɾ j a s
panadería	p a n a d e ɾ i a
mamoneá	m a m o n e a
pisón	p i s o n
declamado	d e k l a m a d o
simulado	s i m u l a d o
calafateados	k a l a f a t e a d o s
desproveyera	d e s p ɾ o b e ʝ e ɾ a
calor	k a l o ɾ
organismo	o ɾ ɡ a n i s m o
grieta	ɡ ɾ j e t a
mosaicos	m o s a i k o s
lisonjero	l i s o n x e ɾ o
estaño	e s t a ɲ o
autolesionada	a u t o l e s j o n a d a
colicorto	k o l i k o ɾ t o
tachada	t a t͡ʃ a d a
parador	p a ɾ a d o ɾ
núcleo	n u k l e o
banderita	b a n d e ɾ i t a
carrero	k a r e ɾ o
frecuentadora	f ɾ e k w e n t a d o ɾ a
magenta	m a x e n t a
voleada	b o l e a d a
Vito	b i t o
adelitas	a d e l i t a s
guineoecuatorial	ɡ i n e o e k w a t o ɾ j a l
incumbidas	i n k u m b i d a s
desensillar	d e s e n s i ʝ a ɾ
desprestigiado	d e s p ɾ e s t i x j a d o
convulsivo	k o m b u l s i b o
miocarditis	m j o k a ɾ d i t i s
leudo	l e u d o
Choy	t͡ʃ o i
dentudo	d e n t u d o
cofre	k o f ɾ e
replanteados	r e p l a n t e a d o s
guapo	ɡ w a p o
jamaicanos	x a m a i k a n o s
estaquillas	e s t a k i ʝ a s
superpremiado	s u p e ɾ p ɾ e m j a d o
comilonas	k o m i l o n a s
asará	a s a ɾ a
disculpa	d i s k u l p a
ministrado	m i n i s t ɾ a d o
soláis	s o l a i s
oaxaqueño	w̝ a x a k e ɲ o
prevaricadora	p ɾ e b a ɾ i k a d o ɾ a
ninguneada	n i n ɡ u n e a d a
surfeados	s u ɾ f e a d o s
mongolito	m o n ɡ o l i t o
regule	r e ɡ u l e
escarda	e s k a ɾ d a
seguradas	s e ɡ u ɾ a d a s
lloriqueados	ʝ o ɾ i k e a d o s
tipológicos	t i p o l o x i k o s
cantanos	k a n t a n o s
pellín	p e ʝ i n
atreveríamos	a t ɾ e b e ɾ i a m o s
aquitano	a k i t a n o
soler	s o l e ɾ
corcho	k o ɾ t͡ʃ o
sicológicas	s i k o l o x i k a s
conversara	k o m b e ɾ s a ɾ a
apocopa	a p o k o p a
balleneras	b a ʝ e n e ɾ a s
queísmo	k e i s m o
fosforilaremos	f o s f o ɾ i l a ɾ e m o s
elegantes	e l e ɡ a n t e s
aguará	a ɡ w a ɾ a
olimpiada	o l i m p j a d a
becuadro	b e k w a d ɾ o
rédito	r e d i t o
tolina	t o l i n a
resoluto	r e s o l u t o
llamémosla	ʝ a m e m o s l a
compurgamos	k o m p u ɾ ɡ a m o s
comuniques	k o m u n i k e s
profundamente	p ɾ o ˌf u n d a m e n t e
ameba	a m e b a
filmar	f i l m a ɾ
leías	l e i a s
inmunocomprometidos	i m m u n o k o m p ɾ o m e t i d o s
hablándome	a b l a n d o m e
atrofiará	a t ɾ o f j a ɾ a
ultrarreligiosa	u l t ɾ a r e l i x j o s a
canela	k a n e l a
Piamonte	p j a m o n t e
veámoslos	b e a m o s l o s
pluripatológico	p l u ɾ i p a t o l o x i k o
marmota	m a ɾ m o t a
aventures	a b e n t u ɾ e s
salvaguardamos	s a l b a ɡ w a ɾ d a m o s
fibrinosos	f i b ɾ i n o s o s
colorada	k o l o ɾ a d a
hierosolimitano	ʝ e ɾ o s o l i m i t a n o
acompañamiento	a k o m p a ɲ a m j e n t o
abstendríamos	a b s t e n d ɾ i a m o s
calda	k a l d a
trilineal	t ɾ i l i n e a l
daríamos	d a ɾ i a m o s
et	e t
godo	ɡ o d o
abajadlo	a b a x a d l o
remunerativo	r e m u n e ɾ a t i b o
emperrar	e m p e r a ɾ
hayámoos	a ʝ a m o o s
atas	a t a s
desencadenador	d e s e n k a d e n a d o ɾ
acuitados	a k w i t a d o s
espesas	e s p e s a s
tírenla	t i ɾ e n l a
estacados	e s t a k a d o s
acordándose	a k o ɾ d a n d o s e
crac	k ɾ a k
postulas	p o s t u l a s
protamina	p ɾ o t a m i n a
blocadas	b l o k a d a s
acuminadas	a k u m i n a d a s
Amarillo	a m a ɾ i ʝ o
rondeña	r o n d e ɲ a
espachurrada	e s p a t͡ʃ u r a d a
Mauro	m a u ɾ o
polenta	p o l e n t a
amargosa	a m a ɾ ɡ o s a
amistado	a m i s t a d o
techados	t e t͡ʃ a d o s
caxcana	k a ɡ s k a n a
ratificamos	r a t i f i k a m o s
secuestrador	s e k w e s t ɾ a d o ɾ
petidina	p e t i d i n a
trigarante	t ɾ i ɡ a ɾ a n t e
trasmontados	t ɾ a s m o n t a d o s
putadita	p u t a d i t a
vetaros	b e t a ɾ o s
gerontóloga	x e ɾ o n t o l o ɡ a
diptongada	d i b t o n ɡ a d a
divisadas	d i b i s a d a s
andaban	a n d a b a n
bandejita	b a n d e x i t a
subveguería	s u b b e ɡ e ɾ i a
espinodal	e s p i n o d a l
sidonia	s i d o n j a
bayuca	b a ʝ u k a
testificar	t e s t i f i k a ɾ
horroroso	o r o ɾ o s o
enredados	e n r e d a d o s
mansega	m a n s e ɡ a
parlamentarios	p a ɾ l a m e n t a ɾ j o s
mandamiento	m a n d a m j e n t o
bastoneadas	b a s t o n e a d a s
puritanas	p u ɾ i t a n a s
intemperante	i n t e m p e ɾ a n t e
lucaya	l u k a ʝ a
abadernásemos	a b a d e ɾ n a s e m o s
desternilladas	d e s t e ɾ n i ʝ a d a s
arbustiva	a ɾ b u s t i b a
enlutar	e n l u t a ɾ
saquear	s a k e a ɾ
adenohipófisis	a d e n o i p o f i s i s
ningunos	n i n ɡ u n o s
prearmar	p ɾ e a ɾ m a ɾ
victimado	b i ɡ t i m a d o
listillo	l i s t i ʝ o
jadeados	x a d e a d o s
estada	e s t a d a
amarrete	a m a r e t e
cómanle	k o m a n l e
joderla	x o d e ɾ l a
apanar	a p a n a ɾ
sensatas	s e n s a t a s
deteriorante	d e t e ɾ j o ɾ a n t e
rehén	r e e n
cámping	k a m p i n
puros	p u ɾ o s
servil	s e ɾ b i l
semiconductor	s e m i k o n d u ɡ t o ɾ
discreteadas	d i s k ɾ e t e a d a s
Cantórbery	k a n t o ɾ b e ɾ i
restados	r e s t a d o s
corsé	k o ɾ s e
vetándoles	b e t a n d o l e s
intrusadas	i n t ɾ u s a d a s
cadaverosa	k a d a b e ɾ o s a
lubrifico	l u b ɾ i f i k o
leyendo	l e ʝ e n d o
autogestionado	a u t o x e s t j o n a d o
plebeyo	p l e b e ʝ o
argumentar	a ɾ ɡ u m e n t a ɾ
punalúa	p u n a l u a
incluso	i n k l u s o
frambueso	f ɾ a m b w e s o
leoninas	l e o n i n a s
definitivas	d e f i n i t i b a s
cafeico	k a f e i k o
oíble	o i b l e
piemontés	p j e m o n t e s
polbero	p o l b e ɾ o
compendiado	k o m p e n d j a d o
desarbolar	d e s a ɾ b o l a ɾ
apetitosa	a p e t i t o s a
sinostosis	s i n o s t o s i s
arrullo	a r u ʝ o
apagamos	a p a ɡ a m o s
cómanme	k o m a m m e
vestibulococlear	b e s t i b u l o k o k l e a ɾ
africada	a f ɾ i k a d a
intransigentes	i n t ɾ a n s i x e n t e s
vimos	b i m o s
morfea	m o ɾ f e a
fabrica	f a b ɾ i k a
calumniosa	k a l u m n j o s a
anaplásico	a n a p l a s i k o
apocalipsis	a p o k a l i b s i s
enastado	e n a s t a d o
enrabietados	e n r a b j e t a d o s
huno	u n o
precapitalista	p ɾ e k a p i t a l i s t a
retornado	r e t o ɾ n a d o
huí	u i
estaban	e s t a b a n
reológico	r e o l o x i k o
reproductivas	r e p ɾ o d u ɡ t i b a s
cascajo	k a s k a x o
sótano	s o t a n o
Mercurio	m e ɾ k u ɾ j o
alejada	a l e x a d a
anteanoche	a n t e a n o t͡ʃ e
bruñido	b ɾ u ɲ i d o
vetaríamos	b e t a ɾ i a m o s
deputaréis	d e p u t a ɾ e i s
faremos	f a ɾ e m o s
profusos	p ɾ o f u s o s
ondulado	o n d u l a d o
anadeadas	a n a d e a d a s
perennifolio	p e ɾ e n n i f o l j o
densificadas	d e n s i f i k a d a s
alteo	a l t e o
mericarpio	m e ɾ i k a ɾ p j o
convergidos	k o m b e ɾ x i d o s
esculturales	e s k u l t u ɾ a l e s
morfina	m o ɾ f i n a
portuenses	p o ɾ t w e n s e s
recostados	r e k o s t a d o s
adoptando	a d o b t a n d o
ampolla	a m p o ʝ a
malditas	m a l d i t a s
Angulo	a n ɡ u l o
juglaresco	x u ɡ l a ɾ e s k o
chulunca	t͡ʃ u l u n k a
reproductiva	r e p ɾ o d u ɡ t i b a
curvare	k u ɾ b a ɾ e
Ledesma	l e d e s m a
Marroquín	m a r o k i n
burkinesa	b u ɾ k i n e s a
inequívoca	i n e k i b o k a
precavidas	p ɾ e k a b i d a s
recolectadas	r e k o l e ɡ t a d a s
sufragada	s u f ɾ a ɡ a d a
traficados	t ɾ a f i k a d o s
intuir	i n t w i ɾ
asuán	a s w a n
cantarlas	k a n t a ɾ l a s
Ramona	r a m o n a
laboratorial	l a b o ɾ a t o ɾ j a l
testadas	t e s t a d a s
moraríamos	m o ɾ a ɾ i a m o s
vial	b j a l
ovil	o b i l
reputar	r e p u t a ɾ
contraatacados	k o n t ɾ a a t a k a d o s
codesarrollado	k o d e s a r o ʝ a d o
heparina	e p a ɾ i n a
artesano	a ɾ t e s a n o
subscriptos	s u b s k ɾ i b t o s
forro	f o r o
fructífero	f ɾ u ɡ t i f e ɾ o
escapado	e s k a p a d o
columnela	k o l u m n e l a
enrocas	e n r o k a s
sujetar	s u x e t a ɾ
bagrátida	b a ɡ ɾ a t i d a
coliderar	k o l i d e ɾ a ɾ
sexar	s e ɡ s a ɾ
defino	d e f i n o
contestar	k o n t e s t a ɾ
transfectar	t ɾ a n s f e ɡ t a ɾ
deputemos	d e p u t e m o s
entesitis	e n t e s i t i s
expiado	e ɡ s p j a d o
veneranda	b e n e ɾ a n d a
disyuntor	d i s ʝ u n t o ɾ
ectópica	e ɡ t o p i k a
funcar	f u n k a ɾ
reputados	r e p u t a d o s
butiá	b u t j a
incolora	i n k o l o ɾ a
florido	f l o ɾ i d o
gentilhombre	x e n t i l o m b ɾ e
chupamiel	ˌt͡ʃ u p a m j e l
mostraríamos	m o s t ɾ a ɾ i a m o s
lihueñe	l i w e ɲ e
catinona	k a t i n o n a
envestir	e m b e s t i ɾ
pocotón	p o k o t o n
autotrófico	a u t o t ɾ o f i k o
abastos	a b a s t o s
epigástrico	e p i ɡ a s t ɾ i k o
piquigualdo	p i k i ɡ w a l d o
Vichada	b i t͡ʃ a d a
desrabotada	d e s r a b o t a d a
acalorarse	a k a l o ɾ a ɾ s e
almodovarianos	a l m o d o b a ɾ j a n o s
saturaste	s a t u ɾ a s t e
latué	l a t w e
escudriñamiento	e s k u d ɾ i ɲ a m j e n t o
encuartelada	e n k w a ɾ t e l a d a
ruinado	r w i n a d o
predestinada	p ɾ e d e s t i n a d a
espeso	e s p e s o
rubéola	r u b e o l a
conectaste	k o n e ɡ t a s t e
unicameral	u n i k a m e ɾ a l
tándems	t a n d e m s
mohínos	m o i n o s
logísticas	l o x i s t i k a s
quemador	k e m a d o ɾ
calabriadas	k a l a b ɾ j a d a s
optados	o b t a d o s
bioéticas	b i o e t i k a s
yiras	ʝ i ɾ a s
anchura	a n t͡ʃ u ɾ a
criaturita	k ɾ j a t u ɾ i t a
vapeadas	b a p e a d a s
rácano	r a k a n o
alojativo	a l o x a t i b o
quíntuplos	k i n t u p l o s
Cartago	k a ɾ t a ɡ o
endotérmicos	e n d o t e ɾ m i k o s
trasquilado	t ɾ a s k i l a d o
estuvieses	e s t u b j e s e s
clamadas	k l a m a d a s
microbiana	m i k ɾ o b j a n a
traído	t ɾ a i d o
manú	m a n u
escarbador	e s k a ɾ b a d o ɾ
cacheteada	k a t͡ʃ e t e a d a
alardeados	a l a ɾ d e a d o s
según	s e ɡ u n
indico	i n d i k o
data	d a t a
esponjoso	e s p o n x o s o
minamos	m i n a m o s
desdeñar	d e s d e ɲ a ɾ
pluripartidaria	p l u ɾ i p a ɾ t i d a ɾ j a
anticarro	a n t i k a r o
abrasaremos	a b ɾ a s a ɾ e m o s
sobrevoladas	s o b ɾ e b o l a d a s
triángulos	t ɾ j a n ɡ u l o s
puntilla	p u n t i ʝ a
ligoteo	l i ɡ o t e o
sacramento	s a k ɾ a m e n t o
