<|IND|>gen	ɡ ɛ n
<|IND|>kapas	k a . p a s
<|IND|>senter	s ɛ n t ə r
<|IND|>juag	d͡ʒ u a k̚
<|IND|>rahayu	r a h a j u
<|IND|>gatal	ɡ a . t a l
<|IND|>pendarahan	p ə n . d a . r a h . a n
<|IND|>akil	a . k ɪ l
<|IND|>sentralistis	s ɛ n t r a l ɪ s t ɪ s
<|IND|>negeri	n ə ɡ ə r i
<|IND|>perjaka	p ə r . d͡ʒ a . k a
<|IND|>lansia	l a n s i a
<|IND|>bersedia	a b o n ə m ɛ n
<|IND|>vetsin	v ɛ t . ʃ i n
<|IND|>keadilan	k ə a d ɪ l a n
<|IND|>abilah	a b i l a h
<|IND|>kempis	k ə m p ɪ s
<|IND|>amo	a m o
<|IND|>malem	m a . l ə m
<|IND|>dansa	d a n . s a
<|IND|>nyiur	ɲ j u r
<|IND|>tahap	t a . h a p
<|IND|>bam	b a m
<|IND|>reanimasi	r e a n i m a s i
<|IND|>voli	v o . l i
<|IND|>mengalir	m ə ŋ . a . l ɪ r
<|IND|>lelang	l ɛ l a ŋ
<|IND|>bodok	b o d ɔ k̚
<|IND|>antigen	a n . t i . ɡ ɛ n
<|IND|>audite	a u̯ . d i . t e
<|IND|>defile	d e f i l e
<|IND|>kuil	k u ɪ l
<|IND|>puri	p u . r i
<|IND|>balur	b a l ʊ r
<|IND|>bangsa	b a ŋ . s a
<|IND|>pulut	p u l ʊ t̚
<|IND|>menganiayai	m ə ŋ a n i a j a i
<|IND|>mama	m a m a
<|IND|>kruk	k r ʊ k
<|IND|>bapak	b a p a ʔ
<|IND|>stasi	s t a s i
<|IND|>lintasan	l ɪ n . t a s . a n
<|IND|>amali	a . m a . l i
<|IND|>pendukung	p ə n d u k ʊ ŋ
<|IND|>siram	s i . r a m
<|IND|>yakin	j a k ɪ n
<|IND|>videografer	v i d e o ɡ r a f ə r
<|IND|>pengguna	p ə ŋ ɡ u n a
<|IND|>kuliah	k u l i a h
<|IND|>telur	t ə l u r
<|IND|>veteriner	v ɛ . t ə . r i . n ɛ r
<|IND|>anghun	a ŋ . h u n
<|IND|>imperialisme	ɪ m p ɛ r i a l ɪ s m ə
<|IND|>L	ɛ l
<|IND|>lateral	l a . t ə . r a l
<|IND|>urita	u r i t a
<|IND|>abir	a b ɪ r
<|IND|>semak	s ə m a ʔ
<|IND|>pemberontakan	p ə m b ə r ɔ n t a k a n
<|IND|>faring	f ä . r i ŋ
<|IND|>obrol	ɔ b r ɔ l
<|IND|>sabi	s a . b i
<|IND|>semir	s ə m i r
<|IND|>kardiolog	k a r . d i . o . l ɔ k
<|IND|>berus	b ə r ʊ s
<|IND|>ortu	o r . t u
<|IND|>engkau	ə ŋ k a u̯
<|IND|>tua	t u . a
<|IND|>makmum	m a ʔ m ʊ m
<|IND|>hakam	h a . k a m
<|IND|>anua	a . n u . a
<|IND|>korporal	k ɔ r . p o . r a l
<|IND|>perjanjian	p ə r . d͡ʒ a n . d͡ʒ i . a n
<|IND|>kuartal	k u a r t a l
<|IND|>penanda	p ə n a n d a
<|IND|>malik	m a . l ɪ ʔ
<|IND|>anyam	a ɲ a m
<|IND|>sutra	s u . t r a
<|IND|>gelora	ɡ ə l o r a
<|IND|>alir	a . l ɪ r
<|IND|>sempoa	s ə m p o a
<|IND|>bak	b a k
<|IND|>jangan	d͡ʒ a ŋ a n
<|IND|>enzim	ɛ n . z ɪ m
<|IND|>wasabi	w a s a b i
<|IND|>kumpulan	k ʊ m p ʊ l a n
<|IND|>selada	s a l a d a
<|IND|>altitudo	a l t i t u d o
<|IND|>nabi	n a b i
<|IND|>alpa	a l . p a
<|IND|>cendana	t͡ʃ ə n . d a . n a
<|IND|>mulai	m u . l a i̯
<|IND|>pasraman	p a s . r a . m a n
<|IND|>perasaan	p ə r a s a a n
<|IND|>Allah	ɑ l l ɑ h
<|IND|>tir	t ɪ r
<|IND|>kau	k a u̯
<|IND|>tebang	t ə . b a ŋ
<|IND|>kaji	k a d͡ʒ i
<|IND|>hedonisme	h e . d o . n i s . m ə
<|IND|>reduksionisme	r e . d ʊ k . s i . o . n ɪ s . m ə
<|IND|>arhir	a r . h ɪ r
<|IND|>ambyur	a m bʲ ʊ r
<|IND|>pulau	p u l a u̯
<|IND|>lomba	l ɔ m b a
<|IND|>kesenjangan	k ə . s ə n . d͡ʒ a ŋ . a n
<|IND|>tempeleng	t ə m . p e . l ɛ ŋ
<|IND|>margarin	m a r ɡ a r ɪ n
<|IND|>selaka	s ə . l a . k a
<|IND|>aliah	a l i a h
<|IND|>adiafora	a d i a f o r a
<|IND|>Naufal	n a u . f a l
<|IND|>prabu	p r a . b u
<|IND|>dakwaan	d a ʔ w a a n
<|IND|>menemukan	m ə n ə m u k a n
<|IND|>ketinggalan	k ə t i ŋ . ɡ a . l a n
<|IND|>ponsel	p o n s ɛ l
<|IND|>wadah	w a . d a h
<|IND|>soba	s o . b a
<|IND|>kartun	k a r t u n
<|IND|>celaan	t͡ʃ ə l a a n
<|IND|>kredo	k r e . d o
<|IND|>berambang	b ə . r a m . b a ŋ
<|IND|>difusi	d i f u s i
<|IND|>ergonomi	e r ɡ o n o m i
<|IND|>anjing	a n d͡ʒ i ŋ
<|IND|>romusa	r o . m u . s a
<|IND|>praktek	p r a k̚ t ɛ k̚
<|IND|>nira	n i . r a
<|IND|>grahita	ɡ r a . h i . t a
<|IND|>maktub	m a k t u b
<|IND|>reputasi	r e p u t a s i
<|IND|>gempita	ɡ ə m . p i . t a
<|IND|>cecer	t͡ʃ e . t͡ʃ ɛ r
<|IND|>sambilan	s a m . b ɪ l . a n
<|IND|>cabul	t͡ʃ a . b ʊ l
<|IND|>usul	u s ʊ l
<|IND|>kenyataan	k ə . ɲ a . t a . a n
<|IND|>Rabu	r a . b u
<|IND|>toto	t o t o
<|IND|>waralaba	w a r a l a b a
<|IND|>penguatan	p ə ŋ u a t̚ a n
<|IND|>granat	ɡ r a . n a t̚
<|IND|>kegagalan	k ə . ɡ a . ɡ a l . a n
<|IND|>biro	b i . r o
<|IND|>tertinggal	t ə r t ɪ ŋ ɡ a l
<|IND|>parut	p a . r ʊ t
<|IND|>halusinasi	h a l u s i n a s i
<|IND|>tentu	t ə n t u
<|IND|>lama	l a . m a
<|IND|>staf	s t a f
<|IND|>uskup	u s . k ʊ p
<|IND|>swasta	s w a s t a
<|IND|>Callista	k a l i s t a
<|IND|>Finlandia	f ɪ n l a n d i a̯
<|IND|>juta	d͡ʒ u t a
<|IND|>aruna	a r u n a
<|IND|>bahaya	b a h a j a
<|IND|>PM	p e ɛ m
<|IND|>adaptif	a d a p . t ɪ f
<|IND|>benduan	b ə n . d u . a n
<|IND|>celapa	t͡ʃ ə . l a . p a
<|IND|>perintah	p ə r ɪ n t a h
<|IND|>ribu	r i b u
<|IND|>kompet	k ɔ m p ɛ t̚
<|IND|>marhabanan	m a r h a b a n a n
<|IND|>semangka	s ə . m a ŋ . k a
<|IND|>kopitiam	k o p i t i a m
<|IND|>lestari	l ə s . t a . r i
<|IND|>chindo	t͡ʃ i n d o
<|IND|>yubileum	j u b i l e ʊ m
<|IND|>hadiah	h a d i j a h
<|IND|>awet	a . w ɛ t
<|IND|>baftah	b a f t a h
<|IND|>tamat	t a m a t̚
<|IND|>mizab	m i z a p̚
<|IND|>jenasah	d͡ʒ ə n a s a h
<|IND|>aporia	a . p o . r i . a
<|IND|>aslosin	a s . l o . s ɪ n
<|IND|>syahbandar	ʃ a h . b a n . d a r
<|IND|>anggara	a ŋ ɡ a r a
<|IND|>kait	k a ɪ t̚
<|IND|>kembang	k ə m b a ŋ
<|IND|>resep	r ə s ɛ p
<|IND|>kilap	k i l a p̚
<|IND|>analitis	a n a l i t ɪ s
<|IND|>patriarkat	p a . t r i . a r . k a t̚
<|IND|>pap	p a p
<|IND|>mengabsen	m ə ŋ . a p . s e n
<|IND|>bausastra	b a . u . s a s . t r a
<|IND|>anyir	a ɲ ɪ r
<|IND|>terpal	t ə r p a l
<|IND|>darah	d a r a h
<|IND|>angsongar	a ŋ s o ŋ a r
<|IND|>belajar	b ə . l a . d͡ʒ a r
<|IND|>romansa	r o m a n s a
<|IND|>komisi	k o m i . s i
<|IND|>sabo	s a . b o
<|IND|>atan	a t a n
<|IND|>koneksi	k o n ɛ k s i
<|IND|>lanca	l a n . t͡ʃ a
<|IND|>anuhuai	a . n u . h u . a i̯
<|IND|>kurung	k u . r ʊ ŋ
<|IND|>paru	p ä . r u
<|IND|>sapa	s a . p a
<|IND|>sarung	s a r ʊ ŋ
<|IND|>puas	p u a s
<|IND|>dedak	d ə . d a k
<|IND|>rantau	r a n . t a u̯
<|IND|>pahala	p a . h a . l a
<|IND|>pekerjaan	p ə . k ə r . d ʒ a . ʔ a n
<|IND|>diferensial	d i . f e . r ɛ n . s i . a l
<|IND|>gravitasi	ɡ r a v i t a s i
<|IND|>hilang	h i l a ŋ
<|IND|>inset	i n s ɛ t
<|IND|>observasi	ɔ p̚ . s ə r . v a . s i
<|IND|>dana	d a . n a
<|IND|>magis	m a . ɡ ɪ s
<|IND|>abiseka	a b i . s e . k a
<|IND|>tempur	t ə m p ʊ r
<|IND|>terowongan	t ə r o w ɔ ŋ a n
<|IND|>semalem	s ə . m a . l ə m
<|IND|>KPR	k a . p e . ɛ r
<|IND|>gunseikan	ɡ u n . s e i . k a n
<|IND|>algoritmik	a l ɡ o r ɪ t̚ m ɪ k̚
<|IND|>prei	p r e i
<|IND|>kamuflase	k a m u f l a s ə
<|IND|>antunga	a n . t u . ŋ a
<|IND|>mangkat	m a ŋ k a t̚
<|IND|>anggong	a ŋ ɡ ɔ ŋ
<|IND|>sarasehan	s a . r a . s ɛ h . a n
<|IND|>meritokratis	m e . r i . t o . k r a . t ɪ s
<|IND|>antesis	a n t e s ɪ s
<|IND|>ikhlas	i x l a s
<|IND|>hasad	h a s a t̚
<|IND|>aksara	a k . s a . r a
<|IND|>uban	u . b a n
<|IND|>menyerahkan	m ə ɲ ə r a h k a n
<|IND|>vasokonstriksi	v a s o k ɔ n s t r ɪ k s i
<|IND|>makasih	m a . k a . s ɪ h
<|IND|>iktibar	ɪ ʔ t i b a r
<|IND|>merusak	m ə r u s a ʔ
<|IND|>gempa	ɡ ə m p a
<|IND|>dorongan	d ɔ r ɔ ŋ a n
<|IND|>terburuk	t ə r b u r ʊ k̚
<|IND|>apoking	a . p o . k ɪ ŋ
<|IND|>antardesa	a n t a r d ɛ s a
<|IND|>akatopi	a k a t o p i
<|IND|>angkasawan	a ŋ k a s a w a n
<|IND|>penerimaan	p ə . n ə . r i . m a . a n
<|IND|>mengumpamakan	m ə ŋ u m p a m a k a n
<|IND|>lapis	l a . p ɪ s
<|IND|>lebar	l e b a r
<|IND|>adat	a . d a t
<|IND|>pelacur	p ə . l a . t͡ʃ ʊ r
<|IND|>dasar	d a s a r
<|IND|>guna	ɡ u n a
<|IND|>roman	r o . m a n
<|IND|>aniaya	a n i . a . j a
<|IND|>penyesuaian	p ə ɲ ə s u a i̯ a n
<|IND|>ampul	a m . p ʊ l
<|IND|>adpis	a t̚ p ɪ s
<|IND|>erti	ə r . t i
<|IND|>kutang	k u . t a ŋ
<|IND|>sa	s a
<|IND|>joli	d͡ʒ o l i
<|IND|>resmi	r ə s . m i
<|IND|>takal	t a . k a l
<|IND|>takut	t a . k u t
<|IND|>sri	s ə r i
<|IND|>butana	b u . t a . n a
<|IND|>idap	ɪ d a p̚
<|IND|>pelarian	p ə . l a . r i . a n
<|IND|>surga	s ʊ r ɡ a
<|IND|>rames	r a . m ə s
<|IND|>sana	s a n a
<|IND|>pekan	p ə k a n
<|IND|>jang	j a ŋ
<|IND|>KTP	k a t ɛ p ɛ
<|IND|>kelar	k ə . l a r
<|IND|>krans	k r a n s
<|IND|>tabu	t a b u
<|IND|>elang	ə l a ŋ
<|IND|>ketahanan	k ə t a h a n a n
<|IND|>kardiovaskuler	k a r d i o v a s k u l ɛ r
<|IND|>kofte	k ɔ f t e
<|IND|>antok	a n t ɔ k̚
<|IND|>fatamorgana	f a t a m ɔ r ɡ a n a
<|IND|>belom	b ə . l o m
<|IND|>askese	a s k e s ə
<|IND|>BNPT	b e ɛ n p e t e
<|IND|>bumbung	b u m b u ŋ
<|IND|>angin	a ŋ i n
<|IND|>apen	a p ə n
<|IND|>ider	i d ə r
<|IND|>A	a
<|IND|>bobrok	b o . b r ɔ k
<|IND|>unggul	u ŋ ɡ ʊ l
<|IND|>jeneng	d͡ʒ ɛ . n ɛ ŋ
<|IND|>l	ɛ l
<|IND|>seremoni	s e . r e . m o . n i
<|IND|>kelambu	k ə l a m b u
<|IND|>angsang	a ŋ s a ŋ
<|IND|>silet	s i l ɛ t̚
<|IND|>mag	m ɑ h
<|IND|>babaun	b a . b a . ʊ n
<|IND|>bilateral	b i . l a . t ə . r a l
<|IND|>lokalisasi	l o k a l i s a s i
<|IND|>cakalang	t͡ʃ a . k a . l a ŋ
<|IND|>kers	k ɛ r s
<|IND|>Ahad	a h a t̚
<|IND|>serong	s ɛ r ɔ ŋ
<|IND|>lulusan	l u l ʊ s a n
<|IND|>datuk	d a t ʊ k̚
<|IND|>layang	l a . j a ŋ
<|IND|>udon	u . d o n
<|IND|>timpang	t ɪ m . p a ŋ
<|IND|>ganti	ɡ a n . t i
<|IND|>tenggelam	t ə ŋ ɡ ə l a m
<|IND|>majelis	m a d͡ʒ ə l ɪ s
<|IND|>merubah	m ə r u b a h
<|IND|>rembesan	r ə m b ə s a n
<|IND|>radius	r a d i ʊ s
<|IND|>berketombe	b ə r k ə t ɔ m b e
<|IND|>adorasi	a . d o . r a . s i
<|IND|>huruf	h u r ʊ f
<|IND|>toksin	t ɔ k . s ɪ n
<|IND|>termoregulasi	t ɛ r . m o . r e . ɡ u . l a . s i
<|IND|>khawatir	x a w a t ɪ r
<|IND|>bajaj	b a . d ʒ a i̯
<|IND|>tunang	t u . n a ŋ
<|IND|>pelatih	p ə l a t ɪ h
<|IND|>brahmana	b r a h m a n a
<|IND|>Turki	t u r k i
<|IND|>tiris	t i r i s
<|IND|>lensa	l ɛ n s a
<|IND|>kepada	k ə p a d a
<|IND|>binawah	b i n a w a h
<|IND|>mampu	m a m p u
<|IND|>penyederhanaan	p ə . ɲ ə . d ə r . h a . n a . a n
<|IND|>tadah	t a d a h
<|IND|>farsakh	f a r s a x
<|IND|>perunggu	p ə . r ʊ ŋ . ɡ u
<|IND|>duka	d u . k a
<|IND|>badare	b a . d a . r ə
<|IND|>hechting	h ɛ k̚ t ɪ ŋ
<|IND|>mangkuk	m a ŋ k ʊ k̚
<|IND|>mastautin	m a s t a u̯ t ɪ n
<|IND|>goban	ɡ o . b a n
<|IND|>kelab	k ə l a b
<|IND|>tajin	t a . d͡ʒ ɪ n
<|IND|>limit	l i m ɪ t̚
<|IND|>kitab	k i . t a p̚
<|IND|>arapota	a . r a . p o . t a
<|IND|>puja	p u . d͡ʒ a
<|IND|>itas	i t a s
<|IND|>riol	r i . ɔ l
<|IND|>gejala	ɡ ə . d͡ʒ a . l a
<|IND|>jasuke	d͡ʒ a s u k e
<|IND|>mahram	m a h r a m
<|IND|>KTSP	k a t e ɛ s p e
<|IND|>spesifik	s p ɛ s i f ɪ k̚
<|IND|>apek	a . p ɛ k
<|IND|>anggi	a ŋ ɡ i
<|IND|>ken	k ɛ n
<|IND|>baronsai	b a . r o n . s a i̯
<|IND|>bad	b a t̚
<|IND|>anoda	a . n o . d a
<|IND|>benar	b e . n a r
<|IND|>serdadu	s ə r d a d u
<|IND|>hibah	h i b a h
<|IND|>adempauze	a d ə m . p a u̯ . z ə
<|IND|>artropoda	a r t r o p o d a
<|IND|>syabas	ʃ a . b a s
<|IND|>gereja	ɡ ə r ɛ d͡ʒ a
<|IND|>makanan	m a k a . n a n
<|IND|>deforestasi	d e . f o . r ə s . t a . s i
<|IND|>kencana	k ə n . t͡ʃ a . n a
<|IND|>terung	t ə . r ʊ ŋ
<|IND|>baktau	b a k . t a ʊ̯
<|IND|>ijazah	ɪ d͡ʒ a z a h
<|IND|>bazar	b a . z a r
<|IND|>aplaus	a p . l a . u s
<|IND|>fasakh	f a s a ʔ
<|IND|>ancala	a n t͡ʃ a l a
<|IND|>Nyonya	ɲ o ɲ a
<|IND|>lobang	l o b a ŋ
<|IND|>toksikologi	t ɔ k . s i . k o . l o . ɡ i
<|IND|>kumulatif	k u m u l a t ɪ f
<|IND|>verano	v e r a n o
<|IND|>handal	h a n d a l
<|IND|>sehat	s ɛ h a t̚
<|IND|>x	ɛ k s
<|IND|>tensi	t ɛ n s i
<|IND|>ibukota	i . b u . k o . t a
<|IND|>sarkas	s a r k a s
<|IND|>kompi	k ɔ m p i
<|IND|>angsana	a ŋ s a n a
<|IND|>sabit	s a b ɪ t̚
<|IND|>pangkat	p a ŋ k a t̚
<|IND|>ayun	a j ʊ n
<|IND|>akademi	a k a . d e . m i
<|IND|>madrasah	m a d r a s a h
<|IND|>lues	l u . e s
<|IND|>bawang	b a w a ŋ
<|IND|>defleksi	d e . f l ɛ k . s i
<|IND|>jala	d͡ʒ a l a
<|IND|>biologis	b i o l o ɡ ɪ s
<|IND|>averoisme	a . v e . r o . ɪ s . m ə
<|IND|>mengoplos	m ə ŋ . o p . l o s
<|IND|>sumbu	s ʊ m . b u
<|IND|>ibadah	i . b a . d a h
<|IND|>delesi	d e . l e . s i
<|IND|>ananim	a n a n ɪ m
<|IND|>dongkrak	d ɔ ŋ k r a k̚
<|IND|>nirharapan	n i r h a r a p a n
<|IND|>akeo	a k e o
<|IND|>acar	a t͡ʃ a r
<|IND|>titinada	t i . t i . n a . d a
<|IND|>paus	p a ʊ s
<|IND|>penghancuran	p ə ŋ h a n t͡ʃ ʊ r a n
<|IND|>karnivora	k a r n i v o r a
<|IND|>samsek	s a m . s ə k
<|IND|>watas	w a t a s
<|IND|>deselerasi	d e s ɛ l ə r a s i
<|IND|>momentum	m o . m ɛ n . t ʊ m
<|IND|>tinggal	t ɪ ŋ ɡ a l
<|IND|>galak	ɡ a . l a k
<|IND|>tenggorokan	t̪ ə ŋ . ɡ o . r o . k ä n
<|IND|>mitos	m i t o s
<|IND|>palang	p a l a ŋ
<|IND|>karsa	k a r s a
<|IND|>etude	e t u d ɛ
<|IND|>mendiamkan	m ə n d i a m k a n
<|IND|>ketan	k ə t a n
<|IND|>taju	t a d͡ʒ u
<|IND|>kandela	k a n . d e . l a
<|IND|>penyelenggaraan	p ə . ɲ ə . l ə ŋ . ɡ a . r a . a n
<|IND|>debu	d ə b u
<|IND|>rogol	r ɔ . ɡ ɔ l
<|IND|>ragil	r a . ɡ ɪ l
<|IND|>gapura	ɡ a p u r a
<|IND|>judogi	d͡ʒ u . d o . ɡ i
<|IND|>gelak	ɡ ə l a k
<|IND|>Ibrani	i b r a n i
<|IND|>hara	h a . r a
<|IND|>tentang	t ə n t a ŋ
<|IND|>gagang	ɡ a . ɡ a ŋ
<|IND|>Jepang	d͡ʒ ə p a ŋ
<|IND|>PSK	p ɛ ɛ s k a
<|IND|>rujak	r u d͡ʒ a ʔ
<|IND|>ambyang	a m bʲ a ŋ
<|IND|>takar	t a k a r
<|IND|>bujangga	b u . d͡ʒ a ŋ . ɡ a
<|IND|>kuntit	k ʊ n t ɪ t̚
<|IND|>awo	a w o
<|IND|>insidental	ɪ n . s i . d ɛ n . t a l
<|IND|>grup	ɡ r ʊ p̚
<|IND|>punca	p ʊ n . t͡ʃ a
<|IND|>pedupaan	p ə d u p a a n
<|IND|>lasik	l a . s i k
<|IND|>ngab	ŋ a b
<|IND|>dom	d ɔ m
<|IND|>resistor	r e s ɪ s t ɔ r
<|IND|>degeneratif	d e ɡ e n ə r a t ɪ f
<|IND|>ꦢꦺꦱ	d e . s ɔ
<|IND|>edaran	e . d a r . a n
<|IND|>atmosferis	a t m ɔ s f ɛ r ɪ s
<|IND|>tebusan	t ə . b u . s a n
<|IND|>frekuensi	f r e k u ɛ n s i
<|IND|>cogan	t͡ʃ o . ɡ a n
<|IND|>seprai	s ə p . r a i
<|IND|>Malingsia	m ä l ɪ ŋ . s i a
<|IND|>absolusi	a b s o l u s i
<|IND|>gugur	ɡ u . ɡ ʊ r
<|IND|>defekasi	d e f e k a s i
<|IND|>beleran	b ɛ l ɛ r aː n
<|IND|>tahu	t a u
<|IND|>jawab	d͡ʒ a . w a p̚
<|IND|>BBLR	b e b e ɛ l ɛ r
<|IND|>blek	b l ɛ k
<|IND|>beli	b ə l i
<|IND|>mari	m a . r i
<|IND|>kelarutan	k ə . l a . r u . t a n
<|IND|>tengkujuh	t ə ŋ k u d͡ʒ ʊ h
<|IND|>berjibaku	b ə r . d͡ʒ i . b a . k u
<|IND|>perdikan	p ə r d i k a n
<|IND|>selak	s e . l a k
<|IND|>aforestasi	a f o r ɛ s t a s i
<|IND|>sela	s e . l a
<|IND|>PR	p ɛ . ɛ r
<|IND|>pengadaan	p ə ŋ . a d a . a n
<|IND|>badi	b a d i
<|IND|>Indonesia	i n . d o . n ɛ . s ɪ . j a
<|IND|>kabus	k a b ʊ s
<|IND|>adiksimba	a d ɪ k s ɪ m b a
<|IND|>kamikaze	k a m i k a z e
<|IND|>aliansi	a l i a n s i
<|IND|>berdarah	b ə r d a r a h
<|IND|>cilik	t͡ʃ i . l ɪ k
<|IND|>jentera	d͡ʒ ə n t ə r a
<|IND|>honji	h o n . d͡ʒ i
<|IND|>bukti	b u k . t i
<|IND|>dekomposisi	d e k ɔ m p o s i s i
<|IND|>kacung	k a t͡ʃ ʊ ŋ
<|IND|>jadwal	d͡ʒ a t̚ w a l
<|IND|>berpulang	b ə r p u l a ŋ
<|IND|>unik	u n i k
<|IND|>interferensi	ɪ n t ə r f ə r ɛ n s i
<|IND|>hidayah	h i d a j a h
<|IND|>takeyari	t a . k e . y a . r i
<|IND|>anakompo	a n a k ɔ m p o
<|IND|>segara	s ə ɡ a r a
<|IND|>kandil	k a n . d ɪ l
<|IND|>jawi	d͡ʒ a . w i
<|IND|>alokai	a l o k a i̯
<|IND|>soang	s o a̯ ŋ
<|IND|>nasi	n a s i
<|IND|>riskan	r i s . k a n
<|IND|>margasatwa	m a r . ɡ a . s a t . w a
<|IND|>asidulan	a s i . d u . l a n
<|IND|>kersen	k ɛ r s ə n
<|IND|>Aceh	a t͡ʃ e h
<|IND|>empati	ɛ m p a t i
<|IND|>klasikal	k l a s ɪ k . a l
<|IND|>penderita	p ə n d ə r i t a
<|IND|>titrasi	t i t r a s i
<|IND|>gaharu	ɡ a h a r u
<|IND|>uduk	u . d ʊ k
<|IND|>terkait	t ə r k a ɪ t̚
<|IND|>proses	p r o s ɛ s
<|IND|>ansai	a n . s a i̯
<|IND|>asmara	a s . m a . r a
<|IND|>astronaut	a s t r o n a u̯ t̚
<|IND|>batik	b a t ɪ k
<|IND|>aktivasi	a k̚ t i v a s i
<|IND|>pura	p u . r a
<|IND|>tablig	t a b l ɪ k̚
<|IND|>teorema	t e o r ɛ m a
<|IND|>sepur	s ə p u r
<|IND|>spesifisitas	s p e s i f i s i t a s
<|IND|>ingin	i . ŋ i n
<|IND|>tudung	t u . d ʊ ŋ
<|IND|>uber	u b ə r
<|IND|>semong	s ə m ɔ ŋ
<|IND|>perolehan	p ə r o l ɛ h . a n
<|IND|>antrap	a n t r a p̚
<|IND|>keputusasaan	k ə p u t u s a s a a n
<|IND|>Estonia	e s t o n i a̯
<|IND|>fotosel	f o t o s ɛ l
<|IND|>kertas	k ə r t a s
<|IND|>parpol	p a r . p o l
<|IND|>potongan	p ɔ t ɔ ŋ a n
<|IND|>losmen	l o s . m ɛ n
<|IND|>antarbahasa	a n t a r b a h a s a
<|IND|>mudra	m u d . r a
<|IND|>kirik	k i . r ɪ ʔ
<|IND|>Bulgaria	b ʊ l ɡ a r i a̯
<|IND|>ateisme	a t e ɪ s m ə
<|IND|>kapan	k a . p a n
<|IND|>aftab	a f t a p̚
<|IND|>aneka	a n ɛ . k a
<|IND|>fluks	f l ʊ k s
<|IND|>ketersediaan	k ə . t ə r . s ə . d i . a . a n
<|IND|>apang	a p a ŋ
<|IND|>tumbuh	t ʊ m b ʊ h
<|IND|>aktris	a k t r ɪ s
<|IND|>mengetatkan	m ə ŋ ə t a t̚ k a n
<|IND|>amoh	a m ɔ h
<|IND|>rancang	r a n . t͡ʃ a ŋ
<|IND|>seri	s e . r i
<|IND|>langau	l a ŋ a u̯
<|IND|>mewah	m ɛ w a h
<|IND|>anaheha	a n a h e h a
<|IND|>lengket	l ɛ ŋ k ɛ t̚
<|IND|>edisi	ɛ d i s i
<|IND|>pada	p a d a
<|IND|>rapat	r a p a t
<|IND|>memberhentikan	m ə m b ə r h ə n t i k a n
<|IND|>kering	k ə r ɪ ŋ
<|IND|>nanti	n a n . t i
<|IND|>babka	b a p . k a
<|IND|>piadah	p i a d a h
<|IND|>maljum	m a l d͡ʒ u m
<|IND|>dekat	d ə k a t
<|IND|>G	ɡ e
<|IND|>didik	d i d ɪ ʔ
<|IND|>homo	h o . m o
<|IND|>silsilah	s ɪ l s i l a h
<|IND|>jangankan	d͡ʒ a . ŋ a n . k a n
<|IND|>alutta	a l ʊ t t a
<|IND|>empu	ə m p u
<|IND|>anuitas	a . n u . i . t a s
<|IND|>influen	ɪ n f l u ɛ n
<|IND|>lengan	l ə . ŋ ä n
<|IND|>seprei	s ə p . r e i
<|IND|>emoji	e . m o . d͡ʒ i
<|IND|>bab	b a b
<|IND|>ambir	a m b ɪ r
<|IND|>rasuah	r a . s u . a h
<|IND|>ancaman	a n . t͡ʃ a . m a n
<|IND|>babad	b a b a t̚
<|IND|>indikator	ɪ n d i k a t ɔ r
<|IND|>sempurna	s ə m . p u r . n a
<|IND|>awam	a w a m
<|IND|>aboi	a . b o i̯
<|IND|>gabah	ɡ a b a h
<|IND|>alel	a . l ɛ l
<|IND|>puji	p u . d͡ʒ i
<|IND|>skor	s k o r
<|IND|>Ngawi	ŋ a w i
<|IND|>membranofon	m ɛ m b r a n o f ɔ n
<|IND|>kerbau	k ə r b a u̯
<|IND|>obi	o . b i
<|IND|>resorpsi	r e s ɔ r p s i
<|IND|>J	d͡ʒ e
<|IND|>resonansi	r e . s o . n a n . s i
<|IND|>pecutan	p ə t͡ʃ ʊ t a n
<|IND|>demografi	d e m o ɡ r a f i
<|IND|>anaye	a n a j ɛ
<|IND|>bayu	b a j u
<|IND|>ambiguitas	a m b i ɡ u i t a s
<|IND|>aplikatif	a p l i k a t ɪ f
<|IND|>blangko	b ə̆ l a ŋ k o
<|IND|>munsyi	m u n . ʃ i
<|IND|>fotoelektrisitas	f o t o ɛ l ɛ k̚ t r i s i t a s
<|IND|>pionir	p i o n ɪ r
<|IND|>maka	m a k a
<|IND|>andap	a n . d a p
<|IND|>suka	s u k a
<|IND|>maling	m a . l ɪ ŋ
<|IND|>dikau	d i k a u̯
<|IND|>anakia	a n a k i a̯
<|IND|>mesjid	m ə s d͡ʒ ɪ t̚
<|IND|>tasbih	t a s b ɪ h
<|IND|>badul	b a . d ʊ l
<|IND|>sumatif	s u . m a . t ɪ f
<|IND|>mustahik	m ʊ s t a h ɪ k̚
<|IND|>dewan	d ɛ w a n
<|IND|>manira	m a . n i . r a
<|IND|>asal	a . s a l
<|IND|>asid	a s ɪ t
<|IND|>audiometri	a u̯ . d i . o . m e . t r i
<|IND|>wafat	w a f a t̚
<|IND|>lada	l a d a
<|IND|>tuntut	t u n . t ʊ t
<|IND|>menggali	m ə ŋ . ɡ a . l i
<|IND|>kilang	k i l a ŋ
<|IND|>Maret	m a r ə t
<|IND|>E	e
<|IND|>hayati	h a . j a . t i
<|IND|>informasi	i n f ɔ r m a s i
<|IND|>menghadiri	m ə ŋ . h a . d i r . i
<|IND|>antum	a n t ʊ m
<|IND|>irama	i r a m a
<|IND|>ekaristi	ɛ k a r i s t i
<|IND|>among	a m ɔ ŋ
<|IND|>kamber	k a m . b ə r
<|IND|>Juni	d͡ʒ u . n i
<|IND|>dorna	d o r n a
<|IND|>saat	s a . ʔ a t
<|IND|>aplikan	a p̚ l i k a n
<|IND|>lauk	l a . ʊ ʔ
<|IND|>rasio	r a s i o̯
<|IND|>kasuistik	k a s u ɪ s t ɪ k̚
<|IND|>dewana	d ɛ w a n a
<|IND|>suvenir	s u v ə n ɪ r
<|IND|>aktivisme	a k̚ t i v ɪ s m ə
<|IND|>heptana	h e p . t a . n a
<|IND|>giat	ɡ i a t̚
<|IND|>sengsai	s ɛ ŋ . s a i
<|IND|>mengencingi	m ə . ŋ e n . c i ŋ . i
<|IND|>ongkos	o ŋ . k o s
<|IND|>angrem	a ŋ r ə m
<|IND|>desalinasi	d e . s a . l i . n a . s i
<|IND|>terbesar	t ə r b ə s a r
<|IND|>taring	t a . r ɪ ŋ
<|IND|>onigiri	o . n i . ɡ i . r i
<|IND|>wortel	w o r . t ə l
<|IND|>anggas	a ŋ ɡ a s
<|IND|>partus	p a r . t ʊ s
<|IND|>pemabuk	p ə m a b u k
<|IND|>rindang	r ɪ n d a ŋ
<|IND|>sagu	s a ɡ o
<|IND|>khizanatulkitab	x i z a n a t ʊ l k i t a p̚
<|IND|>KPK	k a p e k a
<|IND|>negoisasi	n ɛ . ɡ o . s i . a . s i
<|IND|>menganggap	m ə ŋ a ŋ ɡ a p̚
<|IND|>heterogen	h e . t e . r o . ɡ ɛ n
<|IND|>parlementer	p a r l ə m ɛ n t ɛ r
<|IND|>SHUN	ɛ s h a u ɛ n
<|IND|>babatan	b a . b a t . a n
<|IND|>tepis	t ə . p ɪ s
<|IND|>anggal	a ŋ . ɡ a l
<|IND|>jadi	d ʒ a . d i
<|IND|>mencekoki	m ə ɲ . t͡ʃ ə . k o . k i
<|IND|>sambungan	s a m . b ʊ ŋ . a n
<|IND|>siang	s i . a ŋ
<|IND|>tersier	t ɛ r s i ɛ r
<|IND|>rasional	r a s i o n a l
<|IND|>kolektivitas	k o l ɛ k t i v i t a s
<|IND|>moda	m o . d a
<|IND|>asyik	a . ʃ ɪ k
<|IND|>ꦱꦺꦴꦕ	s o t͡ʃ ɔ
<|IND|>pemacu	p ə . m a . t͡ʃ u
<|IND|>asbabulwurud	a s . b a . b ʊ l . w u . r ʊ t
<|IND|>pengecaman	p ə . ŋ ə . t͡ʃ a m . a n
<|IND|>binasa	b i . n a . s a
<|IND|>micin	m i . t͡ʃ i n
<|IND|>pandemi	p a n d e m i
<|IND|>kabuki	k a b u k i
<|IND|>merk	m ɛ r k
<|IND|>angki	a ŋ k i
<|IND|>catat	t͡ʃ a t a t̚
<|IND|>luka	l u k a
<|IND|>Islandia	ɪ s l a n d i a̯
<|IND|>Indra	i n . d r a
<|IND|>antaladan	a n . t a . l a . d a n
<|IND|>julang	d͡ʒ u l a ŋ
<|IND|>pertahanan	p ə r t a h a n a n
<|IND|>bungsut	b ʊ ŋ s ʊ t̚
<|IND|>masakan	m a s a k̚ a n
<|IND|>jagung	d͡ʒ a ɡ ʊ ŋ
<|IND|>perpaduan	p ə r p a d u a n
<|IND|>kultivasi	k ʊ l t i v a s i
<|IND|>aspal	a s . p a l
<|IND|>aloun	a . l o . ʊ n
<|IND|>perbuatan	p ə r . b u . a . t a n
<|IND|>akar	a . k a r
<|IND|>tengok	t e . ŋ ɔ k
<|IND|>perembesan	p ə . r ə m . b ə s . a n
<|IND|>kotor	k o t o r
<|IND|>tiram	t i r a m
<|IND|>baba	b a . b a
<|IND|>borang	b ɔ r a ŋ
<|IND|>dukung	d u . k ʊ ŋ
<|IND|>tinjau	t i n d͡ʒ a u̯
<|IND|>onagata	o . n a . ɡ a . t a
<|IND|>arowon	a . r o . w ɔ n
<|IND|>magnitudo	m a k n i t u d o
<|IND|>nyaman	ɲ a m a n
<|IND|>zikir	z i k ɪ r
<|IND|>menggarisbawahi	m ə ŋ . ɡ a . r i s . b a . w a h . i
<|IND|>penganjur	p ə ŋ a n d͡ʒ ʊ r
<|IND|>kontributor	k ɔ n . t r i . b u . t ɔ r
<|IND|>berbeda	b ə r b ɛ d a
<|IND|>kabupaten	k a . b u . p a . t e n
<|IND|>nabatah	n a b a t a h
<|IND|>tanggapan	t a ŋ . ɡ a . p a n
<|IND|>tengar	t ə ŋ a r
<|IND|>siber	s i b ə r
<|IND|>permainan	p ə r m a i . n a n
<|IND|>rekonsiliasi	r e . k ɔ n . s i . l i . a . s i
<|IND|>mengatakan	m ə ŋ a t a k a n
<|IND|>ritsleting	r i t . s l ə . t i ŋ
<|IND|>nalar	n a l a r
<|IND|>mukbang	m ʊ k b ɑ ŋ
<|IND|>kayas	k a j a s
<|IND|>pihak	p i h a ʔ
<|IND|>kehujanan	k ə h u d͡ʒ a n a n
<|IND|>asrok	a s . r ɔ k
<|IND|>amporang	a m p o r a ŋ
<|IND|>bersenandung	b ə r s ə n a n d ʊ ŋ
<|IND|>ransel	r a n . s ə l
<|IND|>perdana	p ə r d a n a
<|IND|>am	a m
<|IND|>pita	p i . t a
<|IND|>buku	b u k u
<|IND|>eksim	ɛ k . s ɪ m
<|IND|>determinasi	d e . t ɛ r . m i . n a . s i
<|IND|>warkat	w a r . k a t
<|IND|>sentul	s ə n . t ʊ l
<|IND|>yuyitsu	j u . j i t . s u
<|IND|>izin	ɪ z ɪ n
<|IND|>calak	t͡ʃ a l a ʔ
<|IND|>abras	a b . r a s
<|IND|>perabuan	p ə r a b u a n
<|IND|>manga	m a n ɡ a
<|IND|>IPA	i . p a
<|IND|>kedaerahan	k ə . d a ɛ . r a h . a n
<|IND|>komet	k o . m ɛ t̚
<|IND|>alodna	a . l ɔ t . n a
<|IND|>psikolog	p ə s i k o l ɔ k̚
<|IND|>pialang	p ɪ j a l a ŋ
<|IND|>sadir	s a d ɪ r
<|IND|>alis	ʔ ä . l i s
<|IND|>aora	a . o . r a
<|IND|>doa	d o a
<|IND|>persentil	p ə r . s ɛ n . t ɪ l
<|IND|>Tamil	t a m ɪ l
<|IND|>aruris	a . r u . r ɪ s
<|IND|>pencucian	p ə n t͡ʃ u t͡ʃ iʲ a n
<|IND|>sami	s a m i
<|IND|>bagan	b a . ɡ a n
<|IND|>amput	a m p ʊ t̚
<|IND|>ajara	a d͡ʒ a r a
<|IND|>gugus	ɡ u ɡ ʊ s
<|IND|>muluk	m u . l ʊ ʔ
<|IND|>kandungan	k a n d ʊ ŋ a n
<|IND|>iotasisme	i o t a s ɪ s m ə
<|CEB|>Abapo	ʔ a b a p o
<|CEB|>Abesamis	ʔ a b e s a m i s
<|CEB|>Abril	ʔ a b ɾ i l
<|CEB|>Adbentista	ʔ a d b e n t i s t a
<|CEB|>Adlawan	ʔ ɐ d l a w a n
<|CEB|>Agas	a ɡ ɐ s
<|CEB|>Agdao	ʔ a ɡ d a w
<|CEB|>Alcoy	ʔ a l k o j
<|CEB|>Alvarado	ʔ a l b a ɾ a d o
<|CEB|>Aragon	ʔ a ɾ a ɡ o n
<|CEB|>Baclayon	b a k l a j o n
<|CEB|>Bacus	b a k u s
<|CEB|>Balatik	b a l a t i k
<|CEB|>Balbuena	b a l b u w e n a
<|CEB|>Barcenas	b a ɾ s e n a s
<|CEB|>Bautista	b a w t i s t a
<|CEB|>Bernes	b e ɾ n e s
<|CEB|>Bibliya	b i b l i a
<|CEB|>Bogohanon	b o ɡ o h a n o n
<|CEB|>Bohol	b o h o l
<|CEB|>Bonghanoy	b o ŋ h a n o j
<|CEB|>Borongan	b o ɾ o n ɡ a n
<|CEB|>Bulacan	b u l a k a n
<|CEB|>Cabanlit	k a b a n l i t
<|CEB|>Cabatuan	k a b a t u ʔ a n
<|CEB|>Cabello	k a b e l j o
<|CEB|>Cadeliña	k a d e l i ɲ a
<|CEB|>Calinan	k a l i n a n
<|CEB|>Castañeda	k a s t a ɲ e d a
<|CEB|>Castaños	k a s t a ɲ o s
<|CEB|>Catmon	k a t m o n
<|CEB|>Cayanong	k a j a n o ŋ
<|CEB|>Cañete	k a ɲ e t e
<|CEB|>Comendador	k o m e n d a d o ɾ
<|CEB|>Cyrus	s a j ɾ u s
<|CEB|>Daanlungsod	d a a n l u ŋ s o d
<|CEB|>Dacumos	d a k u m o s
<|CEB|>Dagohoy	d a ɡ o h o j
<|CEB|>Divinagracia	d i b i n a ɡ ɾ a s j a
<|CEB|>Diyos	d i j o s
<|CEB|>Eguia	ʔ e ɡ i j a
<|CEB|>Enero	ʔ e n e ɾ o
<|CEB|>Eulogia	ʔ e w l o h i j a
<|CEB|>Francisco	p ɾ a n s i s k o
<|CEB|>Genaro	h e n a ɾ o
<|CEB|>Gomez	ɡ o m e s
<|CEB|>Guiuan	ɡ i w a n
<|CEB|>Huybes	h u i b e s
<|CEB|>Ibañez	ʔ i b a ɲ e s
<|CEB|>Iloilo	ʔ i l o j l o
<|CEB|>Intsik	ʔ ɪ n t͡ʃ i k
<|CEB|>Jorge	h o r h ɛ
<|CEB|>Jose	h o s e
<|CEB|>Kasambagan	k a s a m b a ɡ a n
<|CEB|>Kinatsila	k i n a t s i l a ʔ
<|CEB|>Kulas	k u l a s
<|CEB|>Lawas	l a w a s
<|CEB|>Lisondra	l i s o n d ɾ a
<|CEB|>Loreto	l o ɾ e t o
<|CEB|>Lunes	l u n e s
<|CEB|>Mafalda	m a p a l d a
<|CEB|>Mananquil	m a n a ŋ k i l
<|CEB|>Manzano	m a n s a n o
<|CEB|>Marigondon	m a ɾ i ɡ o n d o n
<|CEB|>Marso	m a ɾ s o
<|CEB|>Martinez	m a ɾ t i n e s
<|CEB|>Matugas	m a t u ɡ a s
<|CEB|>Mercader	m e ɾ k a d e ɾ
<|CEB|>Ocampo	ʔ o k a m p o
<|CEB|>Ocaña	ʔ o k a ɲ a
<|CEB|>Padayhag	p a d a j a ɡ
<|CEB|>Paquibato	p a k i b a t o
<|CEB|>Pasipiko	p a s i p i k o
<|CEB|>Perez	p e ɾ e s
<|CEB|>Perla	p e ɾ l a
<|CEB|>Pilapil	p i l a p i l
<|CEB|>Pinadayag	p i n a d a j a ɡ
<|CEB|>Quiñones	k i ɲ o n e s
<|CEB|>Razonable	ɾ a s o n a b l e
<|CEB|>Rodriguez	ɾ o d ɾ i ɡ e s
<|CEB|>Sabado	s a b a d o
<|CEB|>Samar	s a m a ɾ
<|CEB|>Santiago	s a n t i a ɡ o
<|CEB|>Santillan	s a n t i l j a n
<|CEB|>Sinangote	s i n a ŋ ɡ o t e
<|CEB|>Surigao	s u ɾ i ɡ a w
<|CEB|>Tampos	t a m p o s
<|CEB|>Taneo	t a n e o
<|CEB|>Toledohanon	t o l e d o h a n o n
<|CEB|>Tomas	t o m a s
<|CEB|>Toril	t o ɾ i l
<|CEB|>Torres	t o ɾ e s
<|CEB|>Ulalong	ʔ u l a l o ŋ
<|CEB|>Villanueva	b i l j a n u w e b a
<|CEB|>abaga	ʔ a b a ɡ a
<|CEB|>abakadhan	ʔ a b a k a d h a n
<|CEB|>abog	ɐ b u ɡ
<|CEB|>abogado	ʔ a b o ɡ a d o
<|CEB|>abogasiya	ʔ a b o ɡ a s i j a
<|CEB|>abrigo	ʔ a b ɾ i ɡ o
<|CEB|>absolusyon	ʔ a b s o l u s j o n
<|CEB|>administrador	ʔ a d m i n i s t ɾ a d o ɾ
<|CEB|>adunahan	ʔ a d u n a h a n
<|CEB|>agay	a ɡ a ɪ
<|CEB|>agridulse	ʔ a ɡ ɾ i d u l s e
<|CEB|>ahedres	ʔ a h e d ɾ e s
<|CEB|>ahente	ʔ a h e n t e
<|CEB|>akademiya	ʔ a k a d e m i j a
<|CEB|>ako	ʔ a h o
<|CEB|>aksiyon	ʔ a k s i j o n
<|CEB|>aktibidades	ʔ a k t i b i d a d e s
<|CEB|>akusar	ʔ a k u s a ɾ
<|CEB|>akusasyon	ʔ a k u s a s j o n
<|CEB|>alahas	ʔ a l a h a s
<|CEB|>alambre	ʔ a l a m b ɾ e
<|CEB|>alang	ʔ a l a ŋ
<|CEB|>alegasyon	ʔ a l e ɡ a s j o n
<|CEB|>aleluya	ʔ a l e l u j a
<|CEB|>alibangbang	ʔ a l i b a ŋ b a ŋ
<|CEB|>alimpatakan	ʔ a l i m p a t a k a n
<|CEB|>alingagngag	a l i ŋ a ɡ ŋ a ɡ
<|CEB|>almoranas	ʔ a l m o ɾ a n a s
<|CEB|>alpa	ʔ a l p a
<|CEB|>amag	ʔ a m a ɡ
<|CEB|>amaon	ʔ a m a ʔ o n
<|CEB|>amba	a m b a ʔ
<|CEB|>amendar	ʔ a m e n d a ɾ
<|CEB|>amplipikasyon	ʔ a m p l i p i k a s j o n
<|CEB|>anak	ʔ a n a k
<|CEB|>anemya	ʔ a n e m j a
<|CEB|>angso	ʔ a ŋ s o
<|CEB|>anilaw	ʔ a n i l a w
<|CEB|>anino	ʔ a n i n o
<|CEB|>anso	ʔ a n s o
<|CEB|>antigo	ʔ a n t i ɡ o
<|CEB|>antod	ʔ a n t o d
<|CEB|>apostol	ʔ a p o s t o l
<|CEB|>ari	ʔ a ɾ i
<|CEB|>arisgar	ʔ a ɾ i s ɡ a ɾ
<|CEB|>ariyos	ʔ a ɾ i j o s
<|CEB|>arkipelago	ʔ a ɾ k i p e l a ɡ o
<|CEB|>arkitekto	ʔ a ɾ k i t e k t o
<|CEB|>arsobispado	ʔ a ɾ s o b i s p a d o
<|CEB|>asa	ʔ a s a
<|CEB|>asul	ʔ a s u l
<|CEB|>atop	a t ʊ p
<|CEB|>atsoy	ʔ a t s o j
<|CEB|>away	ʔ a w a j
<|CEB|>awto	ʔ a w t o
<|CEB|>awtorisar	ʔ a w t o ɾ i s a ɾ
<|CEB|>ayaay	ʔ a j a ʔ a j
<|CEB|>ayroplano	ʔ a j ɾ o p l a n o
<|CEB|>baboy	b a b o j
<|CEB|>bagol	b a ɡ o l
<|CEB|>bagsak	b a ɡ s a k
<|CEB|>bahag	b a h a ɡ
<|CEB|>baho	b a h o
<|CEB|>bakilid	b a k i l i d
<|CEB|>baklay	b a k l a j
<|CEB|>bako	b a k o ʔ
<|CEB|>bakos	b a k o s
<|CEB|>baktas	b a k t a s
<|CEB|>bakunawa	b a k u n a w a
<|CEB|>balalatok	b a l a l a t o k
<|CEB|>balatian	b a l a t i ʔ a n
<|CEB|>balbakuwa	b a l b a k u w a
<|CEB|>balda	b a l d a
<|CEB|>balibago	b a l i b a ɡ o
<|CEB|>balod	b a l o d
<|CEB|>balon	b a j o n
<|CEB|>balukag	b a l u k a ɡ
<|CEB|>balungbong	b a l̪ u ŋ b o ŋ
<|CEB|>bandido	b a n d i d o
<|CEB|>bangkarote	b a ŋ k a ɾ o t e
<|CEB|>banwa	b a n w a
<|CEB|>banyera	b a n j e ɾ a
<|CEB|>baos	b aː u s
<|CEB|>barag	b a ɾ a ɡ
<|CEB|>baskog	b a s k o ɡ
<|CEB|>bat	b a t
<|CEB|>batayan	b a t a j a n
<|CEB|>bati	b a t i
<|CEB|>batid	b a t i d
<|CEB|>batiis	b a t i ʔ i s
<|CEB|>batong	b a t o ŋ
<|CEB|>batsilyer	b a t s i l j e ɾ
<|CEB|>batuta	b a t u t a ʔ
<|CEB|>batyag	b a t j a ɡ
<|CEB|>bawod	b a w o d
<|CEB|>bawos	b a w o s
<|CEB|>bayad	b a d͡ʒ a d
<|CEB|>bayat	b a j a t
<|CEB|>baybay	b a j b a j
<|CEB|>belib	b e l i b
<|CEB|>berdin	b ɛ r d i n
<|CEB|>bersikulo	b e ɾ s i k u l o
<|CEB|>beterana	b e t e ɾ a n a
<|CEB|>beterano	b e t e ɾ a n o
<|CEB|>bibihan	b i b i h a n̪
<|CEB|>biko	b i k o
<|CEB|>bilat	b i l a t
<|CEB|>bildo	b i l̪ d̪ o
<|CEB|>bilyar	b i l j a ɾ
<|CEB|>binali	b i n̪ a l̪ i
<|CEB|>binatonan	b i n a t o n a n
<|CEB|>binilanggo	b i n i l a ŋ ɡ o ʔ
<|CEB|>birada	b i ɾ a d a
<|CEB|>bitad	b i t a d
<|CEB|>bitay	b i t a j
<|CEB|>bitbit	b i t b i t
<|CEB|>bitoon	b i t uˑ ʔ u n
<|CEB|>biyahe	b i a h e
<|CEB|>bloke	b l o k e
<|CEB|>boda	b o d a
<|CEB|>bodka	b o d k a
<|CEB|>bokabularyo	b o k a b u l a ɾ j o
<|CEB|>bokasyon	b o k a s j o n
<|CEB|>bondying	b o n d j i ŋ
<|CEB|>botas	b o t a s
<|CEB|>botelya	b o t e l j a
<|CEB|>boykot	b o j k o t
<|CEB|>bringhinas	b ɾ i ŋ h i n a s
<|CEB|>buang	b u ʔ a ŋ
<|CEB|>buaya	b u ʔ a j a
<|CEB|>bubo	b u b o
<|CEB|>budaya	b u d a j a
<|CEB|>budhi	b u d h i ʔ
<|CEB|>bugaw	b u ɡ a w
<|CEB|>bugdo	b u ɡ d o
<|CEB|>bughaw	b u ɡ h a w
<|CEB|>bugoy	b u ɡ ɔ ɪ
<|CEB|>buhi	b u h i ʔ
<|CEB|>buklad	b u k l a d
<|CEB|>bukol	b u k o l
<|CEB|>buktot	b u k t o t
<|CEB|>bulakbol	b u l a k b o l
<|CEB|>bulalakaw	b u l a l a k a w
<|CEB|>bulawan	b u a w a n
<|CEB|>bulhog	b u l h o ɡ
<|CEB|>bulinaw	b u l i n a w
<|CEB|>bulkan	b u l k a n
<|CEB|>bulog	b u l o ɡ
<|CEB|>bulto	b u l t o
<|CEB|>bungahoy	b u ŋ a h o j
<|CEB|>bunot	b u n o t
<|CEB|>bunsod	b u n s o d
<|CEB|>buntod	b u n t o d
<|CEB|>buot	b u ʔ o t
<|CEB|>buros	b u ɾ o s
<|CEB|>busay	b u s a j
<|CEB|>calculator	k a l k j u l e i t o ɾ
<|CEB|>chiongbian	t͡ʃ ɔ ŋ b j a n
<|CEB|>daan	d a ʔ a n
<|CEB|>dagami	d a ɡ a m i
<|CEB|>daghan	d a ɡ h a n
<|CEB|>dagit	d a ɡ i t
<|CEB|>dakbayan	d a k b a j a n
<|CEB|>dalunggan	d a l u ŋ ɡ a n
<|CEB|>dampog	d a m p o ɡ
<|CEB|>danggit	d a ŋ ɡ i t
<|CEB|>daog	d a ʔ o ɡ
<|CEB|>dato	d a t o ʔ
<|CEB|>day	d̪ a ɪ
<|CEB|>dayap	d a j a p
<|CEB|>deliryo	d e l i ɾ j o
<|CEB|>detalye	d e t a l j e
<|CEB|>diin	d i ʔ i n
<|CEB|>diriyot	d i ɾ i j o t
<|CEB|>disenteriya	d i s e n t e ɾ i j a
<|CEB|>diyakono	d i a k o n o
<|CEB|>diyot	d i j o t
<|CEB|>dodong	d o d o ŋ
<|CEB|>dughit	d u ɡ h i t
<|CEB|>dugos	d u ɡ o s
<|CEB|>dulaan	d u a ʔ a n
<|CEB|>dulon	d u j o n
<|CEB|>dumog	d u m o ɡ
<|CEB|>dunggab	d u ŋ ɡ a b
<|CEB|>dunggan	d u ŋ ɡ a n
<|CEB|>dunggo	d u ŋ ɡ o ʔ
<|CEB|>dunggoanan	d u ŋ ɡ o ʔ a n a n
<|CEB|>edukasyon	ʔ e d u k a s j o n
<|CEB|>eleksyon	ʔ e l e k s j o n
<|CEB|>elepante	ʔ e l e p a n t e
<|CEB|>empleyado	ʔ e m p l e j a d o
<|CEB|>enad	ɛː n a d
<|CEB|>espiritu	ʔ e s p i ɾ i t u
<|CEB|>estatuwa	ʔ e s t a t u a
<|CEB|>estupido	ʔ e s t u p i d o
<|CEB|>exag	ɪ k s ɑ d ʒ
<|CEB|>foreigner	f ɔ ɾ i n ə ɹ
<|CEB|>gaba	ɡ a b a
<|CEB|>gahom	ɡ a h o m
<|CEB|>gajod	ɡ a d͡ʒ o d
<|CEB|>gama	ɡ a m a ʔ
<|CEB|>gamot	ɡ a m o t
<|CEB|>gana	ɡ a n a
<|CEB|>ganahan	ɡ a n a h a n
<|CEB|>ganansiya	ɡ a n a n s i a
<|CEB|>garing	ɡ a ɾ i ŋ
<|CEB|>gilayon	ɡ i l a j o n
<|CEB|>guba	ɡ u b a ʔ
<|CEB|>gumamela	ɡ u m a m e l a
<|CEB|>gutang	ɡ u t a ŋ
<|CEB|>guwatsi	ɡ u w a t̪ s̪ i
<|CEB|>gwapa	ɡ w a p a
<|CEB|>habagatan	h a b a ɡ a t a n
<|CEB|>habal	h a b a l
<|CEB|>hagnaya	h a ɡ n a j a
<|CEB|>halang	h a l a ŋ
<|CEB|>halingan	h a l i ŋ a n
<|CEB|>hangga	h a ŋ ɡ a ʔ
<|CEB|>harina	h a ɾ i n a
<|CEB|>hasang	h a s a ŋ
<|CEB|>hasler	h a s l e ɾ
<|CEB|>hatag	h a t a ɡ
<|CEB|>hayahay	h a j a h a j
<|CEB|>helikopter	h e l i k o p t e ɾ
<|CEB|>higante	h i ɡ a n t e
<|CEB|>hikot	h i k o t
<|CEB|>hilomon	h i l o m o n
<|CEB|>himantayon	h i m a n t a j o n
<|CEB|>hinagiban	h i n a ɡ i b a n
<|CEB|>hingatulog	h i ŋ a t u l o ɡ
<|CEB|>hinguko	h i ŋ u k o
<|CEB|>hinog	h i n o ɡ
<|CEB|>hipon	h i p o n
<|CEB|>hiring	h i ɾ̪ i ŋ
<|CEB|>hita	h i t a ʔ
<|CEB|>hitsura	h i t s u ɾ a
<|CEB|>hiusa	h i uː s̪ a
<|CEB|>hospital	h o s p i t a l
<|CEB|>hubag	h u b a ɡ
<|CEB|>hubo	h u b o ʔ
<|CEB|>hugas	h u ɡ a s
<|CEB|>hulga	h u l ɡ a ʔ
<|CEB|>huwad	h u a d
<|CEB|>huyang	h u j a ŋ
<|CEB|>ibabaw	ʔ i b a b a w
<|CEB|>ignorante	ʔ i ɡ n o ɾ a n t e
<|CEB|>iho	ʔ i h o
<|CEB|>ikaduha	i k a d u h a
<|CEB|>ikanapulo	i k a n a p u l ʊ ʔ
<|CEB|>ikaunom	i k a u n ʊ m
<|CEB|>ikaupat	i k a u p a t̪
<|CEB|>ikog	ʔ i k o ɡ
<|CEB|>ilok	ʔ i l o k
<|CEB|>imburnal	ʔ i m b u ɾ n a l
<|CEB|>implikasyon	ʔ i m p l i k a s j o n
<|CEB|>importansiya	ʔ i m p o ɾ t a n s i a
<|CEB|>inadlawan	i n̪ a d̪ l̪ a w a n̪
<|CEB|>inahan	ʔ i n a h a n
<|CEB|>inom	ʔ i n o m
<|CEB|>instruksyon	ʔ i n s t ɾ u k s j o n
<|CEB|>inunlan	ʔ i n u n l a n
<|CEB|>inunom	i n u n ʊ m
<|CEB|>ipos	i p o s̪
<|CEB|>isda	ʔ i s d a ʔ
<|CEB|>isi	ʔ i s i
<|CEB|>ispat	i s̪ p a t̪
<|CEB|>itikan	i t̪ i k a n̪
<|CEB|>itlog	ʔ i t l o ɡ
<|CEB|>ito	ʔ i t o ʔ
<|CEB|>iya	ʔ i a
<|CEB|>iyot	ʔ i j o t
<|CEB|>jakol	d͡ʒ a k o l
<|CEB|>jorge	h o r h ɛ
<|CEB|>jud	d͡ʒ u d
<|CEB|>kaaslom	k a ʔ a s l o m
<|CEB|>kabanga	k a b a ŋ a
<|CEB|>kabuang	k a b u ʔ a ŋ
<|CEB|>kadto	k a d t o
<|CEB|>kaduha	k a d̪ u h a
<|CEB|>kagabii	k a ɡ a b i ʔ i
<|CEB|>kagawasan	k a ɡ a w a s a n
<|CEB|>kagwapo	k a ɡ w a p o
<|CEB|>kajo	k a d͡ʒ o
<|CEB|>kakahoyan	k a k a h o j a n
<|CEB|>kalabera	k a l a b e ɾ a
<|CEB|>kalainan	k a l a ʔ i n a n
<|CEB|>kalambre	k a l a m b ɾ e
<|CEB|>kalasag	k a l a s a ɡ
<|CEB|>kalaskas	k a l a s k a s
<|CEB|>kalatkat	k a l̪ a t̪ k a t̪
<|CEB|>kalentura	k a l e n t u ɾ a
<|CEB|>kalinaw	k a l i n a w
<|CEB|>kaliwatan	k a l i w a t a n
<|CEB|>kamalig	k a m a l i ɡ
<|CEB|>kamao	k a m a ʔ o
<|CEB|>kamatis	k a m a t i s
<|CEB|>kamatuoran	k a m a t u ʔ o ɾ a n
<|CEB|>kambras	k a m b ɾ a s
<|CEB|>kamkam	k a m k a m
<|CEB|>kamlas	k a m l a s
<|CEB|>kamot	k a m o t
<|CEB|>kampana	k a m p a n a ʔ
<|CEB|>kanta	k a n t a
<|CEB|>kapait	k a p a i t
<|CEB|>kapay	k a p a j
<|CEB|>kapayas	k a p a j a s
<|CEB|>kapito	k a p i t̪ o
<|CEB|>kapuloan	k a p u l o ʔ a n
<|CEB|>kaputol	k a p u t̪ o l̪
<|CEB|>karaan	k a ɾ a ʔ ɐ n
<|CEB|>karbon	k a ɾ b o n
<|CEB|>karinyo	k a ɾ i n j o
<|CEB|>kasag	k a s a ɡ
<|CEB|>kasiyam	k a s̪ i j ʌ m
<|CEB|>kasundalohan	k a s u n d a l o h a n
<|CEB|>katahom	k a t a h o m
<|CEB|>katarata	k a t a ɾ a t a
<|CEB|>katawa	k a t a w a
<|CEB|>katkat	k a t̪ k a t̪
<|CEB|>katol	k a t o l
<|CEB|>katre	k a t ɾ e
<|CEB|>katulo	k a t̪ ɔ l ʊ
<|CEB|>katunhayan	k a t u n h a j a n
<|CEB|>katuod	k a t u ʔ o d
<|CEB|>kaugalingnan	k a ʔ u ɡ a l i ŋ n a n
<|CEB|>kaunom	k a u n ʊ m
<|CEB|>kaupat	k a ɔ p a t̪
<|CEB|>kausa	k a ɔ s a
<|CEB|>kay	k a j
<|CEB|>kaymito	k a j m i t o
<|CEB|>kayo	k aː y u
<|CEB|>kilat	k i l a t
<|CEB|>kinahanglan	k i n a h a ŋ l a n
<|CEB|>kinaunahan	k i n ʌ u n a h ʌ n
<|CEB|>kinsa	k i n s a ʔ
<|CEB|>kisame	k i s a m e
<|CEB|>kita	k i t a
<|CEB|>kobrador	k o b ɾ a d o ɾ
<|CEB|>kolera	k o l e ɾ a
<|CEB|>kombensyon	k o m b e n s j o n
<|CEB|>kombento	k o m b ɛ n t o
<|CEB|>komedyana	k o m e d j a n a
<|CEB|>komite	k o m i t e
<|CEB|>komportable	k o m p o ɾ t a b l e
<|CEB|>komun	k o m u n
<|CEB|>kondensada	k o n d e n s a d a
<|CEB|>kongreso	k o n ɡ ɾ e s o
<|CEB|>konkreto	k o n k ɾ e t o
<|CEB|>konsagrasyon	k o n s a ɡ ɾ a s j o n
<|CEB|>konsolasyon	k o n s o l a s j o n
<|CEB|>konsorte	k o n s o ɾ t e
<|CEB|>kontento	k o n t e n t o
<|CEB|>kosina	k o s i n a
<|CEB|>kubalan	k u b a l a n
<|CEB|>kubkob	k u b k o b
<|CEB|>kugmo	k u ɡ m o
<|CEB|>kugon	k u ɡ o n
<|CEB|>kukok	k u k o k
<|CEB|>kulago	k u l a ɡ o ʔ
<|CEB|>kuli	k u l i ʔ
<|CEB|>kulkog	k u l k u ɡ
<|CEB|>kulkol	k u l k o l
<|CEB|>kulob	k u l o b
<|CEB|>kulukabildo	k u l̪ u k a b i l̪ d̪ o
<|CEB|>kumalagko	k u m a l a ɡ k o ʔ
<|CEB|>kupo	k u p o ʔ
<|CEB|>kuratsa	k u ɾ a t s a
<|CEB|>kusgan	k u s ɡ a n
<|CEB|>kutsara	k u t s a ɾ a
<|CEB|>kutsaron	k u t s a ɾ o n
<|CEB|>kuwadrilyon	k u w a d ɾ i l j o n
<|CEB|>kuwang	k u w a ŋ
<|CEB|>kuwartahan	k u w a ɾ t a h a n
<|CEB|>kuwenta	k u w e n t a
<|CEB|>kuwintilyon	k u w i n t i l j o n
<|CEB|>kwelyo	k w e l j o
<|CEB|>laag	l a ʔ a ɡ
<|CEB|>laagan	l a ʔ a ɡ a n
<|CEB|>labaha	l a b a h a
<|CEB|>labot	l a b o t
<|CEB|>lagutmon	l a ɡ u t m o n
<|CEB|>lahar	l a h a ɾ
<|CEB|>lakat	l a k a t
<|CEB|>lalaki	l a l a k i
<|CEB|>lamparilya	l a m p a ɾ i l j a
<|CEB|>langaw	l a ŋ a w
<|CEB|>langoyanan	l a ŋ o j a n a n
<|CEB|>lanot	l̪ a n̪ o t̪
<|CEB|>lansa	l a n s a
<|CEB|>lansyaw	l a n s j a w
<|CEB|>lapa	l̪ a p a ʔ
<|CEB|>largabista	l a ɾ ɡ a b i s t a
<|CEB|>lasang	l a s a ŋ
<|CEB|>laslas	l a s l a s
<|CEB|>lawas	l a w a s
<|CEB|>lawin	l a w i n
<|CEB|>libang	l i b a ŋ
<|CEB|>libre	l i b ɾ e
<|CEB|>lider	l i d e ɾ
<|CEB|>ligid	l i ɡ i d
<|CEB|>lihay	l i h a j
<|CEB|>liog	l i ʔ o ɡ
<|CEB|>lisensiyado	l i s e n s i a d o
<|CEB|>liso	l i s o
<|CEB|>listahan	l i s t a h a n
<|CEB|>litrato	l i t ɾ a t o
<|CEB|>lubnganan	l u b ŋ a n a n
<|CEB|>lugaw	l u ɡ a w
<|CEB|>lugos	l u ɡ o s
<|CEB|>luhod	l u h o d
<|CEB|>lukdo	l u k d o
<|CEB|>lunga	l̪ u ŋ a
<|CEB|>lungayngay	l u ŋ a j ŋ a j
<|CEB|>lungib	l u ŋ i b
<|CEB|>lungon	l u ŋ o n
<|CEB|>lungsod	l u ŋ s o d
<|CEB|>lunhaw	l u n h a u
<|CEB|>lupoy	l u p o j
<|CEB|>lusa	l u s a ʔ
<|CEB|>lusay	l u s a j
<|CEB|>luwag	l u a ɡ
<|CEB|>luwas	l u a s
<|CEB|>mabalod	m a b a l o d
<|CEB|>mabangis	m a b a ŋ i s
<|CEB|>madre	m a d ɾ e
<|CEB|>magdudula	m a ɡ d u d u l a ʔ
<|CEB|>magduduwa	m a ɡ d u d u w a ʔ
<|CEB|>maglala	m a ɡ l a l a
<|CEB|>mahatagon	m a h a t a ɡ o n
<|CEB|>mahilom	m a h i l u m
<|CEB|>makaduha	m a k a d u h a
<|CEB|>makalima	m ʌ k a l̪ i m a
<|CEB|>makapito	m ʌ k a p i t̪ o
<|CEB|>makatubol	m a k a t u b o l
<|CEB|>makaunom	m ʌ k a u n ʊ m
<|CEB|>makausa	m ʌ k a u s̪ a
<|CEB|>maldito	m a l d i t o
<|CEB|>malinawon	m a l i n a w o n
<|CEB|>malisyoso	m a l i s j o s o
<|CEB|>maluya	m a l u j a
<|CEB|>man	m a n
<|CEB|>manahon	m a n a h o n
<|CEB|>manambalay	m a n a m b a l a j
<|CEB|>mangahoy	m a ŋ a h o j
<|CEB|>mangga	m a ŋ ɡ a
<|CEB|>mani	m a n i
<|CEB|>manokmanok	m a n o k m a n o k
<|CEB|>mapa	m a p a
<|CEB|>mapahiyomon	m a p a h i j o m o n
<|CEB|>martilyo	m a ɾ t i l j o
<|CEB|>maskara	m a s k a ɾ a
<|CEB|>matahapon	m a t a h a p o n
<|CEB|>matulogtulog	m a t u l o ɡ t u l o ɡ
<|CEB|>matunok	m a t u n o k
<|CEB|>mayor	m ɛ j o ɾ
<|CEB|>merkado	m e ɾ k a d o
<|CEB|>mikropono	m i k ɾ o p o n o
<|CEB|>milo	m i l̪ o ʔ
<|CEB|>miyentras	m i j e n t ɾ a s
<|CEB|>morpema	m o ɾ p e m a
<|CEB|>mulmol	m u l m o l
<|CEB|>nana	n a n a ʔ
<|CEB|>napulo	n a p u l ʊ ʔ
<|CEB|>nasyon	n a s j o n
<|CEB|>negra	n e ɡ ɾ a
<|CEB|>negro	n e ɡ ɾ o
<|CEB|>ngabil	ŋ a b i l
<|CEB|>ngilo	ŋ i l̪ o
<|CEB|>ngislo	ŋ i s l o ʔ
<|CEB|>ngutngot	ŋ u t ŋ o t
<|CEB|>nila	n i l a
<|CEB|>ninyo	n i n d͡ʒ o
<|CEB|>okupado	ʔ o k u p a d o
<|CEB|>otap	o t̪ a p
<|CEB|>otin	ʔ o t i n
<|CEB|>pagkuha	p ʌ ɡ k u h a ʔ
<|CEB|>pagpamolitika	p a ɡ p a m o l i t i k a
<|CEB|>pagpanigarilyo	p a ɡ p a n i ɡ a ɾ i l j o
<|CEB|>pagpuno	p ʌ ɡ p u n ɔ ʔ
<|CEB|>pagtupad	p a ɡ t u p a d
<|CEB|>pahayahay	p a h a j a h a j
<|CEB|>pahiyom	p a h i j o m
<|CEB|>pahumot	p a h u m o t
<|CEB|>painit	p a ʔ i n i t
<|CEB|>palahubog	p a l a h u b o ɡ
<|CEB|>palainom	p a l a ʔ i n o m
<|CEB|>palangga	p a l a ŋ ɡ a ʔ
<|CEB|>palibot	p a l i b o t
<|CEB|>pambata	p a m b a t a
<|CEB|>panagang	p a n a ɡ a ŋ
<|CEB|>pandak	p a n d a k
<|CEB|>pandong	p a n d o ŋ
<|CEB|>pangadye	p a ŋ a d j ɛ
<|CEB|>pangitik	p a ŋ i t̪ i k
<|CEB|>panigarilyo	p a n i ɡ a ɾ i l j o
<|CEB|>pantalon	p a n t a l o n
<|CEB|>paragrap	p a ɾ a ɡ ɾ a p
<|CEB|>paraiso	p a ɾ a j s o
<|CEB|>parapente	p a ɾ a p e n t e
<|CEB|>parapo	p a ɾ a p o
<|CEB|>paras	p a ɾ a s
<|CEB|>pareho	p a ɾ e h o
<|CEB|>paryente	p a ɾ j e n t e
<|CEB|>pasilidad	p a s i l i d a d
<|CEB|>pasipista	p a s i p i s t a
<|CEB|>pastor	p a s t o ɾ
<|CEB|>patay	p a t a j
<|CEB|>patilya	p a t i l j a
<|CEB|>pato	p a t o
<|CEB|>pawikan	p a w i k a n
<|CEB|>payag	p a j a ɡ
<|CEB|>payod	p a j o d
<|CEB|>payong	p a j o ŋ
<|CEB|>pilak	p i l a k
<|CEB|>pilipog	p i l i p o ɡ
<|CEB|>pinito	p i n ɪ t ʊ
<|CEB|>pinyahan	p i ɲ a h a n
<|CEB|>pirma	p i ɾ m a
<|CEB|>piso	p i s o
<|CEB|>piyer	p i j e ɾ
<|CEB|>planta	p l a n t a
<|CEB|>poste	p o s t e
<|CEB|>prediksyon	p ɾ e d i k s i j o n
<|CEB|>preparado	p ɾ e p a ɾ a d o
<|CEB|>presensya	p ɾ e s e n s j a
<|CEB|>pribilehiyo	p ɾ i b i l e h i j o
<|CEB|>prisohan	p ɾ i s o h a n
<|CEB|>probinsiya	p ɾ o b i n s j a
<|CEB|>prutas	p ɾ u t a s
<|CEB|>puasa	p u ʔ a s a
<|CEB|>pudlos	p u d l o s
<|CEB|>puhunan	p u h u n a n
<|CEB|>puklo	p u k l o ʔ
<|CEB|>pukot	p u k o t
<|CEB|>pulkas	p u l k a s
<|CEB|>punerarya	p u n e ɾ a ɾ j a
<|CEB|>pungko	p u ŋ k o ʔ
<|CEB|>pungkopungko	p u ŋ k o p u ŋ k o ʔ
<|CEB|>puso	p u s o
<|CEB|>putli	p u t l i ʔ
<|CEB|>puto	p u t o
<|CEB|>puwede	p u w e d e
<|CEB|>ransiyo	ɾ a n s i j o
<|CEB|>regalo	ɾ e ɡ a l o
<|CEB|>relasyon	ɾ e l a s j o n
<|CEB|>reorganisar	ɾ e ʔ o ɾ ɡ a n i s a ɾ
<|CEB|>reporma	ɾ e p o ɾ m a
<|CEB|>rosquillos	ɾ̪ o s̪ k i l̪ j o s̪
<|CEB|>ruler	ɾ u l e ɾ
<|CEB|>sabsab	s a b s a b
<|CEB|>sabwag	s a b w a ɡ
<|CEB|>sagang	s a ɡ a ŋ
<|CEB|>sagbot	s̪ a ɡ b o t̪
<|CEB|>saka	s a k a
<|CEB|>sakate	s a k a t e
<|CEB|>saksi	s a k s i
<|CEB|>salabay	s a l a b a j
<|CEB|>salabotan	s a l a b o t a n
<|CEB|>salida	s a l i d a
<|CEB|>salikwaot	s a l i k w a ʔ o t
<|CEB|>salom	s a l o m
<|CEB|>saluwal	s a l u w a l
<|CEB|>samar	s aˑ m ɐ ɾ
<|CEB|>sambag	s ɐ m b ɐ ɡ
<|CEB|>sandiya	s a n d i j a
<|CEB|>sanga	s a ŋ a
<|CEB|>sangay	s a ŋ a ɪ
<|CEB|>sano	s a n o
<|CEB|>santilmo	s a n t i l m o
<|CEB|>saong	s a ʔ o ŋ
<|CEB|>sapal	s a p a l
<|CEB|>sapi	s a p ɪ ʔ
<|CEB|>sayal	s a j a l
<|CEB|>sayop	s a j o p
<|CEB|>sedula	s e d u l a
<|CEB|>seguro	s e ɡ u ɾ o
<|CEB|>seksyon	s e k s j o n
<|CEB|>semilya	s e m i l j a
<|CEB|>senado	s e n a d o
<|CEB|>sensiyo	s e n s i j o
<|CEB|>sentido	s e n t i d o
<|CEB|>serbesa	s e ɾ b e s a
<|CEB|>setenta	s e t e n t a
<|CEB|>sigay	s̪ i ɡ a ɪ
<|CEB|>sige	s i ɡ e
<|CEB|>sijam	s i d͡ʒ a m
<|CEB|>sikaduha	s̪ i k a d̪ u h a
<|CEB|>sikatulo	s̪ i k a t̪ u l o
<|CEB|>siko	s i k o
<|CEB|>simbako	s i m b a k o
<|CEB|>sindikato	s i n d i k a t o
<|CEB|>sinehan	s i n e h a n
<|CEB|>singot	s i ŋ o t
<|CEB|>sipat	s̪ i p a t̪
<|CEB|>sirado	s i ɾ a d o
<|CEB|>siya	s i a
<|CEB|>siyudad	s i j u d a d
<|CEB|>sosyalismo	s o s j a l i s m o
<|CEB|>suba	s u b a ʔ
<|CEB|>sugal	s u ɡ a l
<|CEB|>sukli	s u k l i ʔ
<|CEB|>suko	s u k ɔ
<|CEB|>sula	s u l a
<|CEB|>sulay	s u l a j
<|CEB|>sulod	s u d
<|CEB|>susmarisep	s u s m a ɾ i s e p
<|CEB|>sutukil	s u t u k i l
<|CEB|>suway	s u a j
<|CEB|>suwerte	s u w e ɾ t e
<|CEB|>suya	s u j a ʔ
<|CEB|>taas	t̪ a ʔ a s̪
<|CEB|>tabilikod	t a b i l i k o d
<|CEB|>tagaw	t a ɡ a w
<|CEB|>tagay	t a ɡ a j
<|CEB|>tagiptip	t̪ a ɡ i p t̪ i p
<|CEB|>tagohipos	t a ɡ o h i p o s
<|CEB|>tahod	t̪ a h o d̪
<|CEB|>taklob	t a k l o b
<|CEB|>takos	t a k o s
<|CEB|>takwal	t a k w a l
<|CEB|>talaba	t a l a b a
<|CEB|>talaw	t a l a w
<|CEB|>talawan	t a l a w a n
<|CEB|>tali	t a l i
<|CEB|>talibong	t a l i b o ŋ
<|CEB|>taludtod	t a l u d t o d
<|CEB|>tambalanan	t a m b a l a n a n
<|CEB|>tambaloslos	t a m b a l o s l o s
<|CEB|>taming	t a m i ŋ
<|CEB|>tangis	t a ŋ i s
<|CEB|>tangkugo	t a ŋ k u ɡ o ʔ
<|CEB|>tanglad	t a ŋ l a d
<|CEB|>taop	t̪ a ɔ p
<|CEB|>tapis	t̪ a p i s̪
<|CEB|>tapol	t a p o l
<|CEB|>tapos	t a p o s
<|CEB|>tasa	t a s a
<|CEB|>tata	t a t a
<|CEB|>taudtaod	t a ʔ u d t a ʔ o d
<|CEB|>tawa	t a w a
<|CEB|>tawag	t a w a ɡ
<|CEB|>tawong	t a w o ŋ
<|CEB|>telepono	t e l e p o n o
<|CEB|>templado	t e m p l a d o
<|CEB|>tigbahin	t̪ i ɡ b a h i n̪
<|CEB|>tigdugang	t̪ i ɡ d̪ u ɡ a ŋ
<|CEB|>tigdumala	t i ɡ d u m a l a
<|CEB|>tigidig	t i ɡ i d i ɡ
<|CEB|>tigkuha	t̪ i ɡ k u h a ʔ
<|CEB|>tigpuno	t̪ i ɡ p u n o ʔ
<|CEB|>tiket	t i k e t
<|CEB|>tiklo	t i k l o ʔ
<|CEB|>tilaok	t i l a ʔ o k
<|CEB|>tindera	t i n d e ɾ a
<|CEB|>tindog	t i n d o ɡ
<|CEB|>tingali	t i ŋ a l i
<|CEB|>tingkoy	t i ŋ k o j
<|CEB|>tingob	t̪ i ŋ o b
<|CEB|>tipas	t̪ i p a s̪
<|CEB|>tiya	t i j a
<|CEB|>tiyo	t i j o
<|CEB|>tokaya	t o k a j a
<|CEB|>tokhang	t o k h a ŋ
<|CEB|>toma	t o m a ʔ
<|CEB|>trangkaso	t ɾ a ŋ k a s o
<|CEB|>trapik	t ɾ a p i k
<|CEB|>traynta	t ɾ a j n t a
<|CEB|>tsapa	t͡ʃ a p a
<|CEB|>tsinelas	t s i n e l a s
<|CEB|>tsismosa	t s i s m o s a
<|CEB|>tuberkulosis	t u b e ɾ k u l o s i s
<|CEB|>tubo	t u b o
<|CEB|>tudtod	t u d t o d
<|CEB|>tugas	t u ɡ a s
<|CEB|>tuig	t u ʔ i ɡ
<|CEB|>tukoy	t u k o j
<|CEB|>tulak	t u l a k
<|CEB|>tuli	t u l i ʔ
<|CEB|>tulo	t u l o
<|CEB|>tunok	t u n o k
<|CEB|>tuohon	t u ʔ o h o n
<|CEB|>turko	t u ɾ k u
<|CEB|>tuwerka	t u w e ɾ k a
<|CEB|>udong	ʔ u d o ŋ
<|CEB|>udto	ʔ u d t o
<|CEB|>ugat	ʔ u ɡ a t
<|CEB|>ugay	u ɡ a ɪ
<|CEB|>ugdo	ʔ u ɡ d o
<|CEB|>ugis	ʔ u ɡ i s
<|CEB|>ugkay	ʔ u ɡ k a j
<|CEB|>ugma	ʔ u ɡ m a ʔ
<|CEB|>uki	ʔ u k i
<|CEB|>unahan	u n a h ʌ n
<|CEB|>unauna	u n a u n a
<|CEB|>unom	ʔ u n o m
<|CEB|>utang	ʔ u t a ŋ
<|CEB|>utangan	ʔ u t a ŋ a n
<|CEB|>utong	ʔ u t o ŋ
<|CEB|>uwak	ʔ u a k
<|CEB|>uyon	ʔ u j o n
<|CEB|>wagas	w a ɡ a s
<|CEB|>wail	w a i l̪
<|CEB|>winalo	w i n a l ʊ
<|CEB|>yads	j a d ʒ
<|CEB|>yamis	j a m i s
<|CEB|>yaya	j a j a
<|TGL|>bayawak	b a j a w a k
<|TGL|>luminis	l u m i n i s
<|TGL|>Kuwaresma	k u a ɾ e s m a
<|TGL|>mahinhin	m a h i n h i n
<|TGL|>lamasin	l a m a s i n
<|TGL|>kolehiyal	k o l e h i a l
<|TGL|>samo	s a m o ʔ
<|TGL|>bibliyoteka	b i b l i o t e k a
<|TGL|>z	z i
<|TGL|>Clemente	k l e m e n t e
<|TGL|>entero	ʔ e n t e ɾ o
<|TGL|>rehente	ɾ e h e n t e
<|TGL|>balimbing	b a l i m b i ŋ
<|TGL|>matitibay	m a t i t i b a j
<|TGL|>giwa	ɡ i w a ʔ
<|TGL|>sumunod	s u m u n o d
<|TGL|>misis	m i s i s
<|TGL|>bungaw	b u ŋ a w
<|TGL|>halumigmig	h a l u m i ɡ m i ɡ
<|TGL|>makuha	m a k u h a
<|TGL|>tako	t a k o
<|TGL|>hirol	h i ɾ o l
<|TGL|>Indotsina	ʔ i n d o t͡ʃ i n a
<|TGL|>alisangsang	ʔ a l i s a ŋ s a ŋ
<|TGL|>Libjo	l i b h o ʔ
<|TGL|>sidlan	s i d l a n
<|TGL|>batubalani	b a t u b a l a n i ʔ
<|TGL|>abyugin	ʔ a b j u ɡ i n
<|TGL|>kandidatura	k a n d i d a t u ɾ a
<|TGL|>entremetido	ʔ e n t ɾ e m e t i d o
<|TGL|>dinagipik	d i n a ɡ i p i k
<|TGL|>hukuman	h u k u m a n
<|TGL|>manlait	m a n l a ʔ i t
<|TGL|>singaw	s i ŋ a w
<|TGL|>Closa	k l o s a
<|TGL|>kumpensasyon	k u m p e n s a s j o n
<|TGL|>Layco	l a j k o
<|TGL|>Aliga	ʔ a l i ɡ a
<|TGL|>taglamig	t a ɡ l a m i ɡ
<|TGL|>arkitektura	ʔ a ɾ k i t e k t u ɾ a
<|TGL|>sawil	s a w i l
<|TGL|>pasma	p a s m a
<|TGL|>peryodista	p e ɾ j o d i s t a
<|TGL|>bini	b i n i ʔ
<|TGL|>humiram	h u m i ɾ a m
<|TGL|>Asistio	ʔ a s i s t j o
<|TGL|>yumanig	j u m a n i ɡ
<|TGL|>Barbie	b a ɾ b i
<|TGL|>timayok	t i m a j o k
<|TGL|>Pansol	p a n s o l
<|TGL|>Tagaytay	t a ɡ a j t a j
<|TGL|>Ruedas	ɾ u e d a s
<|TGL|>magbasanlot	m a ɡ b a s a n l o t
<|TGL|>ipatapon	ʔ i p a t a p o n
<|TGL|>polaynas	p o l a j n a s
<|TGL|>Maloles	m a l o l e s
<|TGL|>isakay	ʔ i s a k a j
<|TGL|>Pinagkaisahan	p i n a ɡ k a ʔ i s a h a n
<|TGL|>kutsukutso	k u ˌt͡ʃ u k u t͡ʃ o
<|TGL|>halimbawa	h a l i m b a w a ʔ
<|TGL|>mamilis	m a m i l i s
<|TGL|>muhala	m u h a l a ʔ
<|TGL|>mamaya	m a m a j a ʔ
<|TGL|>taludtod	t a l u d t o d
<|TGL|>lalawigan	l a l a w i ɡ a n
<|TGL|>maghati	m a ɡ h a t i ʔ
<|TGL|>suhol	s u h o l
<|TGL|>ragsak	ɾ a ɡ s a k
<|TGL|>radyo	ɾ a d j o
<|TGL|>mabalasik	m a b a l a s i k
<|TGL|>talang	t a l a ŋ
<|TGL|>budhi	b u d h i ʔ
<|TGL|>umusbong	ʔ u m u s b o ŋ
<|TGL|>alahero	ʔ a l a h e ɾ o
<|TGL|>kaalit	k a ʔ a l i t
<|TGL|>maabo	m a ʔ a b o
<|TGL|>dengge	d e ŋ ɡ e
<|TGL|>karelyebo	k a ɾ e l j e b o
<|TGL|>sabi	s a b i
<|TGL|>tarang	t a ɾ a ŋ
<|TGL|>Soledad	s o l e d a d
<|TGL|>marites	m a ɾ i t e s
<|TGL|>heneral	h e n e ɾ a l
<|TGL|>Kankanaey	k a n k a n a ʔ e j
<|TGL|>Cueto	k u e t o
<|TGL|>yakyak	j a k j a k
<|TGL|>lahi	l a h i ʔ
<|TGL|>daungan	ˌd a ʔ u ŋ a n
<|TGL|>magkaaway	m a ɡ k a ʔ a w a j
<|TGL|>adres	ʔ a d ɾ e s
<|TGL|>traidor	t ɾ a j d o ɾ
<|TGL|>ayon	ʔ a j o n
<|TGL|>iskul	ʔ i s k u l
<|TGL|>talibas	t a l i b a s
<|TGL|>Marulas	m a ɾ u l a s
<|TGL|>deliryo	d e l i ɾ j o
<|TGL|>pagkasuplado	p a ɡ k a s u p l a d o
<|TGL|>pribilehiyo	p ɾ i b i l e h i o
<|TGL|>rotonda	ɾ o t o n d a
<|TGL|>'di	d i ʔ
<|TGL|>kita	k i t a
<|TGL|>pampanitikan	p a m p a n i t i k a n
<|TGL|>Nadine	n a d i n
<|TGL|>talunton	t a l u n t o n
<|TGL|>hapit	h a p i t
<|TGL|>Soliven	s o l i v e n
<|TGL|>magbababoy	m a ɡ b a b a b o j
<|TGL|>bayad	b a j a d
<|TGL|>gumimik	ɡ u m i m i k
<|TGL|>aksiyon	ʔ a k s i o n
<|TGL|>tindalo	t i n d a l o ʔ
<|TGL|>kaanib	k a ʔ a n i b
<|TGL|>balandra	b a l a n d ɾ a
<|TGL|>ekselensiya	ʔ e k s e l e n s j a
<|TGL|>telepatiya	t e l e p a t i a
<|TGL|>tuma	t u m a
<|TGL|>bertebrado	b e ɾ t e b ɾ a d o
<|TGL|>pasukan	p a s u k a n
<|TGL|>Pagaspas	p a ɡ a s p a s
<|TGL|>Tarnate	t a ɾ n a t e
<|TGL|>komplikasyon	k o m p l i k a s j o n
<|TGL|>ahon	ʔ a h o n
<|TGL|>elye	ʔ e l j e
<|TGL|>tatagukan	t a t a ɡ u k a n
<|TGL|>dagsa	d a ɡ s a ʔ
<|TGL|>Montecillo	m o n t e s i l j o
<|TGL|>personal	p e ɾ s o n a l
<|TGL|>banyas	b a n j a s
<|TGL|>'ka	k a ʔ
<|TGL|>istorbo	ʔ i s t o ɾ b o
<|TGL|>lugo	l u ɡ o
<|TGL|>bira	b i ɾ a
<|TGL|>Manaois	m a n a w i s
<|TGL|>sikologo	s i k o l o ɡ o
<|TGL|>katre	k a t ɾ e
<|TGL|>Ticzon	t i k s o n
<|TGL|>anislag	ʔ a n i s l a ɡ
<|TGL|>tiyahin	t i a h i n
<|TGL|>oso	ʔ o s o
<|TGL|>Pederio	p e d e ɾ j o
<|TGL|>gamutin	ɡ a m u t i n
<|TGL|>Villamayor	v i l j a m a j o ɾ
<|TGL|>inaabisuhan	ʔ i n a ʔ a b i s u h a n
<|TGL|>Lucero	l u s e ɾ o
<|TGL|>pagnanakaw	p a ɡ n a n a k a w
<|TGL|>kubil	k u b i l
<|TGL|>sangkatauhan	s a ŋ k a t a ʔ u h a n
<|TGL|>Dimailig	d i m a ʔ i l i ɡ
<|TGL|>kubtangkas	k u b t a ŋ k a s
<|TGL|>karbungkulo	k a ɾ b u ŋ k u l o
<|TGL|>empirisismo	ˌʔ e m p i ɾ i s i s m o
<|TGL|>puwente	p u e n t e
<|TGL|>ani	ʔ a n i
<|TGL|>iglesya	ʔ i ɡ l e s j a
<|TGL|>palaman	p a l a m a n
<|TGL|>Pekto	p e k t o
<|TGL|>bakawan	b a k a w a n
<|TGL|>husto	h u s t o
<|TGL|>peste	p e s t e
<|TGL|>gagad	ɡ a ɡ a d
<|TGL|>marungis	m a ɾ u ŋ i s
<|TGL|>sinigwelas	s i n i ɡ w e l a s
<|TGL|>salalay	s a l a l a j
<|TGL|>ikalawa	ʔ i k a l a w a
<|TGL|>Tupas	t u p a s
<|TGL|>Peñaflor	p e ɲ a f l o ɾ
<|TGL|>kidsulid	k i d s u l i d
<|TGL|>maarte	m a ʔ a ɾ t e
<|TGL|>Kiamzon	k i a m s o n
<|TGL|>puna	p u n a
<|TGL|>Eloriaga	ʔ e l o ɾ j a ɡ a
<|TGL|>tumawag	t u m a w a ɡ
<|TGL|>relohero	ɾ e l o h e ɾ o
<|TGL|>humatsing	h u m a t͡ʃ i ŋ
<|TGL|>alog	ʔ a l o ɡ
<|TGL|>tsok	t͡ʃ o k
<|TGL|>Bolivar	b o l i v a ɾ
<|TGL|>taklab	t a k l a b
<|TGL|>alimuran	ʔ a l i m u ɾ a n
<|TGL|>tuyo	t u j o ʔ
<|TGL|>wangis	w a ŋ i s
<|TGL|>haka	h a k a ʔ
<|TGL|>ligis	l i ɡ i s
<|TGL|>mantala	m a n t a l a
<|TGL|>okasyon	ʔ o k a s j o n
<|TGL|>Cayabyab	k a j a b j a b
<|TGL|>pulseras	p u l s e ɾ a s
<|TGL|>bisaklat	b i s a k l a t
<|TGL|>Ty	t i
<|TGL|>masiba	m a s i b a ʔ
<|TGL|>nakayukyok	n a k a j u k j o k
<|TGL|>abiso	ʔ a b i s o
<|TGL|>samakatwid	s a m a k a t w i d
<|TGL|>asnan	ʔ a s n a n
<|TGL|>magyaya	m a ɡ j a j a ʔ
<|TGL|>sabak	s a b a k
<|TGL|>Haw	h a w
<|TGL|>krimen	k ɾ i m e n
<|TGL|>lapastanganin	l a p a s t a ŋ a n i n
<|TGL|>talukab	t a l u k a b
<|TGL|>bulalayak	ˌb u l a l a j a k
<|TGL|>yumurak	j u m u ɾ a k
<|TGL|>panggang	p a ŋ ɡ a ŋ
<|TGL|>gilid	ɡ i l i d
<|TGL|>burara	b u ɾ a ɾ a ʔ
<|TGL|>Sobrepeña	s o b ɾ e p e ɲ a
<|TGL|>arok	ʔ a ɾ o k
<|TGL|>bakuran	b a k u ɾ a n
<|TGL|>dayan	d a j a n
<|TGL|>sentimo	ˌs e n t i m o
<|TGL|>samaral	s a m a ɾ a l
<|TGL|>saksakin	s a k s a k i n
<|TGL|>X	ʔ e k s
<|TGL|>linatsay	l i n a t͡ʃ a j
<|TGL|>tate	t a t e ʔ
<|TGL|>pagkabigo	p a ɡ k a b i ɡ o ʔ
<|TGL|>historikal	h i s t o ɾ i k a l
<|TGL|>Kurisma	k u ɾ i s m a
<|TGL|>sinaing	s i n a ʔ i ŋ
<|TGL|>agwahas	ʔ a ɡ w a h a s
<|TGL|>entusyasmo	ʔ e n t u s j a s m o
<|TGL|>obligasyon	ʔ o b l i ɡ a s j o n
<|TGL|>nanamantala	n a n a m a n t a l a
<|TGL|>hangad	h a ŋ a d
<|TGL|>Montenegro	m o n t e n e ɡ ɾ o
<|TGL|>mangaliwa	m a ŋ a l i w a ʔ
<|TGL|>protina	p ɾ o t i n a
<|TGL|>giba	ɡ i b a ʔ
<|TGL|>persigido	p e ɾ s i ɡ i d o
<|TGL|>maanggo	m a ʔ a ŋ ɡ o
<|TGL|>Nagtalon	n a ɡ t a l o n
<|TGL|>Clarence	k l a ɾ e n s
<|TGL|>tugya	t u ɡ j a ʔ
<|TGL|>ebakwasyon	ʔ e b a k w a s j o n
<|TGL|>tipaklong	t i p a k l o ŋ
<|TGL|>limahi	l i m a h i ʔ
<|TGL|>paboritismo	p a b o ɾ i t i s m o
<|TGL|>termos	t e ɾ m o s
<|TGL|>Nagcarlan	n a ɡ k a ɾ l a n
<|TGL|>kalyos	k a l j o s
<|TGL|>kuwa	k u a ʔ
<|TGL|>yaon	j a ʔ o n
<|TGL|>alangan	ʔ a l a ŋ a n
<|TGL|>letmaku	l e t m a k u
<|TGL|>kulugo	k u l u ɡ o
<|TGL|>Fariñas	f a ɾ i ɲ a s
<|TGL|>heko	h e k o
<|TGL|>Majayjay	m a h a j h a j
<|TGL|>arsilya	ʔ a ɾ s i l j a
<|TGL|>rito	ɾ i t o
<|TGL|>par	p a ɾ
<|TGL|>Bascoguin	b a s k o ɡ i n
<|TGL|>bulilyaso	b u l i l j a s o
<|TGL|>datiles	ˌd a t i l e s
<|TGL|>isangkot	ʔ i s a ŋ k o t
<|TGL|>pastilyas	p a s t i l j a s
<|TGL|>gumising	ɡ u m i s i ŋ
<|TGL|>sakal	s a k a l
<|TGL|>pulburon	p u l b u ɾ o n
<|TGL|>kadugo	k a d u ɡ o ʔ
<|TGL|>Nelson	n e l s o n
<|TGL|>Chiyoko	t͡ʃ i o k o
<|TGL|>hupa	h u p a ʔ
<|TGL|>Anor	ʔ a n o ɾ
<|TGL|>tigmata	t i ɡ m a t a
<|TGL|>ipakita	ʔ i p a k i t a
<|TGL|>dating	d a t i ŋ
<|TGL|>kasulatan	k a s u l a t a n
<|TGL|>Vecino	v e s i n o
<|TGL|>libid	l i b i d
<|TGL|>manlibak	m a n l i b a k
<|TGL|>kosta	k o s t a
<|TGL|>labintador	l a b i n t a d o ɾ
<|TGL|>kasera	k a s e ɾ a
<|TGL|>arsobispo	ʔ a ɾ s o b i s p o
<|TGL|>hayop	h a j o p
<|TGL|>magpaskil	m a ɡ p a s k i l
<|TGL|>sota	s o t a
<|TGL|>tokaya	t o k a j a
<|TGL|>echosera	ʔ e t͡ʃ o s e ɾ a
<|TGL|>propesora	p ɾ o p e s o ɾ a
<|TGL|>umiintindi	ʔ u m i ʔ i n t i n d i
<|TGL|>payamanin	p a j a m a n i n
<|TGL|>irekomenda	ʔ i ɾ e k o m e n d a
<|TGL|>koral	k o ɾ a l
<|TGL|>singki	s i ŋ k i ʔ
<|TGL|>timos	t i m o s
<|TGL|>amot	ʔ a m o t
<|TGL|>ugaga	ʔ u ɡ a ɡ a ʔ
<|TGL|>akbay	ʔ a k b a j
<|TGL|>panananim	p a n a n a n i m
<|TGL|>pakpak	p a k p a k
<|TGL|>Libra	l i b ɾ a
<|TGL|>kasalukuyan	k a s a l u k u j a n
<|TGL|>imperatibo	ʔ i m p e ɾ a t i b o
<|TGL|>asawa	ʔ a s a w a
<|TGL|>iha	ʔ i h a
<|TGL|>maawain	m a ʔ a w a ʔ i n
<|TGL|>kepo	k e p o
<|TGL|>magulat	m a ɡ u l a t
<|TGL|>senador	s e n a d o ɾ
<|TGL|>tipuno	t i p u n o ʔ
<|TGL|>hibang	h i b a ŋ
<|TGL|>soltada	s o l t a d a
<|TGL|>detalye	d e t a l j e
<|TGL|>lityo	l i t j o
<|TGL|>elektrisista	ʔ e l e k t ɾ i s i s t a
<|TGL|>balda	b a l d a
<|TGL|>palaso	p a l a s o ʔ
<|TGL|>lansang	l a n s a ŋ
<|TGL|>balse	b a l s e
<|TGL|>salik	s a l i k
<|TGL|>Triviño	t ɾ i v i ɲ o
<|TGL|>kalima	k a l i m a
<|TGL|>binhi	b i n h i ʔ
<|TGL|>tilasitha	t i l a s i t h a ʔ
<|TGL|>gawan	ɡ a w a n
<|TGL|>matiyaga	m a t j a ɡ a ʔ
<|TGL|>biskonde	b i s k o n d e
<|TGL|>ikalat	ʔ i k a l a t
<|TGL|>tabak	t a b a k
<|TGL|>usod	ʔ u s o d
<|TGL|>sanaysay	s a n a j s a j
<|TGL|>numipis	n u m i p i s
<|TGL|>salmo	s a l m o
<|TGL|>keri	k e ɾ i
<|TGL|>yumahod	j u m a h o d
<|TGL|>peyneta	p e j n e t a
<|TGL|>bumatak	b u m a t a k
<|TGL|>matimbang	m a t i m b a ŋ
<|TGL|>ambisyon	ʔ a m b i s j o n
<|TGL|>seleksiyon	s e l e k s i o n
<|TGL|>purgatoryo	p u ɾ ɡ a t o ɾ j o
<|TGL|>Marinduque	m a ɾ i n d u k e
<|TGL|>amaranto	ʔ a m a ɾ a n t o
<|TGL|>paligsa	p a l i ɡ s a
<|TGL|>initsupil	ˌʔ i n i t s u p i l
<|TGL|>hatiin	h a t i ʔ i n
<|TGL|>hati	h a t i ʔ
<|TGL|>Remulla	ɾ e m u l j a
<|TGL|>Islam	ʔ i s l a m
<|TGL|>sibsib	s i b s i b
<|TGL|>saysay	s a j s a j
<|TGL|>madamo	m a d a m o
<|TGL|>obaryo	ʔ o b a ɾ j o
<|TGL|>tsitsaron	t͡ʃ i t͡ʃ a ɾ o n
<|TGL|>alkatsopas	ʔ a l k a t͡ʃ o p a s
<|TGL|>maningil	m a n i ŋ i l
<|TGL|>kumbinsido	k u m b i n s i d o
<|TGL|>pangkagawaran	p a ŋ k a ɡ a w a ɾ a n
<|TGL|>gahasa	ɡ a h a s a ʔ
<|TGL|>nabubuwisit	n a b u b u i s i t
<|TGL|>mabibigat	m a b i b i ɡ a t
<|TGL|>yangyang	j a ŋ j a ŋ
<|TGL|>kalangay	k a l a ŋ a j
<|TGL|>Abelgas	ʔ a b e l ɡ a s
<|TGL|>ipagmayabang	ʔ i p a ɡ m a j a b a ŋ
<|TGL|>Pinas	p i n a s
<|TGL|>limusina	l i m u s i n a
<|TGL|>peg	p e ɡ
<|TGL|>sais	s a ʔ i s
<|TGL|>riyesgo	ɾ i e s ɡ o
<|TGL|>laro	l a ɾ o ʔ
<|TGL|>sagwan	s a ɡ w a n
<|TGL|>Barayuga	b a ɾ a j u ɡ a
<|TGL|>Kho	k o
<|TGL|>hardin	h a ɾ d i n
<|TGL|>batia	b a t i a ʔ
<|TGL|>maghalili	m a ɡ h a l i l i
<|TGL|>gobernador	ɡ o b e ɾ n a d o ɾ
<|TGL|>lupig	l u p i ɡ
<|TGL|>birtud	b i ɾ t u d
<|TGL|>tulad	t u l a d
<|TGL|>manahimik	m a n a h i m i k
<|TGL|>sinigurado	s i n i ɡ u ɾ a d o
<|TGL|>bahagi	b a h a ɡ i ʔ
<|TGL|>yano	j a n o
<|TGL|>tambuli	t a m b u l i ʔ
<|TGL|>lingkod	l i ŋ k o d
<|TGL|>tahure	t a h u ɾ e
<|TGL|>kondo	k o n d o
<|TGL|>Valmores	v a l m o ɾ e s
<|TGL|>ginto	ɡ i n t o ʔ
<|TGL|>haligutgot	h a l i ɡ u t ɡ o t
<|TGL|>estandarte	ʔ e s t a n d a ɾ t e
<|TGL|>dagasdas	d a ɡ a s d a s
<|TGL|>Jasmine	d͡ʒ a s m i n
<|TGL|>kadiri	k a d i ɾ i
<|TGL|>miklawas	m i k l a w a s
<|TGL|>bisikleta	b i s i k l e t a
<|TGL|>kategorikal	k a t e ɡ o ɾ i k a l
<|TGL|>diskuwento	d i s k u e n t o
<|TGL|>sutla	s u t l a ʔ
<|TGL|>maako	m a ʔ a k o
<|TGL|>atim	ʔ a t i m
<|TGL|>dukwangin	d u k w a ŋ i n
<|TGL|>panlikod	p a n l i k o d
<|TGL|>asam	ʔ a s a m
<|TGL|>halihaw	h a l i h a w
<|TGL|>Moymoy	m o j m o j
<|TGL|>kumporme	k u m p o ɾ m e
<|TGL|>dalubhayupan	d a ˌl u b h a j u p a n
<|TGL|>wiski	w i s k i
<|TGL|>tumangkad	t u m a ŋ k a d
<|TGL|>radikal	ɾ a d i k a l
<|TGL|>mahistrado	m a h i s t ɾ a d o
<|TGL|>Biyer.	b i e ɾ
<|TGL|>malapot	m a l a p o t
<|TGL|>asno	ʔ a s n o
<|TGL|>repleksiyon	ɾ e p l e k s i o n
<|TGL|>dagusdos	d a ɡ u s d o s
<|TGL|>salwak	s a l w a k
<|TGL|>kabisera	k a b i s e ɾ a
<|TGL|>paninindigan	p a n i n i n d i ɡ a n
<|TGL|>sinehan	s i n e h a n
<|TGL|>Lumad	l u m a d
<|TGL|>bagol	b a ɡ o l
<|TGL|>kwenta	k w e n t a
<|TGL|>be	b e
<|TGL|>hagkan	h a ɡ k a n
<|TGL|>maimbot	m a ʔ i m b o t
<|TGL|>manukan	m a n u k a n
<|TGL|>Kamaynilaan	k a m a j n i l a ʔ a n
<|TGL|>Natanauan	n a t a n a w a n
<|TGL|>kubo	k u b o
<|TGL|>Sabado	s a b a d o
<|TGL|>konyak	k o n j a k
<|TGL|>reportahe	ɾ e p o ɾ t a h e
<|TGL|>Soon	s u n
<|TGL|>pusakal	p u s a k a l
<|TGL|>ukab	ʔ u k a b
<|TGL|>Inocencio	ʔ i n o s e n s j o
<|TGL|>bitak	b i t a k
<|TGL|>kauntian	k a ʔ u n t i ʔ a n
<|TGL|>rotasyon	ɾ o t a s j o n
<|TGL|>malindol	m a l i n d o l
<|TGL|>madiwa	m a d i w a ʔ
<|TGL|>higante	h i ɡ a n t e
<|TGL|>mayayabang	m a j a j a b a ŋ
<|TGL|>Aleman	ʔ a l e m a n
<|TGL|>Hamayka	h a m a j k a
<|TGL|>rambol	ɾ a m b o l
<|TGL|>galagala	ɡ a l a ɡ a l a
<|TGL|>maggantsilyo	m a ɡ ɡ a n t͡ʃ i l j o
<|TGL|>Villablanca	v i l j a b l a n k a
<|TGL|>ko	k o
<|TGL|>haya	h a j a ʔ
<|TGL|>takuri	t a k u ɾ i ʔ
<|TGL|>awtorisasyon	ʔ a w t o ɾ i s a s j o n
<|TGL|>nanghawa	n a ŋ h a w a
<|TGL|>bulyaw	b u l j a w
<|TGL|>Cortez	k o ɾ t e s
<|TGL|>lilok	l i l o k
<|TGL|>hingalo	h i ŋ a l o ʔ
<|TGL|>radikalismo	ɾ a d i k a l i s m o
<|TGL|>labandero	l a b a n d e ɾ o
<|TGL|>Caparas	k a p a ɾ a s
<|TGL|>kodigo	k o d i ɡ o
<|TGL|>magpaalam	m a ɡ p a ʔ a l a m
<|TGL|>ayungin	ʔ a j u ŋ i n
<|TGL|>tributaryo	t ɾ i b u t a ɾ j o
<|TGL|>piyudalismo	p i u d a l i s m o
<|TGL|>siyokoy	s i o k o j
<|TGL|>korea	k o ɾ e a
<|TGL|>magtipid	m a ɡ t i p i d
<|TGL|>Pilipinismo	p i l i p i n i s m o
<|TGL|>daos	d a ʔ o s
<|TGL|>garbo	ɡ a ɾ b o
<|TGL|>maleta	m a l e t a
<|TGL|>talentado	t a l e n t a d o
<|TGL|>Karunungan	k a ɾ u n u ŋ a n
<|TGL|>Ortea	ʔ o ɾ t e a
<|TGL|>Roxas	ɾ o h a s
<|TGL|>balbakwa	b a l b a k w a
<|TGL|>determinismo	d e t e ɾ m i n i s m o
<|TGL|>Batangueña	b a t a ŋ ɡ e n j a
<|TGL|>kabulagsakan	k a b u l a ɡ s a k a n
<|TGL|>Encarnacion	ʔ e n k a ɾ n a s j o n
<|TGL|>panahinga	p a n a h i ŋ a
<|TGL|>magsimba	m a ɡ s i m b a
<|TGL|>kaligkig	k a l i ɡ k i ɡ
<|TGL|>chaka	t͡ʃ a k a ʔ
<|TGL|>lang	l a ŋ
<|TGL|>dantaon	d a n t a ʔ o n
<|TGL|>akompanya	ʔ a k o m p a n j a
<|TGL|>destabilisasyon	d e s t a b i l i s a s j o n
<|TGL|>Alolod	ʔ a l o l o d
<|TGL|>anis	ʔ a n i s
<|TGL|>anino	ʔ a n i n o
<|TGL|>warlahin	w a ɾ l a h i n
<|TGL|>kilos	k i l o s
<|TGL|>pasasalamat	p a s a s a l a m a t
<|TGL|>tagatuos	t a ɡ a t u ʔ o s
<|TGL|>dedikasyon	d e d i k a s j o n
<|TGL|>Sergio	s e ɾ h i o
<|TGL|>gariya	ɡ a ɾ i a ʔ
<|TGL|>baklad	b a k l a d
<|TGL|>lohiko	l o h i k o
<|TGL|>lasinggera	l a s i ŋ ɡ e ɾ a
<|TGL|>agnostiko	ʔ a ɡ n o s t i k o
<|TGL|>koteho	k o t e h o
<|TGL|>suplada	s u p l a d a
<|TGL|>balino	b a l i n o
<|TGL|>walwal	w a l w a l
<|TGL|>lawulta	l a w u l t a
<|TGL|>dara	d a ɾ a
<|TGL|>pinabulaanan	p i n a b u l a ʔ a n a n
<|TGL|>Lanao	l a n a w
<|TGL|>alipunga	ʔ a l i p u ŋ a
<|TGL|>omsim	ʔ o m s i m
<|TGL|>Mabulo	m a b u l o
<|TGL|>kupo	k u p o ʔ
<|TGL|>Tupa	t u p a
<|TGL|>katotohanan	k a t o t o h a n a n
<|TGL|>tikang	t i k a ŋ
<|TGL|>kromosoma	k ɾ o m o s o m a
<|TGL|>Elorde	ʔ e l o ɾ d e
<|TGL|>binatilyo	b i n a t i l j o
<|TGL|>estranghero	ʔ e s t ɾ a ŋ h e ɾ o
<|TGL|>tiyobibo	t i o b i b o
<|TGL|>palabasa	p a l a b a s a
<|TGL|>magmukmok	m a ɡ m u k m o k
<|TGL|>guham	ɡ u h a m
<|TGL|>sambalilo	s a m b a l i l o
<|TGL|>matipuno	m a t i p u n o ʔ
<|TGL|>santan	s a n t a n
<|TGL|>sundin	s u n d i n
<|TGL|>Montañez	m o n t a ɲ e s
<|TGL|>taltak	t a l t a k
<|TGL|>maambunan	m a ʔ a m b u n a n
<|TGL|>blangko	b l a ŋ k o
<|TGL|>Manalang	m a n a l a ŋ
<|TGL|>maglaway	m a ɡ l a w a j
<|TGL|>April	ʔ e j p ɾ i l
<|TGL|>kongkreto	k o ŋ k ɾ e t o
<|TGL|>tulod	t u l o d
<|TGL|>anib	ʔ a n i b
<|TGL|>bangketa	b a ŋ k e t a
<|TGL|>Cabungcal	k a b u ŋ k a l
<|TGL|>adelanto	ʔ a d e l a n t o
<|TGL|>Decena	d e s e n a
<|TGL|>Korean	k o ɾ i a n
<|TGL|>umaakyat	ʔ u m a ʔ a k j a t
<|TGL|>lumutang	l u m u t a ŋ
<|TGL|>Miraflores	m i ɾ a f l o ɾ e s
<|TGL|>Samar	s a m a ɾ
<|TGL|>magbanda	m a ɡ b a n d a
<|TGL|>Vizconde	v i s k o n d e
<|TGL|>abandonado	ʔ a b a n d o n a d o
<|TGL|>baway	b a w a j
<|TGL|>ingklitik	ʔ i ŋ k l i t i k
<|TGL|>kumbensiyon	k u m b e n s i o n
<|TGL|>talikakas	t a l i k a k a s
<|TGL|>Escuadro	ʔ e s k u a d ɾ o
<|TGL|>ratratin	ɾ a t ɾ a t i n
<|TGL|>David	d e j v i d
<|TGL|>himagas	h i m a ɡ a s
<|TGL|>opsiyon	ʔ o p s i o n
<|TGL|>Medrano	m e d ɾ a n o
<|TGL|>semento	s e m e n t o
<|TGL|>sagubang	s a ɡ u b a ŋ
<|TGL|>sakto	s a k t o
<|TGL|>aroma	ʔ a ɾ o m a
<|TGL|>manghihipo	m a ŋ h i h i p o ʔ
<|TGL|>Nebraska	n e b ɾ a s k a
<|TGL|>gamol	ɡ a m o l
<|TGL|>Gascon	ɡ a s k o n
<|TGL|>katay	k a t a j
<|TGL|>tinedyer	t i n e d j e ɾ
<|TGL|>tulag	t u l a ɡ
<|TGL|>bandehado	b a n d e h a d o
<|TGL|>haj	h a d͡ʒ
<|TGL|>laguyo	l a ɡ u j o ʔ
<|TGL|>Candelaria	k a n d e l a ɾ j a
<|TGL|>ene	ʔ e n e
<|TGL|>badap	b a d a p
<|TGL|>ornitolohiya	ʔ o ɾ n i t o l o h i a
<|TGL|>silidkulay	s i ˌl i d k u l a j
<|TGL|>malambot	m a l a m b o t
<|TGL|>melodiya	m e l o d i a
<|TGL|>bako	b a k o ʔ
<|TGL|>abnormalidad	ʔ a b n o ɾ m a l i d a d
<|TGL|>alat	ʔ a l a t
<|TGL|>Eden	ʔ e d e n
<|TGL|>abain	ʔ a b a ʔ i n
<|TGL|>soberaniya	s o b e ɾ a n i a
<|TGL|>magigi	m a ɡ i ɡ i ʔ
<|TGL|>Rosete	ɾ o s e t e
<|TGL|>kabalyo	k a b a l j o
<|TGL|>pagsasaka	p a ɡ s a s a k a
<|TGL|>sikreto	s i k ɾ e t o
<|TGL|>katol	k a t o l
<|TGL|>mahumaling	m a h u m a l i ŋ
<|TGL|>Budista	b u d i s t a
<|TGL|>kusinero	k u s i n e ɾ o
<|TGL|>halabos	h a l a b o s
<|TGL|>maglustay	m a ɡ l u s t a j
<|TGL|>maburol	ˌm a b u ɾ o l
<|TGL|>lumamig	l u m a m i ɡ
<|TGL|>astinggal	ʔ a s t i ŋ ɡ a l
<|TGL|>timbulog	t i m b u l o ɡ
<|TGL|>tilandoy	t i l a n d o j
<|TGL|>luwag	l u a ɡ
<|TGL|>umisod	ʔ u m i s o d
<|TGL|>ermat	ʔ e ɾ m a t
<|TGL|>kabaktan	k a b a k t a n
<|TGL|>Abad	ʔ a b a d
<|TGL|>hunyango	h u n j a ŋ o ʔ
<|TGL|>bisyon	b i s j o n
<|TGL|>kali	k a l i
<|TGL|>duwende	d u e n d e
<|TGL|>buwitre	b u i t ɾ e
<|TGL|>tanawan	t a n a w a n
<|TGL|>importante	ʔ i m p o ɾ t a n t e
<|TGL|>alguwasil	ʔ a l ɡ u a s i l
<|TGL|>paminta	p a m i n t a
<|TGL|>palitada	p a l i t a d a
<|TGL|>uom	ʔ u ʔ o m
<|TGL|>mabunutan	m a b u n u t a n
<|TGL|>Kuniko	k u n i k o
<|TGL|>Marife	m a ɾ i f e
<|TGL|>repriherador	ɾ e p ɾ i h e ɾ a d o ɾ
<|TGL|>sinsay	s i n s a j
<|TGL|>tsibog	t͡ʃ i b o ɡ
<|TGL|>dalubsining	d a l u b s i n i ŋ
<|TGL|>lako	l a k o ʔ
<|TGL|>Suansing	s u a n s i ŋ
<|TGL|>lingming	l i ŋ m i ŋ
<|TGL|>Castañeda	k a s t a ɲ e d a
<|TGL|>soli	s o l i ʔ
<|TGL|>Maniquiz	m a n i k i s
<|TGL|>mawasak	m a w a s a k
<|TGL|>Epipanya	ʔ e p i p a n j a
<|TGL|>matraka	m a t ɾ a k a
<|TGL|>proyekto	p ɾ o j e k t o
<|TGL|>tuldik	t u l d i k
<|TGL|>pasipismo	p a s i p i s m o
<|TGL|>suminga	s u m i ŋ a
<|TGL|>babaero	b a b a ʔ e ɾ o
<|TGL|>amin	ʔ a m i n
<|TGL|>kanino	k a n i n o
<|TGL|>laspag	l a s p a ɡ
<|TGL|>bagsakan	b a ɡ s a k a n
<|TGL|>tolerante	t o l e ɾ a n t e
<|TGL|>reto	ɾ e t o
<|TGL|>Dulay	d u l a j
<|TGL|>tanggap	t a ŋ ɡ a p
<|TGL|>Sesus	s e s u s
<|TGL|>humigit	h u m i ɡ i t
<|TGL|>Acuña	ʔ a k u ɲ a
<|TGL|>Alcaide	ʔ a l k a j d e
<|TGL|>Camantigue	k a m a n t i ɡ e
<|TGL|>mangomisyon	m a ŋ o m i s j o n
<|TGL|>kartamoneda	k a ɾ t a m o n e d a
<|TGL|>takong	t a k o ŋ
<|TGL|>ka	k a
<|TGL|>butanding	b u t a n d i ŋ
<|TGL|>sumbong	s u m b o ŋ
<|TGL|>diyesmo	d i e s m o
<|TGL|>sanib	s a n i b
<|TGL|>hupot	h u p o t
<|TGL|>sanggumay	s a ŋ ɡ u m a j
<|TGL|>itapat	ʔ i t a p a t
<|TGL|>tabon	t a b o n
<|TGL|>maghasik	m a ɡ h a s i k
<|TGL|>balana	b a l a n a
<|TGL|>yagong	j a ɡ o ŋ
<|TGL|>tambolero	t a m b o l e ɾ o
<|TGL|>direktora	d i ɾ e k t o ɾ a
<|TGL|>pulpol	p u l p o l
<|TGL|>ostrasismo	ʔ o s t ɾ a s i s m o
<|TGL|>maagap	m a ʔ a ɡ a p
<|TGL|>balakyot	b a l a k j o t
<|TGL|>sumite	s u m i t e
<|TGL|>dekwatin	d e k w a t i n
<|TGL|>Ayako	ʔ a j a k o
<|TGL|>Samonte	s a m o n t e
<|TGL|>gulat	ɡ u l a t
<|TGL|>Garces	ɡ a ɾ s e s
<|TGL|>tunggali	t u ŋ ɡ a l i ʔ
<|TGL|>oranggutan	ʔ o ɾ a ŋ ɡ u t a n
<|TGL|>pantalon	p a n t a l o n
<|TGL|>paskuwa	p a s k u a
<|TGL|>aaaban	ʔ a ʔ a ʔ a b a n
<|TGL|>aduwana	ʔ a d u a n a
<|TGL|>sundan	s u n d a n
<|TGL|>mangmang	m a ŋ m a ŋ
<|TGL|>minsanan	m i n s a n a n
<|TGL|>Yoshiko	j o ʃ i k o
<|TGL|>pamilyaridad	p a m i l j a ɾ i d a d
<|TGL|>lakwatsera	l a k w a t͡ʃ e ɾ a
<|TGL|>pagkasuplada	p a ɡ k a s u p l a d a
<|TGL|>pasa	p a s a
<|TGL|>empleyada	ʔ e m p l e a d a
<|TGL|>patola	p a t o l a
<|TGL|>bunggo	b u ŋ ɡ o ʔ
<|TGL|>kalyo	k a l j o
<|TGL|>nipis	n i p i s
<|TGL|>nagagandahan	n a ɡ a ɡ a n d a h a n
<|TGL|>Bolbok	b o l b o k
<|TGL|>oktaba	ʔ o k t a b a
<|TGL|>Ormoc	ʔ o ɾ m o k
<|TGL|>Bogota	b o ɡ o t a
<|TGL|>galang	ɡ a l a ŋ
<|TGL|>lunaw	l u n a w
<|TGL|>makatarungan	m a k a t a ɾ u ŋ a n
<|TGL|>Mandaluyong	m a n d a l u j o ŋ
<|TGL|>probinsiyana	p ɾ o b i n s i a n a
<|TGL|>ngani	ŋ a n i ʔ
<|TGL|>Esperanto	ʔ e s p e ɾ a n t o
<|TGL|>deskumpiyado	d e s k u m p i a d o
<|TGL|>saing	s a ʔ i ŋ
<|TGL|>maghimagsik	m a ɡ h i m a ɡ s i k
<|TGL|>walumpu	w a l u m p u ʔ
<|TGL|>teleolohiya	t e l e o l o h i a
<|TGL|>tsarter	t͡ʃ a ɾ t e ɾ
<|TGL|>mangjumbag	m a ŋ d͡ʒ u m b a ɡ
<|TGL|>pamahalaan	ˌp a m a h a l a ʔ a n
<|TGL|>kuripot	k u ɾ i p o t
<|TGL|>payak	p a j a k
<|TGL|>matinis	m a t i n i s
<|TGL|>palasyo	p a l a s j o
<|TGL|>pasiglahin	p a s i ɡ l a h i n
<|TGL|>agam	ʔ a ɡ a m
<|TGL|>baranggay	b a ɾ a ŋ ɡ a j
<|TGL|>eskarlata	ʔ e s k a ɾ l a t a
<|TGL|>bulyos	b u l j o s
<|TGL|>Barangka	b a ɾ a ŋ k a ʔ
<|TGL|>apdo	ʔ a p d o
<|TGL|>kontento	k o n t e n t o
<|TGL|>mabunganga	m a b u ŋ a ŋ a ʔ
<|TGL|>Corpus	k o ɾ p u s
<|TGL|>pangyari	p a ŋ j a ɾ i
<|TGL|>waley	w a l e j
<|TGL|>durog	d u ɾ o ɡ
<|TGL|>gahol	ɡ a h o l
<|TGL|>dipterya	d i p t e ɾ j a
<|TGL|>kahoy	k a h o j
<|TGL|>Dagupan	d a ɡ u p a n
<|TGL|>Pesigan	p e s i ɡ a n
<|TGL|>asul	ʔ a s u l
<|TGL|>alibutran	ʔ a l i b u t ɾ a n
<|TGL|>hain	h a ʔ i n
<|TGL|>gagi	ɡ a ɡ i ʔ
<|TGL|>seminaryo	s e m i n a ɾ j o
<|TGL|>garya	ɡ a ɾ j a ʔ
<|TGL|>ganda	ɡ a n d a
<|TGL|>singsing	s i ŋ s i ŋ
<|TGL|>bilao	b i l a ʔ o
<|TGL|>disposisyon	d i s p o s i s j o n
<|TGL|>kalihim	k a l i h i m
<|TGL|>lingguhan	l i ŋ ɡ u h a n
<|TGL|>also	ʔ a l s o
<|TGL|>helikopter	h e l i k o p t e ɾ
<|TGL|>pagkabuhay	p a ɡ k a b u h a j
<|TGL|>sukdulan	s u k d u l a n
<|TGL|>Biring	b i ɾ i ŋ
<|TGL|>Siam	s i a m
<|TGL|>reyalista	ɾ e a l i s t a
<|TGL|>pilak	p i l a k
<|TGL|>oras	ʔ o ɾ a s
<|TGL|>Damulag	d a m u l a ɡ
<|TGL|>tinga	t i ŋ a
<|TGL|>alternatibo	ʔ a l t e ɾ n a t i b o
<|TGL|>arwa	ʔ a ɾ w a ʔ
<|TGL|>bango	b a ŋ o
<|TGL|>biyopisika	b i o p i s i k a
<|TGL|>talos	t a l o s
<|TGL|>patnugot	p a t n u ɡ o t
<|TGL|>mulinilyo	m u l i n i l j o
<|TGL|>Guillermo	ɡ i l j e ɾ m o
<|TGL|>Koji	k o d͡ʒ i
<|TGL|>siyantung	s i a n t u ŋ
<|TGL|>taling	t a l i ŋ
<|TGL|>pambansa	p a m b a n s a ʔ
<|TGL|>lumakas	l u m a k a s
<|TGL|>Bugtong	b u ɡ t o ŋ
<|TGL|>pitundaan	p i t u n d a ʔ a n
<|TGL|>salaula	s a l a ʔ u l a ʔ
<|TGL|>kunsumisyon	k u n s u m i s j o n
<|TGL|>pambata	p a m b a t a
<|TGL|>awtonomiya	ʔ a w t o n o m i a
<|TGL|>gatid	ɡ a t i d
<|TGL|>Jocson	h o k s o n
<|TGL|>lagundi	l a ɡ u n d i ʔ
<|TGL|>magdaos	p a ɡ d a ʔ o s
<|TGL|>duweto	d u e t o
<|TGL|>halip	h a l i p
<|TGL|>lumuklok	l u m u k l o k
<|TGL|>Enero	ʔ e n e ɾ o
<|TGL|>solusyon	s o l u s j o n
<|TGL|>Tien	t j e n
<|TGL|>tanghalian	t a ŋ h a l i ʔ a n
<|TGL|>nang	n a ŋ
<|TGL|>rumupok	ɾ u m u p o k
<|TGL|>inspeksiyon	ʔ i n s p e k s i o n
<|TGL|>alamang	ʔ a l a m a ŋ
<|TGL|>landi	l a n d i ʔ
<|TGL|>Valera	v a l e ɾ a
<|TGL|>panlinis	p a n l i n i s
