<|ITA|>abbonamento	a b b o n a m e n t o
<|ITA|>accettare	a t t͡ʃ e t t a r e
<|ITA|>accoglienza	a k k o ʎ ʎ ɛ n t͡s a
<|ITA|>accompagnare	a k k o m p a ɲ ɲ a r e
<|ITA|>accordo	a k k ɔ r d o
<|ITA|>acqua	a k k w a
<|ITA|>acquazzone	a k k w a t t͡s o n e
<|ITA|>acquistare	a k k w i s t a r e
<|ITA|>ad	a d
<|ITA|>adatto	a d a t t o
<|ITA|>adesso	a d ɛ s s o
<|ITA|>affermato	a f f e r m a t o
<|ITA|>agenti	a d͡ʒ ɛ n t i
<|ITA|>agenzia	a d͡ʒ e n t͡s i a
<|ITA|>aggiunge	a d d͡ʒ u n d͡ʒ e
<|ITA|>aggiunto	a d d͡ʒ u n t o
<|ITA|>agli	a ʎ ʎ i
<|ITA|>aiuto	a j u t o
<|ITA|>albergo	a l b ɛ r ɡ o
<|ITA|>alberto	a l b ɛ r t o
<|ITA|>alessandra	a l e s s a n d r a
<|ITA|>alghero	a l ɡ ɛ r o
<|ITA|>alle	a l l e
<|ITA|>allenatore	a l l e n a t o r e
<|ITA|>allineato	a l l i n e a t o
<|ITA|>allo	a l l o
<|ITA|>allucinato	a l l u t͡ʃ i n a t o
<|ITA|>alternato	a l t e r n a t o
<|ITA|>alti	a l t i
<|ITA|>altra	a l t r a
<|ITA|>altre	a l t r e
<|ITA|>altri	a l t r i
<|ITA|>altro	a l t r o
<|ITA|>alture	a l t u r e
<|ITA|>america	a m ɛ r i k a
<|ITA|>amministrazione	a m m i n i s t r a t t͡s j o n e
<|ITA|>ampio	a m p j o
<|ITA|>anatroccolo	a n a t r ɔ k k o l o
<|ITA|>anche	a n k e
<|ITA|>andare	a n d a r e
<|ITA|>animale	a n i m a l e
<|ITA|>animazione	a n i m a t t͡s j o n e
<|ITA|>antognoni	a n t o ɲ ɲ o n i
<|ITA|>antonella	a n t o n ɛ l l a
<|ITA|>aperto	a p ɛ r t o
<|ITA|>appalti	a p p a l t i
<|ITA|>apparecchio	a p p a r e k k j o
<|ITA|>appello	a p p ɛ l l o
<|ITA|>appena	a p p e n a
<|ITA|>applicare	a p p l i k a r e
<|ITA|>aprile	a p r i l e
<|ITA|>ara	a r a
<|ITA|>armati	a r m a t i
<|ITA|>arricchito	a r r i k k i t o
<|ITA|>arrivare	a r r i v a r e
<|ITA|>arsenico	a r s ɛ n i k o
<|ITA|>articolo	a r t i k o l o
<|ITA|>assente	a s s ɛ n t e
<|ITA|>assenza	a s s ɛ n t͡s a
<|ITA|>assicurato	a s s i k u r a t o
<|ITA|>assistenza	a s s i s t ɛ n t͡s a
<|ITA|>assistere	a s s i s t e r e
<|ITA|>assolutistico	a s s o l u t i s t i k o
<|ITA|>attività	a t t i v i t a
<|ITA|>attraverso	a t t r a v ɛ r s o
<|ITA|>attuale	a t t u a l e
<|ITA|>attualità	a t t u a l i t a
<|ITA|>augusta	a w ɡ u s t a
<|ITA|>auto	a w t o
<|ITA|>autorevole	a u t o r e v o l e
<|ITA|>autorità	a u̯ t o r i t a
<|ITA|>autunno	a w t u n n o
<|ITA|>avanti	a v a n t i
<|ITA|>avere	a v e r e
<|ITA|>aveva	a v e v a
<|ITA|>badia	b a d i a
<|ITA|>ballo	b a l l o
<|ITA|>balzo	b a l t͡s o
<|ITA|>banca	b a n k a
<|ITA|>banda	b a n d a
<|ITA|>banditi	b a n d i t i
<|ITA|>basta	b a s t a
<|ITA|>battaglia	b a t t a ʎ ʎ a
<|ITA|>battere	b a t t e r e
<|ITA|>befana	b e f a n a
<|ITA|>benissimo	b e n i s s i m o
<|ITA|>beppe	b ɛ p p e
<|ITA|>biglietto	b i ʎ ʎ e t t o
<|ITA|>bisogno	b i z o ɲ ɲ o
<|ITA|>bolla	b o l l a
<|ITA|>bologna	b o l o ɲ ɲ a
<|ITA|>borse	b o r s e
<|ITA|>brevi	b r ɛ v i
<|ITA|>brutale	b r u t a l e
<|ITA|>buon	b w ɔ n
<|ITA|>cadavere	k a d a v e r e
<|ITA|>calabria	k a l a b r j a
<|ITA|>calcio	k a l t͡ʃ o
<|ITA|>calendario	k a l e n d a r j o
<|ITA|>calore	k a l o r e
<|ITA|>cambiare	k a m b j a r e
<|ITA|>camion	k a m j o n
<|ITA|>camminare	k a m m i n a r e
<|ITA|>cammino	k a m m i n o
<|ITA|>campagna	k a m p a ɲ ɲ a
<|ITA|>campo	k a m p o
<|ITA|>candidato	k a n d i d a t o
<|ITA|>cane	k a n e
<|ITA|>canzone	k a n t͡s o n e
<|ITA|>capire	k a p i r e
<|ITA|>capita	k a p i t a
<|ITA|>capito	k a p i t o
<|ITA|>capo	k a p o
<|ITA|>capolino	k a p o l i n o
<|ITA|>capoluogo	k a p o l w ɔ ɡ o
<|ITA|>cappa	k a p p a
<|ITA|>cardinale	k a r d i n a l e
<|ITA|>casinò	k a z i n ɔ
<|ITA|>caso	k a z o
<|ITA|>castello	k a s t ɛ l l o
<|ITA|>cattedrale	k a t t e d r a l e
<|ITA|>cattolico	k a t t o l i k o
<|ITA|>ce	t͡ʃ e
<|ITA|>celebre	t͡ʃ ɛ l e b r e
<|ITA|>cena	t͡ʃ e n a
<|ITA|>cento	t͡ʃ ɛ n t o
<|ITA|>centrale	t ʃ e n t r a l e
<|ITA|>centro	t ʃ ɛ n t r o
<|ITA|>cerca	t͡ʃ e r k a
<|ITA|>cercare	t ʃ e r k a r e
<|ITA|>cerco	t͡ʃ e r k o
<|ITA|>certo	t͡ʃ ɛ r t o
<|ITA|>che	k e
<|ITA|>chiamo	k j a m o
<|ITA|>chiaro	k j a r o
<|ITA|>chiedere	k j ɛ d e r e
<|ITA|>chiuso	k j u z o
<|ITA|>chiù	k j u
<|ITA|>ciclo	t͡ʃ i k l o
<|ITA|>cinque	t͡ʃ i n k w e
<|ITA|>cioccolato	t͡ʃ o k k o l a t o
<|ITA|>cittadino	t͡ʃ i t t a d i n o
<|ITA|>civile	t͡ʃ i v i l e
<|ITA|>coerenza	k o e r ɛ n t͡s a
<|ITA|>collegamento	k o l l e ɡ a m e n t o
<|ITA|>colloquio	k o l l ɔ k w j o
<|ITA|>colore	k o l o r e
<|ITA|>combattere	k o m b a t t e r e
<|ITA|>come	k o m e
<|ITA|>cominciare	k o m i n t͡ʃ a r e
<|ITA|>compagnia	k o m p a ɲ ɲ i a
<|ITA|>compilazione	k o m p i l a t t͡s j o n e
<|ITA|>complessità	k o m p l e s s i t a
<|ITA|>complotto	k o m p l ɔ t t o
<|ITA|>comprare	k o m p r a r e
<|ITA|>comunque	k o m u n k w e
<|ITA|>concetto	k o n t͡ʃ ɛ t t o
<|ITA|>conclusione	k o n k l u z j o n e
<|ITA|>condividere	k o n d i v i d e r e
<|ITA|>condizione	k o n d i t t͡s j o n e
<|ITA|>condurre	k o n d u r r e
<|ITA|>conduttore	k o n d u t t o r e
<|ITA|>connessione	k o n n e s s j o n e
<|ITA|>contagi	k o n t a d͡ʒ i
<|ITA|>contatto	k o n t a t t o
<|ITA|>conte	k o n t e
<|ITA|>contenimento	k o n t e n i m e n t o
<|ITA|>contenuto	k o n t e n u t o
<|ITA|>continuo	k o n t i n w o
<|ITA|>contrastato	k o n t r a s t a t o
<|ITA|>contro	k o n t r o
<|ITA|>convinto	k o n v i n t o
<|ITA|>copertina	k o p e r t i n a
<|ITA|>copie	k ɔ p j e
<|ITA|>coprire	k o p r i r e
<|ITA|>corona	k o r o n a
<|ITA|>corruscare	k o r r u s k a r e
<|ITA|>costituzionale	k o s t i t u t t͡s j o n a l e
<|ITA|>creare	k r e a r e
<|ITA|>credo	k r e d o
<|ITA|>criterio	k r i t ɛ r j o
<|ITA|>cruciforme	k r u t͡ʃ i f o r m e
<|ITA|>cui	k u j
<|ITA|>curato	k u r a t o
<|ITA|>daffare	d a f f a r e
<|ITA|>dallo	d a l l o
<|ITA|>danno	d a n n o
<|ITA|>deboli	d e b o l i
<|ITA|>debutto	d e b u t t o
<|ITA|>decesso	d e t͡ʃ ɛ s s o
<|ITA|>decisamente	d e t͡ʃ i z a m e n t e
<|ITA|>deciso	d e t͡ʃ i z o
<|ITA|>democratico	d e m o k r a t i k o
<|ITA|>densità	d e n s i t a
<|ITA|>dentro	d e n t r o
<|ITA|>dettaglio	d e t t a ʎ ʎ o
<|ITA|>deve	d ɛ v e
<|ITA|>dice	d i t͡ʃ e
<|ITA|>dichiarato	d i k j a r a t o
<|ITA|>didattica	d i d a t t i k a
<|ITA|>dieci	d j ɛ t͡ʃ i
<|ITA|>difendere	d i f ɛ n d e r e
<|ITA|>difesa	d i f e s a
<|ITA|>difficoltà	d i f f i k o l t a
<|ITA|>diffondere	d i f f o n d e r e
<|ITA|>diffusione	d i f f u z j o n e
<|ITA|>dilettantistico	d i l e t t a n t i s t i k o
<|ITA|>diminuzione	d i m i n u t t͡s j o n e
<|ITA|>dipendente	d i p e n d ɛ n t e
<|ITA|>dire	d i r e
<|ITA|>direzione	d i r e t t s j o n e
<|ITA|>dirotto	d i r o t t o
<|ITA|>disagi	d i z a d͡ʒ i
<|ITA|>disastro	d i z a s t r o
<|ITA|>disposizione	d i s p o z i t t͡s j o n e
<|ITA|>diva	d i v a
<|ITA|>diversità	d i v e r s i t a
<|ITA|>divisione	d i v i z j o n e
<|ITA|>diviso	d i v i z o
<|ITA|>dobbiamo	d o b b j a m o
<|ITA|>dolore	d o l o r e
<|ITA|>domani	d o m a n i
<|ITA|>donna	d ɔ n n a
<|ITA|>donne	d ɔ n n e
<|ITA|>dopo	d o p o
<|ITA|>dormire	d o r m i r e
<|ITA|>dottrina	d o t t r i n a
<|ITA|>dove	d o v e
<|ITA|>dovuto	d o v u t o
<|ITA|>drammatico	d r a m m a t i k o
<|ITA|>droga	d r ɔ ɡ a
<|ITA|>due	d u e
<|ITA|>dunque	d u n k w e
<|ITA|>durante	d u r a n t e
<|ITA|>ebbene	e b b ɛ n e
<|ITA|>ebraico	e b r a j k o
<|ITA|>ecco	ɛ k k o
<|ITA|>economista	e k o n o m i s t a
<|ITA|>ed	e d
<|ITA|>edizione	e d i t t͡s j o n e
<|ITA|>efficiente	e f f i t͡ʃ ɛ n t e
<|ITA|>elicottero	e l i k ɔ t t e r o
<|ITA|>emotivo	e m o t i v o
<|ITA|>energetica	e n e r d͡ʒ ɛ t i k a
<|ITA|>energia	e n e r d͡ʒ i a
<|ITA|>episodi	e p i z ɔ d i
<|ITA|>episodio	e p i z ɔ d j o
<|ITA|>era	ɛ r a
<|ITA|>ero	ɛ r o
<|ITA|>errore	e r r o r e
<|ITA|>errori	e r r o r i
<|ITA|>esattamente	e z a t t a m e n t e
<|ITA|>eseguire	e z e ɡ w i r e
<|ITA|>esempio	e z ɛ m p j o
<|ITA|>esperienza	e s p e r j ɛ n t͡s a
<|ITA|>essere	ɛ s s e r e
<|ITA|>eterno	e t ɛ r n o
<|ITA|>evidente	e v i d ɛ n t e
<|ITA|>evitando	e v i t a n d o
<|ITA|>evitare	e v i t a r e
<|ITA|>fa	f a
<|ITA|>fabbisogno	f a b b i z o ɲ ɲ o
<|ITA|>fabbrica	f a b b r i k a
<|ITA|>fabrizio	f a b r i t t s j o
<|ITA|>faccio	f a t t ʃ o
<|ITA|>fallo	f a l l o
<|ITA|>famiglia	f a m i ʎ ʎ a
<|ITA|>fanno	f a n n o
<|ITA|>fantasia	f a n t a z i a
<|ITA|>fasce	f a ʃ ʃ e
<|ITA|>fascia	f a ʃ ʃ a
<|ITA|>fascista	f a ʃ ʃ i s t a
<|ITA|>fase	f a z e
<|ITA|>fatica	f a t i k a
<|ITA|>fatto	f a t t o
<|ITA|>fatturato	f a t t u r a t o
<|ITA|>febbraio	f e b b r a j o
<|ITA|>federale	f e d e r a l e
<|ITA|>federico	f e d e r i k o
<|ITA|>felice	f e l i t͡ʃ e
<|ITA|>femminile	f e m m i n i l e
<|ITA|>fenomeno	f e n ɔ m e n o
<|ITA|>fermato	f e r m a t o
<|ITA|>ferro	f ɛ r r o
<|ITA|>festa	f ɛ s t a
<|ITA|>festività	f e s t i v i t a
<|ITA|>fiducioso	f i d u t͡ʃ o z o
<|ITA|>figlia	f i ʎ ʎ a
<|ITA|>figlio	f i ʎ ʎ o
<|ITA|>fila	f i l a
<|ITA|>fine	f i n e
<|ITA|>finite	f i n i t e
<|ITA|>fiorentina	f j o r e n t i n a
<|ITA|>firenze	f i r ɛ n t͡s e
<|ITA|>fiscale	f i s k a l e
<|ITA|>fisica	f i z i k a
<|ITA|>fisico	f i z i k o
<|ITA|>fornitura	f o r n i t u r a
<|ITA|>forse	f o r s e
<|ITA|>fortuna	f o r t u n a
<|ITA|>foto	f ɔ t o
<|ITA|>fra	f r a
<|ITA|>frase	f r a z e
<|ITA|>friuli	f r i u l i
<|ITA|>fucile	f u t͡ʃ i l e
<|ITA|>funzione	f u n t͡s j o n e
<|ITA|>furto	f u r t o
<|ITA|>futuro	f u t u r o
<|ITA|>gazebo	ɡ a d d͡z ɛ b o
<|ITA|>genere	d͡ʒ ɛ n e r e
<|ITA|>genio	d͡ʒ ɛ n j o
<|ITA|>giornale	d͡ʒ o r n a l e
<|ITA|>giornata	d͡ʒ o r n a t a
<|ITA|>giorno	d͡ʒ o r n o
<|ITA|>giovanile	d͡ʒ o v a n i l e
<|ITA|>giovanni	d͡ʒ o v a n n i
<|ITA|>giudiziario	d͡ʒ u d i t t͡s j a r j o
<|ITA|>giulietta	d͡ʒ u l j e t t a
<|ITA|>già	d͡ʒ a
<|ITA|>globale	ɡ l o b a l e
<|ITA|>governo	ɡ o v ɛ r n o
<|ITA|>gran	ɡ r a n
<|ITA|>grandi	ɡ r a n d i
<|ITA|>grasso	ɡ r a s s o
<|ITA|>grazie	ɡ r a t t͡s j e
<|ITA|>greco	ɡ r ɛ k o
<|ITA|>griffe	ɡ r i f f e
<|ITA|>gruppetto	ɡ r u p p e t t o
<|ITA|>ieri	j ɛ r i
<|ITA|>il	i l
<|ITA|>ilarità	i l a r i t a
<|ITA|>impeto	i m p e t o
<|ITA|>in	i n
<|ITA|>incontrare	i n k o n t r a r e
<|ITA|>indignazione	i n d i ɲ ɲ a t t͡s j o n e
<|ITA|>inedito	i n ɛ d i t o
<|ITA|>infelice	i n f e l i t͡ʃ e
<|ITA|>infermiere	i n f e r m j ɛ r e
<|ITA|>ingiustizia	i n d͡ʒ u s t i t t͡s j a
<|ITA|>inglese	i n ɡ l e z e
<|ITA|>ingressi	i n ɡ r ɛ s s i
<|ITA|>iniezione	i n j e t t͡s j o n e
<|ITA|>intanto	i n t a n t o
<|ITA|>intenzione	i n t e n t͡s j o n e
<|ITA|>intervista	i n t e r v i s t a
<|ITA|>intorno	i n t o r n o
<|ITA|>introdotto	i n t r o d o t t o
<|ITA|>invece	i n v e t͡ʃ e
<|ITA|>invito	i n v i t o
<|ITA|>io	i o
<|ITA|>istituto	i s t i t u t o
<|ITA|>italiana	i t a l j a n a
<|ITA|>italo	i t a l o
<|ITA|>le	l e
<|ITA|>legato	l e ɡ a t o
<|ITA|>legislativo	l e d͡ʒ i z l a t i v o
<|ITA|>lentamente	l e n t a m ɛ n t e
<|ITA|>leone	l e o n e
<|ITA|>lettera	l ɛ t t e r a
<|ITA|>lettura	l e t t u r a
<|ITA|>lezione	l e t t͡s j o n e
<|ITA|>libertà	l i b e r t a
<|ITA|>limitazione	l i m i t a t t͡s j o n e
<|ITA|>limite	l i m i t e
<|ITA|>lista	l i s t a
<|ITA|>logica	l ɔ d͡ʒ i k a
<|ITA|>lombardia	l o m b a r d i a
<|ITA|>lotta	l ɔ t t a
<|ITA|>luce	l u t͡ʃ e
<|ITA|>luigi	l w i d͡ʒ i
<|ITA|>lupo	l u p o
<|ITA|>maggiore	m a d d͡ʒ o r e
<|ITA|>mail	m ɛ i l
<|ITA|>malore	m a l o r e
<|ITA|>mamma	m a m m a
<|ITA|>manca	m a n k a
<|ITA|>mancato	m a n k a t o
<|ITA|>mantenere	m a n t e n e r e
<|ITA|>marca	m a r k a
<|ITA|>marea	m a r ɛ a
<|ITA|>maria	m a r i a
<|ITA|>marito	m a r i t o
<|ITA|>marocco	m a r ɔ k k o
<|ITA|>martedì	m a r t e d i
<|ITA|>maschera	m a s k e r a
<|ITA|>massaggiatore	m a s s a d d͡ʒ a t o r e
<|ITA|>materiale	m a t e r j a l e
<|ITA|>mattinata	m a t t i n a t a
<|ITA|>medesimo	m e d e z i m o
<|ITA|>medicina	m e d i t͡ʃ i n a
<|ITA|>meglio	m ɛ ʎ ʎ o
<|ITA|>melo	m e l o
<|ITA|>mente	m e n t e
<|ITA|>mentre	m e n t r e
<|ITA|>mercati	m e r k a t i
<|ITA|>mercato	m e r k a t o
<|ITA|>messa	m e s s a
<|ITA|>metà	m e t a
<|ITA|>mezzosoprano	m ɛ d d͡z o s o p r a n o
<|ITA|>mi	m i
<|ITA|>miei	m j ɛ i
<|ITA|>miglior	m i ʎ ʎ o r
<|ITA|>mila	m i l a
<|ITA|>mille	m i l l e
<|ITA|>minore	m i n o r e
<|ITA|>missione	m i s s j o n e
<|ITA|>misto	m i s t o
<|ITA|>modo	m ɔ d o
<|ITA|>moglie	m o ʎ ʎ e
<|ITA|>molto	m o l t o
<|ITA|>monaco	m ɔ n a k o
<|ITA|>mosca	m o s k a
<|ITA|>motivo	m o t i v o
<|ITA|>movimento	m o v i m e n t o
<|ITA|>mugello	m u d͡ʒ ɛ l l o
<|ITA|>multa	m u l t a
<|ITA|>musicale	m u z i k a l e
<|ITA|>napoletano	n a p o l e t a n o
<|ITA|>nascita	n a ʃ ʃ i t a
<|ITA|>nata	n a t a
<|ITA|>natale	n a t a l e
<|ITA|>nato	n a t o
<|ITA|>naturale	n a t u r a l e
<|ITA|>naturalezza	n a t u r a l e t t͡s a
<|ITA|>nazionale	n a t t͡s j o n a l e
<|ITA|>necessario	n e t͡ʃ e s s a r j o
<|ITA|>necessità	n e t͡ʃ e s s i t a
<|ITA|>nemmeno	n e m m e n o
<|ITA|>neonata	n e o n a t a
<|ITA|>nerazzurri	n e r a t t͡s u r r i
<|ITA|>nessun	n e s s u n
<|ITA|>nessuno	n e s s u n o
<|ITA|>netto	n e t t o
<|ITA|>neve	n e v e
<|ITA|>nicola	n i k ɔ l a
<|ITA|>niente	n j ɛ n t e
<|ITA|>nobile	n ɔ b i l e
<|ITA|>non	n o n
<|ITA|>norma	n ɔ r m a
<|ITA|>nostri	n ɔ s t r i
<|ITA|>nostro	n ɔ s t r o
<|ITA|>note	n ɔ t e
<|ITA|>noto	n ɔ t o
<|ITA|>numero	n u m e r o
<|ITA|>nuova	n w ɔ v a
<|ITA|>nuovo	n w ɔ v o
<|ITA|>occhi	ɔ k k i
<|ITA|>offrire	o f f r i r e
<|ITA|>oggi	ɔ d d͡ʒ i
<|ITA|>olanda	o l a n d a
<|ITA|>olimpico	o l i m p i k o
<|ITA|>opera	ɔ p e r a
<|ITA|>operativo	o p e r a t i v o
<|ITA|>operato	o p e r a t o
<|ITA|>oppure	o p p u r e
<|ITA|>orgoglio	o r ɡ o ʎ ʎ o
<|ITA|>oriente	o r j ɛ n t e
<|ITA|>origine	o r i d͡ʒ i n e
<|ITA|>ospite	ɔ s p i t e
<|ITA|>ostinatamente	o s t i n a t a m e n t e
<|ITA|>ottenere	o t t e n e r e
<|ITA|>pace	p a t͡ʃ e
<|ITA|>pagina	p a d͡ʒ i n a
<|ITA|>palazzo	p a l a t t s o
<|ITA|>palco	p a l k o
<|ITA|>palermo	p a l ɛ r m o
<|ITA|>palio	p a l j o
<|ITA|>palo	p a l o
<|ITA|>pane	p a n e
<|ITA|>parere	p a r e r e
<|ITA|>partecipare	p a r t e t͡ʃ i p a r e
<|ITA|>parto	p a r t o
<|ITA|>parziale	p a r t͡s j a l e
<|ITA|>passaporto	p a s s a p o r t o
<|ITA|>passione	p a s s j o n e
<|ITA|>patito	p a t i t o
<|ITA|>paura	p a u r a
<|ITA|>pc	p i t ʃ i
<|ITA|>pellicola	p e l l i k o l a
<|ITA|>pensare	p e n s a r e
<|ITA|>pensavo	p e n s a v o
<|ITA|>pensiero	p e n s j ɛ r o
<|ITA|>pentirsi	p e n t i r s i
<|ITA|>per	p e r
<|ITA|>percorso	p e r k o r s o
<|ITA|>perdere	p ɛ r d e r e
<|ITA|>performance	p e r f ɔ r m a n s
<|ITA|>pericolo	p e r i k o l o
<|ITA|>periodo	p e r i o d o
<|ITA|>perno	p ɛ r n o
<|ITA|>perplessità	p e r p l e s s i t a
<|ITA|>persa	p ɛ r s a
<|ITA|>persino	p e r s i n o
<|ITA|>persona	p e r s o n a
<|ITA|>però	p e r ɔ
<|ITA|>petrolio	p e t r ɔ l j o
<|ITA|>pettorale	p e t t o r a l e
<|ITA|>pezzi	p ɛ t t͡s i
<|ITA|>pianificazione	p j a n i f i k a t t͡s j o n e
<|ITA|>piattaforma	p j a t t a f o r m a
<|ITA|>picciotto	p i t t͡ʃ ɔ t t o
<|ITA|>piccola	p i k k o l a
<|ITA|>piccolo	p i k k o l o
<|ITA|>piovere	p j ɔ v e r e
<|ITA|>più	p j u
<|ITA|>plancia	p l a n t͡ʃ a
<|ITA|>plutone	p l u t o n e
<|ITA|>politico	p o l i t i k o
<|ITA|>pomeriggio	p o m e r i d d͡ʒ o
<|ITA|>pompiere	p o m p j ɛ r e
<|ITA|>popolazione	p o p o l a t t͡s j o n e
<|ITA|>portare	p o r t a r e
<|ITA|>positività	p o z i t i v i t a
<|ITA|>positivo	p o z i t i v o
<|ITA|>possa	p ɔ s s a
<|ITA|>possiamo	p o s s j a m o
<|ITA|>possibile	p o s s i b i l e
<|ITA|>posso	p ɔ s s o
<|ITA|>potrà	p o t r a
<|ITA|>pranzo	p r a n d͡z o
<|ITA|>prefigge	p r e f i d d͡ʒ e
<|ITA|>prende	p r ɛ n d e
<|ITA|>preparazione	p r e p a r a t t͡s j o n e
<|ITA|>presenza	p r e z ɛ n t͡s a
<|ITA|>presto	p r ɛ s t o
<|ITA|>primaria	p r i m a r j a
<|ITA|>primavera	p r i m a v ɛ r a
<|ITA|>primo	p r i m o
<|ITA|>principi	p r i n t͡ʃ i p i
<|ITA|>prodotto	p r o d o t t o
<|ITA|>profonda	p r o f o n d a
<|ITA|>programma	p r o ɡ r a m m a
<|ITA|>progresso	p r o ɡ r ɛ s s o
<|ITA|>promozione	p r o m o t t͡s j o n e
<|ITA|>propria	p r ɔ p r j a
<|ITA|>prossimo	p r ɔ s s i m o
<|ITA|>protezione	p r o t e t t͡s j o n e
<|ITA|>protocollo	p r o t o k ɔ l l o
<|ITA|>prova	p r ɔ v a
<|ITA|>provvedimento	p r o v v e d i m e n t o
<|ITA|>puntata	p u n t a t a
<|ITA|>pupo	p u p o
<|ITA|>pure	p u r e
<|ITA|>qualche	k w a l k e
<|ITA|>qualcosa	k w a l k ɔ z a
<|ITA|>qualcuno	k w a l k u n o
<|ITA|>quando	k w a n d o
<|ITA|>quarantena	k w a r a n t ɛ n a
<|ITA|>quarta	k w a r t a
<|ITA|>quella	k w e l l a
<|ITA|>quelli	k w e l l i
<|ITA|>quello	k w e l l o
<|ITA|>questione	k w e s t j o n e
<|ITA|>quinta	k w i n t a
<|ITA|>quirinale	k w i r i n a l e
<|ITA|>ragazza	r a ɡ a t t͡s a
<|ITA|>ragazzi	r a ɡ a t t͡s i
<|ITA|>rai	r a i̯
<|ITA|>rapire	r a p i r e
<|ITA|>reciproco	r e t͡ʃ i p r o k o
<|ITA|>regola	r ɛ ɡ o l a
<|ITA|>relativo	r e l a t i v o
<|ITA|>renato	r e n a t o
<|ITA|>rende	r ɛ n d e
<|ITA|>rendere	r ɛ n d e r e
<|ITA|>rendiconto	r ɛ n d i k o n t o
<|ITA|>resa	r e z a
<|ITA|>responsabilità	r e s p o n s a b i l i t a
<|ITA|>rete	r e t e
<|ITA|>reticolo	r e t i k o l o
<|ITA|>retrocessione	r e t r o t͡ʃ e s s j o n e
<|ITA|>revisione	r e v i z j o n e
<|ITA|>ricchezza	r i k k e t t͡s a
<|ITA|>riferimento	r i f e r i m e n t o
<|ITA|>riforma	r i f o r m a
<|ITA|>rimanere	r i m a n e r e
<|ITA|>rimangono	r i m a n ɡ o n o
<|ITA|>rimasto	r i m a s t o
<|ITA|>rimettere	r i m e t t e r e
<|ITA|>riscossione	r i s k o s s j o n e
<|ITA|>risposta	r i s p o s t a
<|ITA|>risultato	r i z u l t a t o
<|ITA|>ritmo	r i t m o
<|ITA|>riuscito	r i u ʃ ʃ i t o
<|ITA|>roberta	r o b ɛ r t a
<|ITA|>roberto	r o b ɛ r t o
<|ITA|>roma	r o m a
<|ITA|>romano	r o m a n o
<|ITA|>rossa	r o s s a
<|ITA|>rosso	r o s s o
<|ITA|>rotto	r o t t o
<|ITA|>russa	r u s s a
<|ITA|>saggio	s a d d͡ʒ o
<|ITA|>salerno	s a l ɛ r n o
<|ITA|>saltare	s a l t a r e
<|ITA|>salvini	s a l v i n i
<|ITA|>san	s a n
<|ITA|>sanitario	s a n i t a r j o
<|ITA|>sarà	s a r a
<|ITA|>savoia	s a v ɔ j a
<|ITA|>scadenza	s k a d ɛ n t͡s a
<|ITA|>scatola	s k a t o l a
<|ITA|>scegliere	ʃ e ʎ ʎ e r e
<|ITA|>scelta	ʃ e l t a
<|ITA|>scelto	ʃ e l t o
<|ITA|>sciatrice	ʃ a t r i t͡ʃ e
<|ITA|>scienza	ʃ ɛ n t͡s a
<|ITA|>scorso	s k o r s o
<|ITA|>scudetto	s k u d e t t o
<|ITA|>scuola	s k w ɔ l a
<|ITA|>se	s e
<|ITA|>segno	s e ɲ o
<|ITA|>seguire	s e ɡ w i r e
<|ITA|>sembra	s e m b r a
<|ITA|>sento	s ɛ n t o
<|ITA|>sera	s e r a
<|ITA|>serie	s ɛ r j e
<|ITA|>sesto	s ɛ s t o
<|ITA|>settembre	s e t t ɛ m b r e
<|ITA|>settore	s e t t o r e
<|ITA|>sfida	s f i d a
<|ITA|>sfiducia	s f i d u t͡ʃ a
<|ITA|>sfortuna	s f o r t u n a
<|ITA|>sguardo	z ɡ w a r d o
<|ITA|>siamo	s j a m o
<|ITA|>sicilia	s i t͡ʃ i l j a
<|ITA|>sicuramente	s i k u r a m e n t e
<|ITA|>siena	s j ɛ n a
<|ITA|>signore	s i ɲ o r e
<|ITA|>silvia	s u l v j a
<|ITA|>sindaco	s i n d a k o
<|ITA|>sinistro	s i n i s t r o
<|ITA|>sinossi	s i n ɔ s s i
<|ITA|>sociale	s o t͡ʃ a l e
<|ITA|>sofferenza	s o f f e r ɛ n t͡s a
<|ITA|>soglia	s ɔ ʎ ʎ a
<|ITA|>sogna	s o ɲ ɲ a
<|ITA|>sogno	s o ɲ ɲ o
<|ITA|>sole	s o l e
<|ITA|>solo	s o l o
<|ITA|>sopra	s o p r a
<|ITA|>soprattutto	s o p r a t t u t t o
<|ITA|>soprintendenza	s o p r i n t e n d ɛ n t͡s a
<|ITA|>sorreggono	s o r r ɛ ɡ ɡ o n o
<|ITA|>sorriso	s o r r i s o
<|ITA|>sorveglianza	s o r v e ʎ ʎ a n t͡s a
<|ITA|>sostanza	s o s t a n t͡s a
<|ITA|>sostegno	s o s t e ɲ ɲ o
<|ITA|>sostituire	s o s t i t u i r e
<|ITA|>sottotitoli	s o t t o t i t o l i
<|ITA|>sparito	s p a r i t o
<|ITA|>speciale	s p e t͡ʃ a l e
<|ITA|>spendere	s p ɛ n d e r e
<|ITA|>speranza	s p e r a n t͡s a
<|ITA|>spesa	s p e z a
<|ITA|>spesso	s p e s s o
<|ITA|>spettacolo	s p e t t a k o l o
<|ITA|>sportivo	s p o r t i v o
<|ITA|>squadra	s k w a d r a
<|ITA|>sta	s t a
<|ITA|>stabilità	s t a b i l i t a
<|ITA|>stadio	s t a d j o
<|ITA|>stagionale	s t a d͡ʒ o n a l e
<|ITA|>stagione	s t a d͡ʒ o n e
<|ITA|>stampa	s t a m p a
<|ITA|>stanziati	s t a n t͡s j a t i
<|ITA|>stata	s t a t a
<|ITA|>state	s t a t e
<|ITA|>stavo	s t a v o
<|ITA|>stefano	s t e f a n o
<|ITA|>stima	s t i m a
<|ITA|>stipendio	s t i p ɛ n d j o
<|ITA|>stoccolma	s t o k k o l m a
<|ITA|>storica	s t ɔ r i k a
<|ITA|>stradale	s t r a d a l e
<|ITA|>strano	s t r a n o
<|ITA|>struttura	s t r u t t u r a
<|ITA|>studente	s t u d ɛ n t e
<|ITA|>studio	s t u d j o
<|ITA|>sturzo	s t u r t͡s o
<|ITA|>su	s u
<|ITA|>sua	s u a
<|ITA|>successo	s u t t͡ʃ ɛ s s o
<|ITA|>suo	s u o
<|ITA|>superare	s u p e r a r e
<|ITA|>superato	s u p e r a t o
<|ITA|>susanna	s u z a n n a
<|ITA|>sviluppare	z v i l u p p a r e
<|ITA|>svolta	z v ɔ l t a
<|ITA|>sì	s i
<|ITA|>tabacco	t a b a k k o
<|ITA|>tacchi	t a k k i
<|ITA|>taccuino	t a k k u i n o
<|ITA|>talmente	t a l m e n t e
<|ITA|>talpa	t a l p a
<|ITA|>tanto	t a n t o
<|ITA|>tarantino	t a r a n t i n o
<|ITA|>tariffa	t a r i f f a
<|ITA|>teatro	t e a t r o
<|ITA|>tecnica	t ɛ k n i k a
<|ITA|>tecnicamente	t e k n i k a m e n t e
<|ITA|>tecnico	t ɛ k n i k o
<|ITA|>tedesco	t e d e s k o
<|ITA|>tegame	t e ɡ a m e
<|ITA|>temperature	t e m p e r a t u r e
<|ITA|>tempo	t ɛ m p o
<|ITA|>termine	t ɛ r m i n e
<|ITA|>terra	t ɛ r r a
<|ITA|>terreno	t e r r e n o
<|ITA|>terrestre	t e r r ɛ s t r e
<|ITA|>territorio	t e r r i t ɔ r j o
<|ITA|>terzo	t ɛ r t͡s o
<|ITA|>tesi	t ɛ z i
<|ITA|>testa	t ɛ s t a
<|ITA|>testamento	t e s t a m e n t o
<|ITA|>ti	t i
<|ITA|>tipicamente	t i p i k a m e n t e
<|ITA|>tipo	t i p o
<|ITA|>titoli	t i t o l i
<|ITA|>tokyo	t ɔ k j o
<|ITA|>tornare	t o r n a r e
<|ITA|>tradizionale	t r a d i t t͡s j o n a l e
<|ITA|>tramite	t r a m i t e
<|ITA|>tranquillo	t r a n k w i l l o
<|ITA|>trattamento	t r a t t a m e n t o
<|ITA|>tre	t r e
<|ITA|>tregua	t r ɛ ɡ w a
<|ITA|>treno	t r ɛ n o
<|ITA|>treviso	t r e v i z o
<|ITA|>tridente	t r i d ɛ n t e
<|ITA|>trimestre	t r i m ɛ s t r e
<|ITA|>tromba	t r o m b a
<|ITA|>trova	t r o v a
<|ITA|>turchia	t u r k i a
<|ITA|>tutte	t u t t e
<|ITA|>tutti	t u t t i
<|ITA|>tutto	t u t t o
<|ITA|>tv	t i v u
<|ITA|>udine	u d i n e
<|ITA|>ufficialmente	u f f i t ʃ a l m e n t e
<|ITA|>ulteriore	u l t e r j o r e
<|ITA|>ulteriormente	u l t e r j o r m e n t e
<|ITA|>ultimi	u l t i m i
<|ITA|>umbria	u m b r j a
<|ITA|>umore	u m o r e
<|ITA|>uninominali	u n i n o m i n a l i
<|ITA|>unisce	u n i ʃ ʃ e
<|ITA|>unità	u n i t a
<|ITA|>urina	u r i n a
<|ITA|>usa	u z a
<|ITA|>usare	u z a r e
<|ITA|>uscire	u ʃ ʃ i r e
<|ITA|>uscito	u ʃ ʃ i t o
<|ITA|>utile	u t i l e
<|ITA|>valanga	v a l a n ɡ a
<|ITA|>valere	v a l e r e
<|ITA|>vanno	v a n n o
<|ITA|>vano	v a n o
<|ITA|>vantaggio	v a n t a d d͡ʒ o
<|ITA|>variazione	v a r j a t t͡s j o n e
<|ITA|>ventimiglia	v e n t i m i ʎ ʎ a
<|ITA|>vera	v e r a
<|ITA|>verde	v e r d e
<|ITA|>verdure	v e r d u r e
<|ITA|>vero	v e r o
<|ITA|>versante	v e r s a n t e
<|ITA|>verso	v ɛ r s o
<|ITA|>vettura	v e t t u r a
<|ITA|>vi	v i
<|ITA|>via	v i a
<|ITA|>viaggio	v i a d d͡ʒ o
<|ITA|>vicina	v i t͡ʃ i n a
<|ITA|>vicine	v i t͡ʃ i n e
<|ITA|>video	v i d e o
<|ITA|>viene	v j ɛ n e
<|ITA|>vigente	v i d͡ʒ ɛ n t e
<|ITA|>vigile	v i d͡ʒ i l e
<|ITA|>villa	v i l l a
<|ITA|>vincere	v i n t ʃ e r e
<|ITA|>viste	v i s t e
<|ITA|>vive	v i v e
<|ITA|>vivere	v i v e r e
<|ITA|>vivo	v i v o
<|ITA|>voce	v o t͡ʃ e
<|ITA|>voglia	v ɔ ʎ ʎ a
<|ITA|>voler	v o l e r
<|ITA|>volontà	v o l o n t a
<|ITA|>volutamente	v o l u t a m e n t e
<|ITA|>vorrebbe	v o r r ɛ b b e
<|ITA|>vorrei	v o r r e j
<|ITA|>vostro	v ɔ s t r o
<|ITA|>votare	v o t a r e
<|ITA|>web	w ɛ b
<|ITA|>whisky	w i s k i
<|ITA|>york	j ɔ r k
<|ITA|>zanetti	d͡z a n e t t i
<|ITA|>zero	d͡z ɛ r o
<|ITA|>zona	d͡z ɔ n a
<|ITA|>épagneul	e p a ɲ ɲ ɔ l
<|ITA|>étoile	e t w a l
<|MLT|>abjad	a b j a t
<|MLT|>abraham	a b r aː m
<|MLT|>adam	a d aː m
<|MLT|>adorazzjoni	a d ɔ r a t t͡s j ɔː n ɪ
<|MLT|>aktar	a k t a r
<|MLT|>aktarx	a k t a r ʃ
<|MLT|>attiv	ɐ tː iː f
<|MLT|>attività	ɐ tː ɪ v ɪ t a
<|MLT|>awstralja	a w s t r aː l j a
<|MLT|>azzjoni	a t t͡s j ɔː n ɪ
<|MLT|>azzjonijiet	a t t͡s j ɔ n ɪ j ɪː t
<|MLT|>aħbar	a ħ b aː r
<|MLT|>aħbarijiet	a ħ b a r ɪ j ɪː t
<|MLT|>aħjar	a ħ j aː r
<|MLT|>aħna	ɐ ħ n ɐ
<|MLT|>aħwa	a ħ w a
<|MLT|>bagħat	b aː t
<|MLT|>bajd	b a j t
<|MLT|>bajda	b a j d a
<|MLT|>ballun	b a l l uː n
<|MLT|>bandiera	b ɐ n d ɪː r ɐ
<|MLT|>baqgħet	b a ʔ a t
<|MLT|>baqgħu	b a ʔ a w
<|MLT|>barka	b a r k a
<|MLT|>barra	b a r r a
<|MLT|>barrani	b a r r aː n ɪ
<|MLT|>bata	b aː t a
<|MLT|>batta	b a t t a
<|MLT|>baġit	b a d͡ʒ ɪ t
<|MLT|>bdiewa	b d ɪː w a
<|MLT|>bejgħ	b ɛ j ħ
<|MLT|>bejjiegħa	b ɛ j j ɪː j a
<|MLT|>bejn	b ɛ j n
<|MLT|>belt	b ɛ l t
<|MLT|>belti	b ɛ l t ɪ
<|MLT|>bena	b ɛ n a
<|MLT|>bidla	b ɪ d l a
<|MLT|>bieb	b ɪː p
<|MLT|>biegħ	b ɪː ħ
<|MLT|>biex	b ɪː ʃ
<|MLT|>bih	b ɪː ħ
<|MLT|>biha	b ɪː j a
<|MLT|>bihom	b ɪː j ɔ m
<|MLT|>bija	b iː j a
<|MLT|>bik	b iː k
<|MLT|>bina	b iː n a
<|MLT|>bini	b ɪ n ɪ
<|MLT|>bint	b ɪ n t
<|MLT|>biżżejjed	b ɪ z z ɛ j j ɛ t
<|MLT|>bla	b l aː
<|MLT|>blu	b l uː
<|MLT|>bniet	b n ɪː t
<|MLT|>bogħod	b ɔː t
<|MLT|>borma	b ɔ r m a
<|MLT|>borġ	b ɔ r t͡ʃ
<|MLT|>bosta	b ɔ s t a
<|MLT|>bħal	p ħ aː l
<|MLT|>bħalma	p ħ aː l m a
<|MLT|>bżonn	b z ɔ n n
<|MLT|>dagħbien	d a b ɪː n
<|MLT|>dam	d aː m
<|MLT|>daqq	d a ʔ
<|MLT|>daqs	d a ʔ s
<|MLT|>daqsxejn	d a ʔ s ʃ ɛ j n
<|MLT|>darba	d a r b a
<|MLT|>darbtejn	d a r p t ɛ j n
<|MLT|>dawl	d a w l
<|MLT|>dawn	d a w n
<|MLT|>dawra	d ɐ w r ɐ
<|MLT|>daħal	d a ħ a l
<|MLT|>daħka	d a ħ k a
<|MLT|>debba	d ɛ bː ɐ
<|MLT|>dehra	d ɛː r a
<|MLT|>dejjaq	d ɛ j j a ʔ
<|MLT|>dejjem	d ɛ j j ɛ m
<|MLT|>demgħa	d ɛ m a
<|MLT|>demm	d ɛ m m
<|MLT|>demokrazija	d ɛ m ɔ k r a t͡s iː j a
<|MLT|>deċiż	d ɛ t͡ʃ iː s
<|MLT|>deċiżjoni	d ɛ t͡ʃ ɪ z j ɔː n ɪ
<|MLT|>dgħajjef	d a j j ɛ f
<|MLT|>dgħajsa	d a j s a
<|MLT|>diffiċli	d ɪ f f iː t͡ʃ l ɪ
<|MLT|>difiża	d ɪ f iː z a
<|MLT|>din	d iː n
<|MLT|>dineb	d ɪ n ɛ p
<|MLT|>dinja	d ɪ n j ɐ
<|MLT|>direzzjoni	d ɪ r ɛ t t͡s j ɔː n ɪ
<|MLT|>disgħa	d ɪ s a
<|MLT|>disgħin	d ɪ s a j n
<|MLT|>djar	d j aː r
<|MLT|>dlam	d l aː m
<|MLT|>dmugħ	d m uː ħ
<|MLT|>dnub	d n uː p
<|MLT|>drabi	d r aː b ɪ
<|MLT|>drapp	d r a p
<|MLT|>dritt	d r ɪ t
<|MLT|>drittijiet	d r ɪ t t ɪ j ɪː t
<|MLT|>ebda	ɛ b d a
<|MLT|>edizzjoni	ɛ d ɪ t t͡s j ɔː n ɪ
<|MLT|>ejja	ɛ j j a
<|MLT|>emmen	ɛ m m ɛ n
<|MLT|>emozzjonali	ɛ m ɔ tː s j ɔ n aː l ɪ
<|MLT|>enerġija	ɛ n ɛ r d͡ʒ iː j a
<|MLT|>erbgħa	ɛ r b a
<|MLT|>erbgħin	ɛ r b ɛ j n
<|MLT|>esperjenza	ɛ s p ɛ r j ɛ n t͡s a
<|MLT|>espressjoni	ɛ s p r ɛ sː j ɔː n ɪ
<|MLT|>essenzjali	ɛ sː ɛ n t s j aː l ɪ
<|MLT|>essenzjalment	ɛ sː ɛ n t s j ɐ l m ɛ n t
<|MLT|>ewwel	ɛ w w ɛ l
<|MLT|>eċċezzjoni	ɛ tː ʃ ɛ tː s j ɔː n ɪ
<|MLT|>eżami	ɛ z aː m ɪ
<|MLT|>eżatt	ɛ z a t
<|MLT|>eżempji	ɛ z ɛ m p j ɪ
<|MLT|>fadal	f a d a l
<|MLT|>far	f aː r
<|MLT|>faċli	f aː t͡ʃ l ɪ
<|MLT|>faħħar	f a ħ ħ a r
<|MLT|>fehem	f ɛː m
<|MLT|>fejda	f ɛ j d a
<|MLT|>felaħ	f ɛ l a ħ
<|MLT|>ferħ	f ɛ r ħ
<|MLT|>fetaħ	f ɛ t a ħ
<|MLT|>fiha	f ɪː j a
<|MLT|>fihom	f ɪː j ɔ m
<|MLT|>fik	f iː k
<|MLT|>fil	f iː l
<|MLT|>filgħaxija	f ɪ l a ʃ iː j a
<|MLT|>filgħaxijiet	f ɪ l a ʃ ɪ j ɪː t
<|MLT|>fina	f iː n a
<|MLT|>fisser	f ɪ s s ɛ r
<|MLT|>fittex	f ɪ t t ɛ ʃ
<|MLT|>fliexken	f l ɪː ʃ k ɛ n
<|MLT|>flixkun	f l ɪ ʃ k uː n
<|MLT|>flok	f l ɔː k
<|MLT|>flus	f l uː s
<|MLT|>fniek	f n ɪː k
<|MLT|>folla	f ɔ l l a
<|MLT|>fomm	f ɔ m m
<|MLT|>forma	f ɔ r m a
<|MLT|>forsi	f ɔ r s ɪ
<|MLT|>fost	f ɔ s t
<|MLT|>frott	f r ɔ tː
<|MLT|>ftakar	f t a k a r
<|MLT|>ftit	f t iː t
<|MLT|>fuq	f uː ʔ
<|MLT|>gawda	ɡ a w d a
<|MLT|>gideb	ɡ ɪ d ɛ p
<|MLT|>gwerra	ɡ w ɛ r r a
<|MLT|>għada	aː d a
<|MLT|>għadd	aː t
<|MLT|>għadda	aː d d a
<|MLT|>għafas	aː f a s
<|MLT|>għajb	a j p
<|MLT|>għajn	a j n
<|MLT|>għajnuna	a j n uː n a
<|MLT|>għalaq	aː l a ʔ
<|MLT|>għaldaqstant	a l d a ʔ s t a n t
<|MLT|>għalhekk	a l ɛː k
<|MLT|>għalja	aː l j a
<|MLT|>għalliem	a l l ɪː m
<|MLT|>għalqa	aː l ʔ a
<|MLT|>għammieq	a m m ɪː ʔ
<|MLT|>għana	aː n a
<|MLT|>għand	aː n t
<|MLT|>għandek	aː n d ɛ k
<|MLT|>għandha	aː n d a
<|MLT|>għandhom	aː n d ɔ m
<|MLT|>għandi	aː n d ɪ
<|MLT|>għandkom	aː n t k ɔ m
<|MLT|>għandna	aː n n a
<|MLT|>għani	aː n ɪ
<|MLT|>għaqda	aː ʔ d a
<|MLT|>għaqdiet	a ʔ d ɪː t
<|MLT|>għaqli	aː ʔ l ɪ
<|MLT|>għaqlija	a ʔ l iː j a
<|MLT|>għaqlin	a ʔ l iː n
<|MLT|>għaraf	aː r a f
<|MLT|>għarajjes	a r a j j ɛ s
<|MLT|>għarfien	a r f ɪː n
<|MLT|>għasar	aː s a r
<|MLT|>għasfur	a s f uː r
<|MLT|>għatxana	a t t͡ʃ aː n a
<|MLT|>għawdex	a w d ɛ ʃ
<|MLT|>għawdxija	a w t͡ʃ iː j a
<|MLT|>għawdxin	a w t͡ʃ iː n
<|MLT|>għawma	a w m a
<|MLT|>għax	aː ʃ
<|MLT|>għaxar	aː ʃ a r
<|MLT|>għażel	aː z ɛ l
<|MLT|>għażiż	a z iː s
<|MLT|>għażla	aː z l a
<|MLT|>għelieqi	ɛ l ɪː ʔ ɪ
<|MLT|>għen	ɛː n
<|MLT|>għex	ɛː ʃ
<|MLT|>għid	ɛ j t
<|MLT|>għodod	ɔː d ɔ t
<|MLT|>għola	ɔː l a
<|MLT|>għolja	ɔː l j a
<|MLT|>għoljin	ɔ l j iː n
<|MLT|>gżejjer	ɡ z ɛ jː ɛ r
<|MLT|>gżira	ɡ z iː r a
<|MLT|>hawn	a w n
<|MLT|>hemm	ɛ m m
<|MLT|>hemmhekk	ɛ m m ɛː k
<|MLT|>hena	ɛː n a
<|MLT|>hewden	ɛ w d ɛ n
<|MLT|>hieni	ħ ɪː n ɪ
<|MLT|>hienja	ħ ɪː n j a
<|MLT|>hija	iː j ɐ
<|MLT|>hinn	ɪ n n
<|MLT|>huma	uː m ɐ
<|MLT|>huwa	uː w ɐ
<|MLT|>iben	ɪ b ɛ n
<|MLT|>iblah	ɪ b l a ħ
<|MLT|>id	iː t
<|MLT|>iebes	ɪː b ɛ s
<|MLT|>iebsa	ɪː p s a
<|MLT|>ieħor	ɪː ħ ɔ r
<|MLT|>ikel	ɪ k ɛ l
<|MLT|>ikrah	ɪ k r a ħ
<|MLT|>illum	ɪ l l uː m
<|MLT|>ilma	ɪ l m a
<|MLT|>ilsna	ɪ l s n ɐ
<|MLT|>imbagħad	ɪ m b aː t
<|MLT|>impjieg	ɪ m p j ɪː k
<|MLT|>impressjoni	ɪ m p r ɛ s s j ɔː n ɪ
<|MLT|>impressjonijiet	ɪ m p r ɛ s s j ɔ n ɪ j ɪː t
<|MLT|>imħabba	ɪ m ħ a b b a
<|MLT|>inbid	ɪ m b iː t
<|MLT|>indika	ɪ n d iː k ɐ
<|MLT|>indikazzjoni	ɪ n d ɪ k a t t͡s j ɔː n ɪ
<|MLT|>indipendenti	ɪ n d ɪ p ɛ n d ɛ n t ɪ
<|MLT|>indiċi	ɪ n d iː t͡ʃ ɪ
<|MLT|>infern	ɪ n f ɛ r n
<|MLT|>infezzjoni	ɪ n f ɛ t t͡s j ɔː n ɪ
<|MLT|>ingliż	ɪ n ɡ l iː s
<|MLT|>inibizzjoni	ɪ n ɪ b ɪ tː s j ɔː n ɪ
<|MLT|>inkella	ɪ n k ɛ l l a
<|MLT|>int	ɪ n t
<|MLT|>internazzjonali	ɪ n t ɛ r n a t t͡s j ɔ n aː l ɪ
<|MLT|>inti	ɪ n t ɪ
<|MLT|>intom	ɪ n t ɔ m
<|MLT|>ipprova	ɪ p p r ɔː v a
<|MLT|>irjieħ	ɪ r j ɪː ħ
<|MLT|>irrisponda	ɪ r r ɪ s p ɔ n d a
<|MLT|>isem	ɪ s ɛ m
<|MLT|>isfar	ɪ s f ɐ r
<|MLT|>isfel	ɪ s f ɛ l
<|MLT|>issa	ɪ s s a
<|MLT|>issieħeb	ɪ s s ɪː ħ ɛ p
<|MLT|>istess	ɪ s t ɛ sː
<|MLT|>itfal	ɪ t f aː l
<|MLT|>ittra	ɪ t t r a
<|MLT|>itwal	ɪ t w a l
<|MLT|>iva	iː v a
<|MLT|>iżjed	ɪ z j ɛ t
<|MLT|>jaf	j aː f
<|MLT|>jagħlaq	j aː l a ʔ
<|MLT|>jagħti	j aː t ɪ
<|MLT|>jagħżel	j aː z ɛ l
<|MLT|>jalla	j a l l a
<|MLT|>jannar	j ɐ n n ɐː r
<|MLT|>jaqbad	j a ʔ b a t
<|MLT|>jaqra	j a ʔ r a
<|MLT|>jara	j aː r a
<|MLT|>jekk	j ɛ kː
<|MLT|>jew	j ɛ w
<|MLT|>jgħallem	j aː l l ɛ m
<|MLT|>jgħid	j ɛ j t
<|MLT|>jgħin	j a j n
<|MLT|>jgħix	j ɛ j ʃ
<|MLT|>jgħodd	j ɔː t
<|MLT|>jgħożż	j ɔː s
<|MLT|>jhedded	j ɛː d d ɛ t
<|MLT|>jibgħat	j ɪ b a t
<|MLT|>jidher	j ɪ d ɛ r
<|MLT|>jiekol	j ɪː k ɔ l
<|MLT|>jiem	j ɪː m
<|MLT|>jien	j ɪː n
<|MLT|>jiena	j ɪː n ɐ
<|MLT|>jifhem	j ɪ f ɛ m
<|MLT|>jilgħab	j ɪ l a p
<|MLT|>jingħata	j ɪ n aː t a
<|MLT|>jinsa	j ɪ n s a
<|MLT|>jisimgħu	j ɪ s ɪ m ɔ w
<|MLT|>jistgħu	j ɪ s t ɔ w
<|MLT|>jitgħallem	j ɪ t aː l l ɛ m
<|MLT|>jixgħel	j ɪ ʃ a l
<|MLT|>jixhed	j ɪ ʃ ɛ t
<|MLT|>jiġifieri	j ɪ d͡ʒ ɪ f ɪː r ɪ
<|MLT|>jogħxa	j ɔː ʃ a
<|MLT|>joqgħod	j ɔ ʔ ɔ t
<|MLT|>jsib	j s iː p
<|MLT|>juri	j uː r ɪ
<|MLT|>jħobb	j ħ ɔ p
<|MLT|>kafè	k a f ɛː
<|MLT|>kamra	k a m r a
<|MLT|>kanta	k a n t a
<|MLT|>kapaċità	k ɐ p ɐ t ʃ ɪ t a
<|MLT|>kbar	ɡ b aː r
<|MLT|>kbir	ɡ b iː r
<|MLT|>kburi	ɡ b uː r ɪ
<|MLT|>keffa	k ɛ f f a
<|MLT|>kelb	k ɛ l p
<|MLT|>kelba	k ɛ l b ɐ
<|MLT|>kelma	k ɛ l m a
<|MLT|>kelmiet	k ɛ l m ɪː t
<|MLT|>kenn	k ɛ n
<|MLT|>kerha	k ɛ r a
<|MLT|>kiber	k ɪ b ɛ r
<|MLT|>kiefer	k ɪː f ɛ r
<|MLT|>kiel	k ɪː l
<|MLT|>kiesaħ	k ɪː s a ħ
<|MLT|>kisser	k ɪ s s ɛ r
<|MLT|>kiteb	k ɪ t ɛ p
<|MLT|>kittieb	k ɪ t t ɪː p
<|MLT|>kixef	k ɪ ʃ ɛ f
<|MLT|>klabb	k l a p
<|MLT|>kliem	k l ɪː m
<|MLT|>kmamar	k m aː m a r
<|MLT|>kmieni	k m ɪː n ɪ
<|MLT|>knejjes	k n ɛ j j ɛ s
<|MLT|>knisja	k n iː s j a
<|MLT|>kollezzjoni	k ɔ lː ɛ tː s j ɔː n ɪ
<|MLT|>kollha	k ɔ l l a
<|MLT|>kollhom	k ɔ l l ɔ m
<|MLT|>kollox	k ɔ l l ɔ ʃ
<|MLT|>kontra	k ɔ n t r a
<|MLT|>koppja	k ɔ p p j a
<|MLT|>kotba	k ɔ d b a
<|MLT|>kotra	k ɔ t r a
<|MLT|>ktejjeb	k t ɛ j j ɛ p
<|MLT|>ktieb	k t ɪː p
<|MLT|>kwistjoni	k w ɪ s t j ɔː n ɪ
<|MLT|>la	l aː
<|MLT|>lagħab	l aː p
<|MLT|>lanqas	l a n ʔ a s
<|MLT|>laqat	l a ʔ a t
<|MLT|>laqgħa	l a ʔ a
<|MLT|>laqgħat	l a ʔ aː t
<|MLT|>latin	l ɐ t iː n
<|MLT|>le	l ɛː
<|MLT|>lejl	l ɛ j l
<|MLT|>lejla	l ɛ j l ɐ
<|MLT|>lemin	l ɛ m iː n
<|MLT|>lesta	l ɛ s t a
<|MLT|>lewn	l ɛ w n
<|MLT|>leħen	l ɛ ħ ɛ n
<|MLT|>lgħabt	l a p t
<|MLT|>lhud	l uː t
<|MLT|>libertà	l ɪ b ɛ r t aː
<|MLT|>libsa	l ɪ p s a
<|MLT|>liema	l ɪː m a
<|MLT|>lingwa	l ɪ n ɡ w ɐ
<|MLT|>liġi	l iː d͡ʒ ɪ
<|MLT|>lpup	l p uː p
<|MLT|>lsien	l s ɪː n
<|MLT|>ma	m aː
<|MLT|>magħha	m a ħ ħ a
<|MLT|>magħhom	m a ħ ħ ɔ m
<|MLT|>magħkom	m aː k ɔ m
<|MLT|>magħmul	m a m uː l
<|MLT|>magħna	m aː n a
<|MLT|>magħqud	m a ʔ uː t
<|MLT|>magħruf	m a r uː f
<|MLT|>malajr	m a l a j r
<|MLT|>malti	m ɐ l t ɪ
<|MLT|>maltija	m ɐ l t iː j ɐ
<|MLT|>maltin	m ɐ l t iː n
<|MLT|>maqtugħ	m a ʔ t uː ħ
<|MLT|>maqtugħa	m a ʔ t uː w a
<|MLT|>mara	m a r a
<|MLT|>mard	m a r t
<|MLT|>marsaxlokk	m a r s a ʃ l ɔ k
<|MLT|>mart	m a r t
<|MLT|>maxtura	m a ʃ t uː r a
<|MLT|>maħbub	m a ħ b uː p
<|MLT|>mbagħad	m b aː t
<|MLT|>mejjet	m ɛ j j ɛ t
<|MLT|>mejta	m ɛ j t a
<|MLT|>mela	m ɛ l a
<|MLT|>merħba	m ɛ r ħ b ɐ
<|MLT|>mess	m ɛ s
<|MLT|>meta	m ɛ t a
<|MLT|>mewt	m ɛ w t
<|MLT|>mexa	m ɛ ʃ a
<|MLT|>mgħallem	m aː l l ɛ m
<|MLT|>mgħallma	m aː l l m a
<|MLT|>mhedda	m ɛː d d a
<|MLT|>mhux	m uː ʃ
<|MLT|>mibegħda	m ɪ b ɛː d a
<|MLT|>mibjugħ	m ɪ b j uː ħ
<|MLT|>miegħek	m ɪː j a k
<|MLT|>miegħu	m ɪː j ɔ w
<|MLT|>miet	m ɪː t
<|MLT|>mifhum	m ɪ f uː m
<|MLT|>miftuħa	m ɪ f t uː ħ a
<|MLT|>mija	m iː j a
<|MLT|>milied	m ɪ l ɪː t
<|MLT|>minna	m ɪ n n a
<|MLT|>minnek	m ɪ n n ɛ k
<|MLT|>minnha	m ɪ n n a
<|MLT|>minnhom	m ɪ n n ɔ m
<|MLT|>minni	m ɪ n n ɪ
<|MLT|>minnkom	m ɪ n k ɔ m
<|MLT|>mistennija	m ɪ s t ɛ n n iː j a
<|MLT|>mistieden	m ɪ s t ɪː d ɛ n
<|MLT|>mistoqsija	m ɪ s t ɔ ʔ s iː j a
<|MLT|>mistoqsijiet	m ɪ s t ɔ ʔ s ɪ j ɪː t
<|MLT|>mitfugħ	m ɪ t f uː ħ
<|MLT|>mitt	m ɪ t
<|MLT|>miżżewweġ	m ɪ z z ɛ w w ɛ t͡ʃ
<|MLT|>miżżewġa	m ɪ z z ɛ w d͡ʒ a
<|MLT|>miżżewġin	m ɪ z z ɛ w d͡ʒ iː n
<|MLT|>mkien	m k ɪː n
<|MLT|>mogħdija	m ɔ d iː j a
<|MLT|>mogħti	m ɔː t ɪ
<|MLT|>mqaddes	m ʔ a d d ɛ s
<|MLT|>mħabba	m ħ a b b a
<|MLT|>nar	n aː r
<|MLT|>navigazzjoni	n a v ɪ ɡ a t t͡s j ɔː n ɪ
<|MLT|>nazzjonali	n a t t͡s j ɔ n aː l ɪ
<|MLT|>nazzjonalist	n a t t͡s j ɔ n a l ɪ s t
<|MLT|>naħa	n a ħ a
<|MLT|>naħat	n a ħ aː t
<|MLT|>nbena	m b ɛ n a
<|MLT|>nesa	n ɛ s a
<|MLT|>ngħata	n aː t a
<|MLT|>nhar	n aː r
<|MLT|>nieda	n ɪː d a
<|MLT|>niedi	n ɪː d ɪ
<|MLT|>nieqes	n ɪː ʔ ɛ s
<|MLT|>nies	n ɪː s
<|MLT|>niexef	n ɪː ʃ ɛ f
<|MLT|>nifs	n ɪ f s
<|MLT|>nisa	n ɪ s a
<|MLT|>nisel	n ɪ s ɛ l
<|MLT|>nisrani	n ɪ s r aː n ɪ
<|MLT|>niżbogħ	n ɪ z b ɔ ħ
<|MLT|>niżel	n ɪ z ɛ l
<|MLT|>nkiteb	n k ɪ t ɛ p
<|MLT|>nofs	n ɔ f s
<|MLT|>nofsinhar	n ɔ f s ɪ n aː r
<|MLT|>nsara	n s aː r a
<|MLT|>ntefa	n t ɛ f a
<|MLT|>obda	ɔ b d a
<|MLT|>omm	ɔ mː
<|MLT|>omosesswali	ɔ m ɔ s ɛ s s w aː l ɪ
<|MLT|>opinjoni	ɔ p ɪ n j ɔː n ɪ
<|MLT|>ordna	ɔ r d n a
<|MLT|>oħla	ɔ ħ l a
<|MLT|>oħra	ɔ ħ r a
<|MLT|>oħrajn	ɔ ħ r a j n
<|MLT|>oħt	ɔ ħ t
<|MLT|>pajjiż	p a j j iː s
<|MLT|>parteċipazzjoni	p a r t ɛ t͡ʃ ɪ p a t t͡s j ɔː n ɪ
<|MLT|>passjoni	p ɐ sː j ɔː n ɪ
<|MLT|>patt	p a t
<|MLT|>paġna	p aː d͡ʒ n a
<|MLT|>pinġa	p ɪ n d͡ʒ a
<|MLT|>pitter	p ɪ t t ɛ r
<|MLT|>politika	p ɔ l iː t ɪ k a
<|MLT|>popli	p ɔ p l ɪ
<|MLT|>possibbli	p ɔ s s ɪ b b l ɪ
<|MLT|>povertà	p ɔ v ɛ r t aː
<|MLT|>pożizzjoni	p ɔ z ɪ tː s j ɔː n ɪ
<|MLT|>pparteċipa	p p a r t ɛ t͡ʃ iː p a
<|MLT|>pprova	ɪ p p r ɔː v a
<|MLT|>promozzjoni	p r ɔ m ɔ t t͡s j ɔː n ɪ
<|MLT|>protezzjoni	p r ɔ t ɛ t t͡s j ɔː n ɪ
<|MLT|>qabad	ʔ a b a t
<|MLT|>qabel	ʔ a b ɛ l
<|MLT|>qabilha	ʔ a b ɪ l a
<|MLT|>qabża	ʔ a b z a
<|MLT|>qadim	ʔ a d iː m
<|MLT|>qagħad	ʔ aː t
<|MLT|>qal	ʔ aː l
<|MLT|>qalb	ʔ a l p
<|MLT|>qam	ʔ aː m
<|MLT|>qarben	ʔ a r b ɛ n
<|MLT|>qares	ʔ aː r ɛ s
<|MLT|>qarib	ʔ a r iː p
<|MLT|>qarraq	ʔ a r r a ʔ
<|MLT|>qasir	ʔ a s iː r
<|MLT|>qassis	ʔ a s s iː s
<|MLT|>qatgħa	ʔ a t a
<|MLT|>qatigħ	ʔ a t iː ħ
<|MLT|>qatra	ʔ a t r a
<|MLT|>qawmien	ʔ a w m ɪː n
<|MLT|>qawwa	ʔ a w w a
<|MLT|>qawwi	ʔ a w w ɪ
<|MLT|>qed	ʔ ɛː t
<|MLT|>qeda	ʔ ɛ d a
<|MLT|>qegħdin	ʔ ɛ d iː n
<|MLT|>qiegħed	ʔ ɛː t
<|MLT|>qima	ʔ iː m a
<|MLT|>qliel	ʔ l ɪː l
<|MLT|>qorti	ʔ ɔ r t ɪ
<|MLT|>ra	r aː
<|MLT|>rabba	r a b b a
<|MLT|>randan	r a n d aː n
<|MLT|>ras	r aː s
<|MLT|>raħal	r a ħ a l
<|MLT|>raħħal	r a ħ ħ aː l
<|MLT|>re	r ɛː
<|MLT|>rebaħ	r ɛ b a ħ
<|MLT|>rebbieħ	r ɛ b b ɪː ħ
<|MLT|>rebħa	r ɛ p ħ a
<|MLT|>relazzjonijiet	r ɛ l a t t͡s j ɔ n ɪ j ɪː t
<|MLT|>resaq	r ɛ s a ʔ
<|MLT|>ried	r ɪː t
<|MLT|>rikk	r ɪ k
<|MLT|>rispett	r ɪ s p ɛ t
<|MLT|>risposta	r ɪ s p ɔ s t a
<|MLT|>risq	r ɪ s ʔ
<|MLT|>rix	r iː ʃ
<|MLT|>rjus	r j uː s
<|MLT|>rokna	r ɔ k n ɐ
<|MLT|>rqaq	r ʔ aː ʔ
<|MLT|>rringrazzja	ɪ r r ɪ n ɡ r a t t͡s j a
<|MLT|>ruħ	r uː ħ
<|MLT|>rwol	r w ɔː l
<|MLT|>rċieva	r t͡ʃ ɪː v a
<|MLT|>rħam	r ħ aː m
<|MLT|>rħula	r ħ uː l a
<|MLT|>sa	s a
<|MLT|>sab	s aː p
<|MLT|>sabar	s a b a r
<|MLT|>sabiħ	s a b ɪː ħ
<|MLT|>sabiħa	s a b ɪː ħ a
<|MLT|>safi	s aː f ɪ
<|MLT|>sahra	s aː r a
<|MLT|>sajd	s a j t
<|MLT|>sajf	s a j f
<|MLT|>sajran	s a j r aː n
<|MLT|>salib	s a l iː p
<|MLT|>saltna	s a l t n a
<|MLT|>salva	s a l v a
<|MLT|>salvaġġa	s a l v a d d͡ʒ a
<|MLT|>sapun	s a p uː n
<|MLT|>saqaf	s a ʔ a f
<|MLT|>sar	s aː r
<|MLT|>saċerdot	s a t͡ʃ ɛ r d ɔː t
<|MLT|>saħan	s a ħ a n
<|MLT|>sbieħ	z b ɪː ħ
<|MLT|>se	s ɛ
<|MLT|>sebgħa	s ɛ b a
<|MLT|>sehem	s ɛː m
<|MLT|>sejjaħ	s ɛ j j a ħ
<|MLT|>sejjer	s ɛ j j ɛ r
<|MLT|>sejħa	s ɛ j ħ a
<|MLT|>sema	s ɛ m a
<|MLT|>sena	s ɛ n a
<|MLT|>sengħa	s ɛ n a
<|MLT|>seqer	s ɛ ʔ ɛ r
<|MLT|>serp	s ɛ r p
<|MLT|>sess	s ɛ sː
<|MLT|>sewwa	s ɛ w w a
<|MLT|>seħħ	s ɛ ħ
<|MLT|>sforza	s f ɔ r t͡s a
<|MLT|>sibt	s ɪ p t
<|MLT|>sidna	s iː d n a
<|MLT|>siegħa	s ɪː j a
<|MLT|>sieq	s ɪː ʔ
<|MLT|>sieħeb	s ɪː ħ ɛ p
<|MLT|>sigriet	s ɪ ɡ r ɪː t
<|MLT|>sikkina	s ɪ k k iː n a
<|MLT|>sinna	s ɪ n n a
<|MLT|>sistema	s ɪ s t ɛː m ɐ
<|MLT|>sistematikament	s ɪ s t ɛ m ɐ t ɪ k ɐ m ɛ n t
<|MLT|>sitt	s ɪ t
<|MLT|>sitta	s ɪ t t a
<|MLT|>sittax	s ɪ t t aː ʃ
<|MLT|>sittin	s ɪ t t iː n
<|MLT|>sitwazzjoni	s ɪ t w a t t͡s j ɔː n ɪ
<|MLT|>siġra	s ɪ d͡ʒ r a
<|MLT|>skejjel	s k ɛ j j ɛ l
<|MLT|>skiet	s k ɪː t
<|MLT|>skola	s k ɔː l a
<|MLT|>smajt	s m a j t
<|MLT|>smigħ	s m ɪː ħ
<|MLT|>sorm	s ɔ r m
<|MLT|>soċjetà	s ɔ t͡ʃ j ɛ t a
<|MLT|>spalla	s p a l l a
<|MLT|>speċifikament	s p ɛ t ʃ ɪ f ɪ k ɐ m ɛ n t
<|MLT|>sqallija	s ʔ a l l iː j a
<|MLT|>stampa	s t a m p a
<|MLT|>staqsa	s t a ʔ s a
<|MLT|>stat	s t aː t
<|MLT|>stazzjon	s t a t t͡s j ɔː n
<|MLT|>stedina	s t ɛ d iː n a
<|MLT|>stess	s t ɛ s
<|MLT|>stieden	s t ɪː d ɛ n
<|MLT|>stilla	s t ɪ l l a
<|MLT|>storja	s t ɔː r j a
<|MLT|>suq	s uː ʔ
<|MLT|>sur	s uː r
<|MLT|>svediż	z v ɛ d iː s
<|MLT|>swied	s w ɪː t
<|MLT|>swieq	s w ɪː ʔ
<|MLT|>sħab	s ħ aː p
<|MLT|>sħana	s ħ aː n ɐ
<|MLT|>sħiħ	s ħ ɪː ħ
<|MLT|>ta	t aː
<|MLT|>tabib	t a b iː p
<|MLT|>tabilħaqq	t a b ɪ l ħ a ʔ
<|MLT|>tagħha	t a ħ ħ a
<|MLT|>tagħhom	t a ħ ħ ɔ m
<|MLT|>tagħkom	t aː k ɔ m
<|MLT|>tagħlim	t a l iː m
<|MLT|>tagħlima	t a l iː m a
<|MLT|>tagħna	t aː n a
<|MLT|>tagħrif	t a r iː f
<|MLT|>tajba	t a j b a
<|MLT|>tajt	t a j t
<|MLT|>talab	t a l a p
<|MLT|>taljan	t ɐ l j ɐː n
<|MLT|>tama	t a m a
<|MLT|>tar	t aː r
<|MLT|>tarbija	t a r b iː j a
<|MLT|>tarf	t a r f
<|MLT|>tassew	t ɐ sː ɛ w
<|MLT|>taħt	t a ħ t
<|MLT|>tbigħ	d b ɪː ħ
<|MLT|>telaq	t ɛ l a ʔ
<|MLT|>tenna	t ɛ n n a
<|MLT|>terremot	t ɛ r r ɛ m ɔː t
<|MLT|>tfajla	t f a j l a
<|MLT|>tfal	t f aː l
<|MLT|>tfittxija	t f ɪ t t͡ʃ iː j a
<|MLT|>tgħallem	t aː l l ɛ m
<|MLT|>tgħid	t ɛ j t
<|MLT|>tgħin	t ɛ j n
<|MLT|>tiegħi	t ɪː j ɛ j
<|MLT|>tifla	t ɪ f l a
<|MLT|>tikmix	t ɪ k m iː ʃ
<|MLT|>tilef	t ɪ l ɛ f
<|MLT|>tini	t ɪ n ɪ
<|MLT|>tkellem	t k ɛ l l ɛ m
<|MLT|>tlettax	t l ɛ t t aː ʃ
<|MLT|>tliet	t l ɪː t
<|MLT|>tlieta	t l ɪː t a
<|MLT|>tmien	t m ɪː n
<|MLT|>tmint	t m ɪ n t
<|MLT|>toqba	t ɔ ʔ b a
<|MLT|>toqob	t ɔ ʔ ɔ p
<|MLT|>tork	t ɔ r k
<|MLT|>tqatel	t ʔ aː t ɛ l
<|MLT|>tqila	t ʔ iː l a
<|MLT|>trab	t r aː p
<|MLT|>trabba	t r a b b a
<|MLT|>tradizzjoni	t r ɐ d ɪ tː s j ɔː n ɪ
<|MLT|>tul	t uː l
<|MLT|>twal	t w aː l
<|MLT|>twelled	t w ɛ l l ɛ t
<|MLT|>tweġiba	t w ɛ d͡ʒ iː b a
<|MLT|>twieled	t w ɪː l ɛ t
<|MLT|>twil	t w iː l
<|MLT|>twila	t w iː l a
<|MLT|>umli	uː m l ɪ
<|MLT|>uża	uː z a
<|MLT|>vapur	v a p uː r
<|MLT|>veloċità	v ɛ l ɔ t ʃ ɪ t a
<|MLT|>vjaġġ	v j a t͡ʃ
<|MLT|>vjolenti	v j ɔ l ɛ n t ɪ
<|MLT|>vuċi	v uː t͡ʃ ɪ
<|MLT|>waqaf	w a ʔ a f
<|MLT|>waqt	w a ʔ t
<|MLT|>wara	w a r a
<|MLT|>ward	w a r t
<|MLT|>warda	w a r d a
<|MLT|>wasal	w a s a l
<|MLT|>wegħda	w ɛː d a
<|MLT|>wera	w ɛ r a
<|MLT|>weraq	w ɛ r a ʔ
<|MLT|>wesgħin	w ɛ s a j n
<|MLT|>wettaq	w ɛ t t a ʔ
<|MLT|>weġġaħ	w ɛ d d͡ʒ a ħ
<|MLT|>widna	w ɪ d n a
<|MLT|>widnejn	w ɪ d n ɛ j n
<|MLT|>wiesgħa	w ɪː s a
<|MLT|>wieġeb	w ɪː d͡ʒ ɛ p
<|MLT|>wieħed	w ɪː ħ ɛ t
<|MLT|>wirdien	w ɪ r d ɪː n
<|MLT|>wiret	w ɪ r ɛ t
<|MLT|>wirja	w ɪ r j a
<|MLT|>wkoll	w k ɔ l l
<|MLT|>xahar	ʃ aː r
<|MLT|>xahrejn	ʃ a r ɛ j n
<|MLT|>xandar	ʃ a n d a r
<|MLT|>xatt	ʃ a t
<|MLT|>xemx	ʃ ɛ m ʃ
<|MLT|>xena	ʃ ɛː n ɐ
<|MLT|>xenqa	ʃ ɛ n ʔ a
<|MLT|>xerred	ʃ ɛ r r ɛ t
<|MLT|>xhieda	ʃ ɪː d a
<|MLT|>xhur	ʃ uː r
<|MLT|>xi	ʃ ɪ
<|MLT|>xiex	ʃ ɪː ʃ
<|MLT|>xita	ʃ ɪ t a
<|MLT|>xkora	ʃ k ɔː r a
<|MLT|>xorb	ʃ ɔ r p
<|MLT|>xorta	ʃ ɔ r t a
<|MLT|>xorti	ʃ ɔ r t ɪ
<|MLT|>xtaq	ʃ t aː ʔ
<|MLT|>xtara	ʃ t a r a
<|MLT|>xuereb	ʃ w ɪː r ɛ p
<|MLT|>ċar	t͡ʃ aː r
<|MLT|>ċavetta	t͡ʃ a v ɛ t t a
<|MLT|>ċediment	t͡ʃ ɛ d ɪ m ɛ n t
<|MLT|>ċivili	t͡ʃ ɪ v iː l ɪ
<|MLT|>ċkejken	t͡ʃ k ɛ j k ɛ n
<|MLT|>ċkejkna	t͡ʃ k ɛ j k n a
<|MLT|>ċkejknin	t͡ʃ k ɛ j k n iː n
<|MLT|>ċuċ	t͡ʃ uː t͡ʃ
<|MLT|>ġa	d͡ʒ a
<|MLT|>ġab	d͡ʒ aː p
<|MLT|>ġappun	d͡ʒ a p p uː n
<|MLT|>ġawhra	d͡ʒ a w r a
<|MLT|>ġedded	d͡ʒ ɛ d d ɛ t
<|MLT|>ġenna	d͡ʒ ɛ n n a
<|MLT|>ġesù	d͡ʒ ɛ s uː
<|MLT|>ġibed	d͡ʒ ɪ b ɛ t
<|MLT|>ġid	d͡ʒ iː t
<|MLT|>ġie	d͡ʒ ɪː
<|MLT|>ġifa	d͡ʒ iː f a
<|MLT|>ġimgħat	d͡ʒ ɪ m aː t
<|MLT|>ġirien	d͡ʒ ɪ r ɪː n
<|MLT|>ġlieda	d͡ʒ l ɪː d a
<|MLT|>ġnien	d͡ʒ n ɪː n
<|MLT|>ġrajja	d͡ʒ r a j j a
<|MLT|>ħa	ħ aː
<|MLT|>ħabb	ħ a p
<|MLT|>ħabel	ħ a b ɛ l
<|MLT|>ħabs	ħ a p s
<|MLT|>ħabta	ħ a b t a
<|MLT|>ħadd	ħ a t
<|MLT|>ħaddem	ħ a d d ɛ m
<|MLT|>ħaddiem	ħ a d d ɪː m
<|MLT|>ħadt	ħ a t
<|MLT|>ħafif	ħ a f iː f
<|MLT|>ħajja	ħ a j j a
<|MLT|>ħajjin	ħ a j j iː n
<|MLT|>ħajr	ħ a j r
<|MLT|>ħalaq	ħ a l a ʔ
<|MLT|>ħalib	ħ a l iː p
<|MLT|>ħalla	ħ a l l a
<|MLT|>ħallat	ħ a l l a t
<|MLT|>ħallelin	ħ a l l ɛ l iː n
<|MLT|>ħalliel	ħ a l l ɪː l
<|MLT|>ħalq	ħ a l ʔ
<|MLT|>ħamest	ħ a m ɛ s t
<|MLT|>ħamsin	ħ a m s iː n
<|MLT|>ħanin	ħ a n iː n
<|MLT|>ħaqq	ħ a ʔ
<|MLT|>ħaseb	ħ a s ɛ p
<|MLT|>ħasra	ħ a s r a
<|MLT|>ħass	ħ a s
<|MLT|>ħatar	ħ a t a r
<|MLT|>ħawt	ħ a w t
<|MLT|>ħaġa	ħ aː d͡ʒ a
<|MLT|>ħaġar	ħ a d͡ʒ a r
<|MLT|>ħażen	ħ a z ɛ n
<|MLT|>ħbiberija	ħ b ɪ b ɛ r iː j a
<|MLT|>ħeba	ħ ɛ b a
<|MLT|>ħejja	ħ ɛ j j a
<|MLT|>ħela	ħ ɛ l a
<|MLT|>ħelwa	ħ ɛ l w ɐ
<|MLT|>ħeġġeġ	ħ ɛ d d͡ʒ ɛ t͡ʃ
<|MLT|>ħieles	ħ ɪː l ɛ s
<|MLT|>ħin	ħ iː n
<|MLT|>ħlas	ħ l aː s
<|MLT|>ħlejjaq	ħ l ɛ j j a ʔ
<|MLT|>ħlief	ħ l ɪː f
<|MLT|>ħmistax	ħ m ɪ s t aː ʃ
<|MLT|>ħniena	ħ n ɪː n a
<|MLT|>ħolm	ħ ɔ l m
<|MLT|>ħolma	ħ ɔ l m a
<|MLT|>ħsara	ħ s aː r a
<|MLT|>ħsibijiet	ħ s ɪ b ɪ j ɪː t
<|MLT|>ħsieb	ħ s ɪː p
<|MLT|>ħut	ħ uː t
<|MLT|>ħwienet	ħ w ɪː n ɛ t
<|MLT|>żagħżugħ	z a z uː ħ
<|MLT|>żagħżugħa	z a z uː w a
<|MLT|>żar	z aː r
<|MLT|>żball	z b a l l
<|MLT|>żewġ	z ɛ w t͡ʃ
<|MLT|>żgur	z ɡ uː r
<|MLT|>żgħar	z aː r
<|MLT|>żgħir	z ɛ j r
<|MLT|>żgħira	z a j r a
<|MLT|>żied	z ɪː t
<|MLT|>żieda	z ɪː d a
<|MLT|>żmien	z m ɪː n
<|MLT|>żnuber	z n uː b ɛ r
<|MLT|>żwieġ	z w ɪː t͡ʃ
<|MLT|>żżewweġ	ɪ z z ɛ w w ɛ t͡ʃ
<|HUN|>ablakból	ɒ b l ɒ ɡ b oː l
<|HUN|>acéllemez	ɒ t͡s eː lː ɛ m ɛ z
<|HUN|>adatainak	ɒ d ɒ t ɒ j i n ɒ k
<|HUN|>adni	ɒ d n i
<|HUN|>ajánlattevő	ɒ j aː n l ɒ tː ɛ v øː
<|HUN|>akad	ɒ k ɒ d
<|HUN|>akció	ɒ k t͡s i j oː
<|HUN|>akihez	ɒ k i ɦ ɛ z
<|HUN|>akiknek	ɒ k i k n ɛ k
<|HUN|>alkalmasnak	ɒ l k ɒ l m ɒ ʃ n ɒ k
<|HUN|>alkalmazni	ɒ l k ɒ l m ɒ z n i
<|HUN|>alkalmazása	ɒ l k ɒ l m ɒ z aː ʃ ɒ
<|HUN|>alkalmazásának	ɒ l k ɒ l m ɒ z aː ʃ aː n ɒ k
<|HUN|>alkotó	ɒ l k o t oː
<|HUN|>allen	ɛ l ɛ n
<|HUN|>amelyen	ɒ m ɛ j ɛ n
<|HUN|>amelynél	ɒ m ɛ j n eː l
<|HUN|>amikkel	ɒ m i kː ɛ l
<|HUN|>amit	ɒ m i t
<|HUN|>analfabéták	ɒ n ɒ l f ɒ b eː t aː k
<|HUN|>andrás	ɒ n d r aː ʃ
<|HUN|>anesztézia	ɒ n ɛ s t eː z i j ɒ
<|HUN|>annyi	ɒ ɲː i
<|HUN|>annál	ɒ nː aː l
<|HUN|>antal	ɒ n t ɒ l
<|HUN|>anyagokat	ɒ ɲ ɒ ɡ o k ɒ t
<|HUN|>anyuka	ɒ ɲ u k ɒ
<|HUN|>apa	ɒ p ɒ
<|HUN|>arca	ɒ r t͡s ɒ
<|HUN|>arcán	ɒ r t͡s aː n
<|HUN|>attribútum	ɒ t r i b uː t u m
<|HUN|>ausztriában	ɒ u s t r i j aː b ɒ n
<|HUN|>autók	ɒ u t oː k
<|HUN|>azokat	ɒ z o k ɒ t
<|HUN|>azért	ɒ z eː r t
<|HUN|>balatoni	b ɒ l ɒ t o n i
<|HUN|>be	b ɛ
<|HUN|>befejezetlen	b ɛ f ɛ j ɛ z ɛ t l ɛ n
<|HUN|>befejezés	b ɛ f ɛ j ɛ z eː ʃ
<|HUN|>befektetők	b ɛ f ɛ k t ɛ t øː k
<|HUN|>bejelenteni	b ɛ j ɛ l ɛ n t ɛ n i
<|HUN|>belüli	b ɛ l y l i
<|HUN|>bemutatásra	b ɛ m u t ɒ t aː ʃ r ɒ
<|HUN|>benyomni	b ɛ ɲ o m n i
<|HUN|>benzin	b ɛ n z i n
<|HUN|>beszerzés	b ɛ s ɛ r z eː ʃ
<|HUN|>beszédét	b ɛ s eː d eː t
<|HUN|>beszéljen	b ɛ s eː jː ɛ n
<|HUN|>betegségek	b ɛ t ɛ k ʃ eː ɡ ɛ k
<|HUN|>betyárok	b ɛ c aː r o k
<|HUN|>betöltött	b ɛ t ø l t ø tː
<|HUN|>birtoka	b i r t o k ɒ
<|HUN|>bizonytalanságok	b i z o ɲ t ɒ l ɒ n ʃ aː ɡ o k
<|HUN|>biztató	b i s t ɒ t oː
<|HUN|>biztonságosabb	b i s t o n ʃ aː ɡ o ʃ ɒ bː
<|HUN|>borító	b o r iː t oː
<|HUN|>buda	b u d ɒ
<|HUN|>budapestre	b u d ɒ p ɛ ʃ t r ɛ
<|HUN|>burkolat	b u r k o l ɒ t
<|HUN|>buszok	b u s o k
<|HUN|>bécsben	b eː d͡ʒ b ɛ n
<|HUN|>bérelt	b eː r ɛ l t
<|HUN|>bír	b iː r
<|HUN|>büntetés	b y n t ɛ t eː ʃ
<|HUN|>bűn	b yː n
<|HUN|>ceremónia	t͡s ɛ r ɛ m oː n i j ɒ
<|HUN|>cikket	t͡s i kː ɛ t
<|HUN|>cipzár	t͡s i b z aː r
<|HUN|>citromsav	t͡s i t r o m ʃ ɒ v
<|HUN|>csaknem	t͡ʃ ɒ k n ɛ m
<|HUN|>családja	t͡ʃ ɒ l aː ɟː ɒ
<|HUN|>csap	t͡ʃ ɒ p
<|HUN|>csapadék	t͡ʃ ɒ p ɒ d eː k
<|HUN|>csapatok	t͡ʃ ɒ p ɒ t o k
<|HUN|>csapatoknak	t͡ʃ ɒ p ɒ t o k n ɒ k
<|HUN|>csatlakozik	t͡ʃ ɒ t l ɒ k o z i k
<|HUN|>csehek	t͡ʃ ɛ h ɛ k
<|HUN|>cseppet	t͡ʃ ɛ pː ɛ t
<|HUN|>csillagok	t͡ʃ i lː ɒ ɡ o k
<|HUN|>csodálatos	t͡ʃ o d aː l ɒ t o ʃ
<|HUN|>csoki	t͡ʃ o k i
<|HUN|>csoportját	t͡ʃ o p o r c aː t
<|HUN|>csökkentése	t͡ʃ ø kː ɛ n t eː ʃ ɛ
<|HUN|>csütörtök	t͡ʃ y t ø r t ø k
<|HUN|>csütörtökön	t͡ʃ y t ø r t ø k ø n
<|HUN|>cukor	t͡s u k o r
<|HUN|>cégek	t͡s eː ɡ ɛ k
<|HUN|>célkitűzés	t͡s eː l k i t yː z eː ʃ
<|HUN|>célpontok	t͡s eː l p o n t o k
<|HUN|>címe	t͡s iː m ɛ
<|HUN|>debreceni	d ɛ b r ɛ t͡s ɛ n i
<|HUN|>demokraták	d ɛ m o k r ɒ t aː k
<|HUN|>dimenziók	d i m ɛ n z i j oː k
<|HUN|>dobogó	d o b o ɡ oː
<|HUN|>dolgát	d o l ɡ aː t
<|HUN|>dönt	d ø n t
<|HUN|>döntéshozó	d ø n t eː ʃ h o z oː
<|HUN|>döntő	d ø n t øː
<|HUN|>ebből	ɛ bː øː l
<|HUN|>egerek	ɛ ɡ ɛ r ɛ k
<|HUN|>egyenesen	ɛ ɟ ɛ n ɛ ʃ ɛ n
<|HUN|>egyház	ɛ c h aː z
<|HUN|>egykor	ɛ c k o r
<|HUN|>egyre	ɛ ɟ r ɛ
<|HUN|>egyének	ɛ ɟ eː n ɛ k
<|HUN|>egyénileg	ɛ ɟ eː n i l ɛ ɡ
<|HUN|>egészségbiztosítási	ɛ ɡ eː ʃː eː ɡ b i s t o ʃ iː t aː ʃ i
<|HUN|>el	ɛ l
<|HUN|>elektromos	ɛ l ɛ k t r o m o ʃ
<|HUN|>elektronikus	ɛ l ɛ k t r o n i k u ʃ
<|HUN|>elem	ɛ l ɛ m
<|HUN|>elemző	ɛ l ɛ m z øː
<|HUN|>elismerés	ɛ l i ʃ m ɛ r eː ʃ
<|HUN|>eljáró	ɛ jː aː r oː
<|HUN|>elkészítése	ɛ l k eː s iː t eː ʃ ɛ
<|HUN|>elkövetkező	ɛ l k ø v ɛ t k ɛ z øː
<|HUN|>ellentétes	ɛ lː ɛ n t eː t ɛ ʃ
<|HUN|>elnézést	ɛ l n eː z eː ʃ t
<|HUN|>elnöke	ɛ l n ø k ɛ
<|HUN|>elnöki	ɛ l n ø k i
<|HUN|>elnökének	ɛ l n ø k eː n ɛ k
<|HUN|>elnökét	ɛ l n ø k eː t
<|HUN|>elnököt	ɛ l n ø k ø t
<|HUN|>elsődleges	ɛ l ʃ øː d l ɛ ɡ ɛ ʃ
<|HUN|>eltérő	ɛ l t eː r øː
<|HUN|>elvétve	ɛ l v eː t v ɛ
<|HUN|>eléréséhez	ɛ l eː r eː ʃ eː ɦ ɛ z
<|HUN|>előkészítése	ɛ l øː k eː s iː t eː ʃ ɛ
<|HUN|>előleg	ɛ l øː l ɛ ɡ
<|HUN|>előnye	ɛ l øː ɲ ɛ
<|HUN|>előtti	ɛ l øː tː i
<|HUN|>előítélet	ɛ l øː j iː t eː l ɛ t
<|HUN|>emelkedő	ɛ m ɛ l k ɛ d øː
<|HUN|>emlékszik	ɛ m l eː k s i k
<|HUN|>emlő	ɛ m l øː
<|HUN|>energiát	ɛ n ɛ r ɡ i j aː t
<|HUN|>ennek	ɛ nː ɛ k
<|HUN|>ennél	ɛ nː eː l
<|HUN|>erdőkben	ɛ r d øː ɡ b ɛ n
<|HUN|>eredmények	ɛ r ɛ d m eː ɲ ɛ k
<|HUN|>eredményre	ɛ r ɛ d m eː ɲ r ɛ
<|HUN|>eredményt	ɛ r ɛ d m eː ɲ t
<|HUN|>erősítése	ɛ r øː ʃ iː t eː ʃ ɛ
<|HUN|>esemény	ɛ ʃ ɛ m eː ɲ
<|HUN|>esküvői	ɛ ʃ k y v øː j i
<|HUN|>esti	ɛ ʃ t i
<|HUN|>estig	ɛ ʃ t i ɡ
<|HUN|>eszerint	ɛ s ɛ r i n t
<|HUN|>eszközzel	ɛ s k ø zː ɛ l
<|HUN|>eszközök	ɛ s k ø z ø k
<|HUN|>esztek	ɛ s t ɛ k
<|HUN|>esély	ɛ ʃ eː j
<|HUN|>esélyekkel	ɛ ʃ eː j ɛ kː ɛ l
<|HUN|>esős	ɛ ʃ øː ʃ
<|HUN|>evezős	ɛ v ɛ z øː ʃ
<|HUN|>expedíció	ɛ k s p ɛ d iː t͡s i j oː
<|HUN|>export	ɛ k s p o r t
<|HUN|>ezernyi	ɛ z ɛ r ɲ i
<|HUN|>falat	f ɒ l ɒ t
<|HUN|>fegyverek	f ɛ ɟ v ɛ r ɛ k
<|HUN|>fejleszteni	f ɛ j l ɛ s t ɛ n i
<|HUN|>fejlesztésének	f ɛ j l ɛ s t eː ʃ eː n ɛ k
<|HUN|>fejlődése	f ɛ j l øː d eː ʃ ɛ
<|HUN|>fejlődő	f ɛ j l øː d øː
<|HUN|>feladatai	f ɛ l ɒ d ɒ t ɒ j i
<|HUN|>felelősségtudat	f ɛ l ɛ l øː ʃː eː k t u d ɒ t
<|HUN|>felelősségét	f ɛ l ɛ l øː ʃː eː ɡ eː t
<|HUN|>felszínes	f ɛ l s iː n ɛ ʃ
<|HUN|>felsőbb	f ɛ l ʃ øː bː
<|HUN|>feltételek	f ɛ l t eː t ɛ l ɛ k
<|HUN|>feltételez	f ɛ l t eː t ɛ l ɛ z
<|HUN|>feltétlenül	f ɛ l t eː t l ɛ n y l
<|HUN|>felvételek	f ɛ l v eː t ɛ l ɛ k
<|HUN|>felére	f ɛ l eː r ɛ
<|HUN|>felület	f ɛ l y l ɛ t
<|HUN|>felülvizsgálat	f ɛ l y l v i ʒ ɡ aː l ɒ t
<|HUN|>fesztivált	f ɛ s t i v aː l t
<|HUN|>figurát	f i ɡ u r aː t
<|HUN|>figyelembe	f i ɟ ɛ l ɛ m b ɛ
<|HUN|>figyelmeztet	f i ɟ ɛ l m ɛ s t ɛ t
<|HUN|>filozófiai	f i l o z oː f i j ɒ j i
<|HUN|>fizikailag	f i z i k ɒ j i l ɒ ɡ
<|HUN|>foci	f o t͡s i
<|HUN|>foglalás	f o ɡ l ɒ l aː ʃ
<|HUN|>fogni	f o ɡ n i
<|HUN|>fogom	f o ɡ o m
<|HUN|>folytat	f o j t ɒ t
<|HUN|>folytatás	f o j t ɒ t aː ʃ
<|HUN|>folytatódik	f o j t ɒ t oː d i k
<|HUN|>fordulóban	f o r d u l oː b ɒ n
<|HUN|>fordított	f o r d iː t o tː
<|HUN|>forint	f o r i n t
<|HUN|>formai	f o r m ɒ j i
<|HUN|>forradalmi	f o rː ɒ d ɒ l m i
<|HUN|>fotót	f o t oː t
<|HUN|>francia	f r ɒ n t͡s i j ɒ
<|HUN|>fronton	f r o n t o n
<|HUN|>futás	f u t aː ʃ
<|HUN|>fájdalmas	f aː j d ɒ l m ɒ ʃ
<|HUN|>föld	f ø l d
<|HUN|>földek	f ø l d ɛ k
<|HUN|>földterület	f ø l t ɛ r y l ɛ t
<|HUN|>függőlegesen	f y ɡː øː l ɛ ɡ ɛ ʃ ɛ n
<|HUN|>füves	f y v ɛ ʃ
<|HUN|>főbb	f øː bː
<|HUN|>főnél	f øː n eː l
<|HUN|>főpolgármester	f øː p o l ɡ aː r m ɛ ʃ t ɛ r
<|HUN|>főszerkesztője	f øː s ɛ r k ɛ s t øː j ɛ
<|HUN|>gazdaságot	ɡ ɒ z d ɒ ʃ aː ɡ o t
<|HUN|>generációs	ɡ ɛ n ɛ r aː t͡s i j oː ʃ
<|HUN|>gondoltam	ɡ o n d o l t ɒ m
<|HUN|>grúz	ɡ r uː z
<|HUN|>gusztustalan	ɡ u s t u ʃ t ɒ l ɒ n
<|HUN|>gyakorol	ɟ ɒ k o r o l
<|HUN|>gyakrabban	ɟ ɒ k r ɒ bː ɒ n
<|HUN|>gyanúja	ɟ ɒ n uː j ɒ
<|HUN|>gyanúsított	ɟ ɒ n uː ʃ iː t o tː
<|HUN|>gyermekét	ɟ ɛ r m ɛ k eː t
<|HUN|>gágog	ɡ aː ɡ o ɡ
<|HUN|>géza	ɡ eː z ɒ
<|HUN|>görög	ɡ ø r ø ɡ
<|HUN|>ha	h ɒ
<|HUN|>hagyma	h ɒ ɟ m ɒ
<|HUN|>hagyománya	h ɒ ɟ o m aː ɲ ɒ
<|HUN|>hagyományai	h ɒ ɟ o m aː ɲ ɒ j i
<|HUN|>hajóra	h ɒ j oː r ɒ
<|HUN|>hajótörést	h ɒ j oː t ø r eː ʃ t
<|HUN|>hallgat	h ɒ l ɡ ɒ t
<|HUN|>hallom	h ɒ lː o m
<|HUN|>hallottam	h ɒ lː o tː ɒ m
<|HUN|>halott	h ɒ l o tː
<|HUN|>halálát	h ɒ l aː l aː t
<|HUN|>hangszerek	h ɒ ŋ k s ɛ r ɛ k
<|HUN|>harang	h ɒ r ɒ ŋ ɡ
<|HUN|>harcot	h ɒ r t͡s o t
<|HUN|>hasonlít	h ɒ ʃ o n l iː t
<|HUN|>használni	h ɒ s n aː l n i
<|HUN|>határidők	h ɒ t aː r i d øː k
<|HUN|>határozni	h ɒ t aː r o z n i
<|HUN|>határt	h ɒ t aː r t
<|HUN|>hatással	h ɒ t aː ʃː ɒ l
<|HUN|>helyek	h ɛ j ɛ k
<|HUN|>helyeken	h ɛ j ɛ k ɛ n
<|HUN|>helyen	h ɛ j ɛ n
<|HUN|>helyett	h ɛ j ɛ tː
<|HUN|>helyezett	h ɛ j ɛ z ɛ tː
<|HUN|>hercegnőnek	h ɛ r t͡s ɛ ɡ n øː n ɛ k
<|HUN|>heti	h ɛ t i
<|HUN|>hiányos	h i j aː ɲ o ʃ
<|HUN|>hiányosságok	h i j aː ɲ o ʃː aː ɡ o k
<|HUN|>hordozó	h o r d o z oː
<|HUN|>hormonok	h o r m o n o k
<|HUN|>horthy	h o r t i
<|HUN|>hozták	h o s t aː k
<|HUN|>hozzátok	h o zː aː t o k
<|HUN|>huszonnégy	h u s o nː eː ɟ
<|HUN|>hálózat	h aː l oː z ɒ t
<|HUN|>három	h aː r o m
<|HUN|>háttér	h aː tː eː r
<|HUN|>hétben	h eː d b ɛ n
<|HUN|>hétvégén	h eː t v eː ɡ eː n
<|HUN|>híd	h iː d
<|HUN|>híreket	h iː r ɛ k ɛ t
<|HUN|>hó	h oː
<|HUN|>hócipője	h oː t͡s i p øː j ɛ
<|HUN|>hő	h øː
<|HUN|>hűvösebb	h yː v ø ʃ ɛ bː
<|HUN|>időbeli	i d øː b ɛ l i
<|HUN|>időktől	i d øː k t øː l
<|HUN|>időközben	i d øː k ø z b ɛ n
<|HUN|>időnkénti	i d øː ŋ k eː n t i
<|HUN|>időpontban	i d øː p o n d b ɒ n
<|HUN|>időre	i d øː r ɛ
<|HUN|>idős	i d øː ʃ
<|HUN|>időt	i d øː t
<|HUN|>ifjúsági	i f j uː ʃ aː ɡ i
<|HUN|>igazolvány	i ɡ ɒ z o l v aː ɲ
<|HUN|>igazán	i ɡ ɒ z aː n
<|HUN|>illik	i lː i k
<|HUN|>illékony	i lː eː k o ɲ
<|HUN|>immár	i mː aː r
<|HUN|>ingatag	i ŋ ɡ ɒ t ɒ ɡ
<|HUN|>ingatlant	i ŋ ɡ ɒ t l ɒ n t
<|HUN|>inget	i ŋ ɡ ɛ t
<|HUN|>ingyen	i ɲ ɟ ɛ n
<|HUN|>ipar	i p ɒ r
<|HUN|>irigykedik	i r i c k ɛ d i k
<|HUN|>irányuló	i r aː ɲ u l oː
<|HUN|>irányzat	i r aː ɲ z ɒ t
<|HUN|>ismertebb	i ʃ m ɛ r t ɛ bː
<|HUN|>isteni	i ʃ t ɛ n i
<|HUN|>izraeli	i z r ɒ ɛ l i
<|HUN|>izzok	i zː o k
<|HUN|>jaj	j ɒ j
<|HUN|>jegyzet	j ɛ ɟ z ɛ t
<|HUN|>jelentősebb	j ɛ l ɛ n t øː ʃ ɛ bː
<|HUN|>jellemzően	j ɛ lː ɛ m z øː ɛ n
<|HUN|>jelöltek	j ɛ l ø l t ɛ k
<|HUN|>jobb	j o bː
<|HUN|>jogszabályok	j o k s ɒ b aː j o k
<|HUN|>jogát	j o ɡ aː t
<|HUN|>junior	j u n i j o r
<|HUN|>jutott	j u t o tː
<|HUN|>jutunk	j u t u ŋ k
<|HUN|>jártak	j aː r t ɒ k
<|HUN|>járunk	j aː r u ŋ k
<|HUN|>járványok	j aː r v aː ɲ o k
<|HUN|>játékban	j aː t eː ɡ b ɒ n
<|HUN|>játékok	j aː t eː k o k
<|HUN|>jönnek	j ø nː ɛ k
<|HUN|>kalandor	k ɒ l ɒ n d o r
<|HUN|>kankalin	k ɒ ŋ k ɒ l i n
<|HUN|>kapcsolattartás	k ɒ p t͡ʃ o l ɒ tː ɒ r t aː ʃ
<|HUN|>kapjanak	k ɒ p j ɒ n ɒ k
<|HUN|>kapjuk	k ɒ p j u k
<|HUN|>kapott	k ɒ p o tː
<|HUN|>kaptak	k ɒ p t ɒ k
<|HUN|>kar	k ɒ r
<|HUN|>karbantartások	k ɒ r b ɒ n t ɒ r t aː ʃ o k
<|HUN|>kategóriát	k ɒ t ɛ ɡ oː r i j aː t
<|HUN|>katona	k ɒ t o n ɒ
<|HUN|>kelenföld	k ɛ l ɛ ɱ f ø l d
<|HUN|>kelljen	k ɛ jː ɛ n
<|HUN|>kellő	k ɛ lː øː
<|HUN|>kemény	k ɛ m eː ɲ
<|HUN|>keresztcsont	k ɛ r ɛ s t t͡ʃ o n t
<|HUN|>keresztül	k ɛ r ɛ s t y l
<|HUN|>keresők	k ɛ r ɛ ʃ øː k
<|HUN|>keretet	k ɛ r ɛ t ɛ t
<|HUN|>kerékpáros	k ɛ r eː k p aː r o ʃ
<|HUN|>kerület	k ɛ r y l ɛ t
<|HUN|>kezdik	k ɛ z d i k
<|HUN|>kezel	k ɛ z ɛ l
<|HUN|>kezelhető	k ɛ z ɛ l ɦ ɛ t øː
<|HUN|>kezét	k ɛ z eː t
<|HUN|>kiabálnak	k i j ɒ b aː l n ɒ k
<|HUN|>kiadás	k i j ɒ d aː ʃ
<|HUN|>kiadó	k i j ɒ d oː
<|HUN|>kialakítani	k i j ɒ l ɒ k iː t ɒ n i
<|HUN|>kialakítására	k i j ɒ l ɒ k iː t aː ʃ aː r ɒ
<|HUN|>kicsivel	k i t͡ʃ i v ɛ l
<|HUN|>kicsoda	k i t͡ʃ o d ɒ
<|HUN|>kikre	k i k r ɛ
<|HUN|>kilót	k i l oː t
<|HUN|>királyság	k i r aː j ʃ aː ɡ
<|HUN|>kisbaba	k i ʒ b ɒ b ɒ
<|HUN|>kiss	k i ʃ
<|HUN|>kiváltság	k i v aː l t͡ʃ aː ɡ
<|HUN|>kivételes	k i v eː t ɛ l ɛ ʃ
<|HUN|>koalíciós	k o ɒ l iː t͡s i j oː ʃ
<|HUN|>kockázatot	k o t͡s k aː z ɒ t o t
<|HUN|>kolozsvári	k o l o ʒ v aː r i
<|HUN|>komolyan	k o m o j ɒ n
<|HUN|>konferenciát	k o ɱ f ɛ r ɛ n t͡s i j aː t
<|HUN|>konstrukció	k o n ʃ t r u k t͡s i j oː
<|HUN|>kormányfő	k o r m aː ɲ f øː
<|HUN|>kozma	k o z m ɒ
<|HUN|>kritikus	k r i t i k u ʃ
<|HUN|>krém	k r eː m
<|HUN|>kára	k aː r ɒ
<|HUN|>képességei	k eː p ɛ ʃː eː ɡ ɛ j i
<|HUN|>képviseleti	k eː p v i ʃ ɛ l ɛ t i
<|HUN|>kérdéseit	k eː r d eː ʃ ɛ j i t
<|HUN|>kéri	k eː r i
<|HUN|>kérni	k eː r n i
<|HUN|>készítettek	k eː s iː t ɛ tː ɛ k
<|HUN|>késő	k eː ʃ øː
<|HUN|>kétségbe	k eː t͡ʃː eː ɡ b ɛ
<|HUN|>kézzel	k eː zː ɛ l
<|HUN|>kívánjuk	k iː v aː ɲː u k
<|HUN|>kölcsön	k ø l t͡ʃ ø n
<|HUN|>kölcsönök	k ø l t͡ʃ ø n ø k
<|HUN|>könyvbe	k ø ɲ v b ɛ
<|HUN|>könyve	k ø ɲ v ɛ
<|HUN|>könyvek	k ø ɲ v ɛ k
<|HUN|>könyvtári	k ø ɲ f t aː r i
<|HUN|>környékén	k ø r ɲ eː k eː n
<|HUN|>köröcske	k ø r ø t͡ʃ k ɛ
<|HUN|>köszönhetően	k ø s ø n ɦ ɛ t øː ɛ n
<|HUN|>kötelezettség	k ø t ɛ l ɛ z ɛ t͡ʃː eː ɡ
<|HUN|>kötelezettségek	k ø t ɛ l ɛ z ɛ t͡ʃː eː ɡ ɛ k
<|HUN|>kötet	k ø t ɛ t
<|HUN|>közepes	k ø z ɛ p ɛ ʃ
<|HUN|>közlekedés	k ø z l ɛ k ɛ d eː ʃ
<|HUN|>középiskolai	k ø z eː p i ʃ k o l ɒ j i
<|HUN|>közönség	k ø z ø n ʃ eː ɡ
<|HUN|>között	k ø z ø tː
<|HUN|>küldje	k y l ɟ ɛ
<|HUN|>külön	k y l ø n
<|HUN|>küszöbe	k y s ø b ɛ
<|HUN|>legdrágább	l ɛ ɡ d r aː ɡ aː bː
<|HUN|>legesélyesebb	l ɛ ɡ ɛ ʃ eː j ɛ ʃ ɛ bː
<|HUN|>leggyakrabban	l ɛ ɡ ɟ ɒ k r ɒ bː ɒ n
<|HUN|>leginkább	l ɛ ɡ i ŋ k aː bː
<|HUN|>legjobb	l ɛ ɡ j o bː
<|HUN|>legkevesebb	l ɛ kː ɛ v ɛ ʃ ɛ bː
<|HUN|>legkiemeltebb	l ɛ kː i j ɛ m ɛ l t ɛ bː
<|HUN|>legkönnyebb	l ɛ kː ø ɲː ɛ bː
<|HUN|>legragyogóbb	l ɛ ɡ r ɒ ɟ o ɡ oː bː
<|HUN|>legyenek	l ɛ ɟ ɛ n ɛ k
<|HUN|>lehetnék	l ɛ h ɛ t n eː k
<|HUN|>lehető	l ɛ h ɛ t øː
<|HUN|>lehetősége	l ɛ h ɛ t øː ʃ eː ɡ ɛ
<|HUN|>lehetőségét	l ɛ h ɛ t øː ʃ eː ɡ eː t
<|HUN|>lenne	l ɛ nː ɛ
<|HUN|>levegőben	l ɛ v ɛ ɡ øː b ɛ n
<|HUN|>leveleket	l ɛ v ɛ l ɛ k ɛ t
<|HUN|>levélben	l ɛ v eː l b ɛ n
<|HUN|>linkek	l i ŋ k ɛ k
<|HUN|>logika	l o ɡ i k ɒ
<|HUN|>logisztikai	l o ɡ i s t i k ɒ j i
<|HUN|>lábán	l aː b aː n
<|HUN|>lágy	l aː ɟ
<|HUN|>lányt	l aː ɲ t
<|HUN|>lássam	l aː ʃː ɒ m
<|HUN|>látják	l aː cː aː k
<|HUN|>légy	l eː ɟ
<|HUN|>lét	l eː t
<|HUN|>magamért	m ɒ ɡ ɒ m eː r t
<|HUN|>magasak	m ɒ ɡ ɒ ʃ ɒ k
<|HUN|>magyarországra	m ɒ ɟ ɒ r o r s aː ɡ r ɒ
<|HUN|>magán	m ɒ ɡ aː n
<|HUN|>megalapozott	m ɛ ɡ ɒ l ɒ p o z o tː
<|HUN|>megbeszélések	m ɛ ɡ b ɛ s eː l eː ʃ ɛ k
<|HUN|>megfelelően	m ɛ k f ɛ l ɛ l øː ɛ n
<|HUN|>meghaltak	m ɛ k h ɒ l t ɒ k
<|HUN|>meghatározott	m ɛ k h ɒ t aː r o z o tː
<|HUN|>megkezdte	m ɛ kː ɛ s t ɛ
<|HUN|>megoldásokat	m ɛ ɡ o l d aː ʃ o k ɒ t
<|HUN|>megszüntetése	m ɛ k s y n t ɛ t eː ʃ ɛ
<|HUN|>megtudni	m ɛ k t u d n i
<|HUN|>megvizsgál	m ɛ ɡ v i ʒ ɡ aː l
<|HUN|>megválasztott	m ɛ ɡ v aː l ɒ s t o tː
<|HUN|>mellékes	m ɛ lː eː k ɛ ʃ
<|HUN|>mennyből	m ɛ ɲ b øː l
<|HUN|>mentes	m ɛ n t ɛ ʃ
<|HUN|>menti	m ɛ n t i
<|HUN|>mentünk	m ɛ n t y ŋ k
<|HUN|>mezőn	m ɛ z øː n
<|HUN|>mik	m i k
<|HUN|>millenniumi	m i lː ɛ nː i j u m i
<|HUN|>mindeddig	m i n d ɛ dː i ɡ
<|HUN|>mindenben	m i n d ɛ m b ɛ n
<|HUN|>mindenféle	m i n d ɛ ɱ f eː l ɛ
<|HUN|>mindennek	m i n d ɛ nː ɛ k
<|HUN|>mindkettő	m i n t k ɛ tː øː
<|HUN|>minősítés	m i n øː ʃ iː t eː ʃ
<|HUN|>miskolcon	m i ʃ k o l t͡s o n
<|HUN|>miért	m i j eː r t
<|HUN|>mocskos	m o t͡ʃ k o ʃ
<|HUN|>modul	m o d u l
<|HUN|>mondják	m o ɲ ɟ aː k
<|HUN|>mondták	m o n t aː k
<|HUN|>mosópor	m o ʃ oː p o r
<|HUN|>motorcsónak	m o t o r t͡ʃ oː n ɒ k
<|HUN|>munkásokat	m u ŋ k aː ʃ o k ɒ t
<|HUN|>mutatják	m u t ɒ cː aː k
<|HUN|>muzsikál	m u ʒ i k aː l
<|HUN|>májusában	m aː j u ʃ aː b ɒ n
<|HUN|>március	m aː r t͡s i j u ʃ
<|HUN|>más	m aː ʃ
<|HUN|>másban	m aː ʒ b ɒ n
<|HUN|>másiknak	m aː ʃ i k n ɒ k
<|HUN|>másnap	m aː ʃ n ɒ p
<|HUN|>második	m aː ʃ o d i k
<|HUN|>másoké	m aː ʃ o k eː
<|HUN|>méltóságteljes	m eː l t oː ʃ aː k t ɛ jː ɛ ʃ
<|HUN|>mélybe	m eː j b ɛ
<|HUN|>mélyen	m eː j ɛ n
<|HUN|>mérd	m eː r d
<|HUN|>méretben	m eː r ɛ d b ɛ n
<|HUN|>mérgező	m eː r ɡ ɛ z øː
<|HUN|>mérni	m eː r n i
<|HUN|>mérők	m eː r øː k
<|HUN|>módosításáról	m oː d o ʃ iː t aː ʃ aː r oː l
<|HUN|>múltán	m uː l t aː n
<|HUN|>művészi	m yː v eː s i
<|HUN|>nadrág	n ɒ d r aː ɡ
<|HUN|>nagymama	n ɒ ɟ m ɒ m ɒ
<|HUN|>nagyot	n ɒ ɟ o t
<|HUN|>napból	n ɒ bː oː l
<|HUN|>napi	n ɒ p i
<|HUN|>napja	n ɒ p j ɒ
<|HUN|>napján	n ɒ p j aː n
<|HUN|>napon	n ɒ p o n
<|HUN|>nappal	n ɒ pː ɒ l
<|HUN|>navigáció	n ɒ v i ɡ aː t͡s i j oː
<|HUN|>negyedszer	n ɛ ɟ ɛ t͡sː ɛ r
<|HUN|>nemigen	n ɛ m i ɡ ɛ n
<|HUN|>nemzeti	n ɛ m z ɛ t i
<|HUN|>nevet	n ɛ v ɛ t
<|HUN|>nevében	n ɛ v eː b ɛ n
<|HUN|>novemberben	n o v ɛ m b ɛ r b ɛ n
<|HUN|>nyilvánosság	ɲ i l v aː n o ʃː aː ɡ
<|HUN|>nyilvánvalóvá	ɲ i l v aː ɱ v ɒ l oː v aː
<|HUN|>nyitva	ɲ i t v ɒ
<|HUN|>nyomai	ɲ o m ɒ j i
<|HUN|>nyomozóiroda	ɲ o m o z oː j i r o d ɒ
<|HUN|>nyugdíjak	ɲ u ɡ d iː j ɒ k
<|HUN|>nádor	n aː d o r
<|HUN|>néha	n eː ɦ ɒ
<|HUN|>néhányan	n eː ɦ aː ɲ ɒ n
<|HUN|>néven	n eː v ɛ n
<|HUN|>növekedés	n ø v ɛ k ɛ d eː ʃ
<|HUN|>növekedése	n ø v ɛ k ɛ d eː ʃ ɛ
<|HUN|>növekedését	n ø v ɛ k ɛ d eː ʃ eː t
<|HUN|>ok	o k
<|HUN|>okok	o k o k
<|HUN|>okozott	o k o z o tː
<|HUN|>októberben	o k t oː b ɛ r b ɛ n
<|HUN|>oldalát	o l d ɒ l aː t
<|HUN|>olyasmi	o j ɒ ʃ m i
<|HUN|>országút	o r s aː ɡ uː t
<|HUN|>otthoni	o t h o n i
<|HUN|>padon	p ɒ d o n
<|HUN|>pelikán	p ɛ l i k aː n
<|HUN|>percen	p ɛ r t͡s ɛ n
<|HUN|>piacra	p i j ɒ t͡s r ɒ
<|HUN|>pillanatig	p i lː ɒ n ɒ t i ɡ
<|HUN|>pillanatok	p i lː ɒ n ɒ t o k
<|HUN|>pillant	p i lː ɒ n t
<|HUN|>polgárháború	p o l ɡ aː r ɦ aː b o r uː
<|HUN|>politika	p o l i t i k ɒ
<|HUN|>portás	p o r t aː ʃ
<|HUN|>pozíciója	p o z iː t͡s i j oː j ɒ
<|HUN|>probléma	p r o b l eː m ɒ
<|HUN|>professzora	p r o f ɛ sː o r ɒ
<|HUN|>profi	p r o f i
<|HUN|>programra	p r o ɡ r ɒ m r ɒ
<|HUN|>pszichológia	p s i ɦ o l oː ɡ i j ɒ
<|HUN|>pupilla	p u p i lː ɒ
<|HUN|>párduc	p aː r d u t͡s
<|HUN|>páva	p aː v ɒ
<|HUN|>pénzem	p eː n z ɛ m
<|HUN|>rasszizmus	r ɒ sː i z m u ʃ
<|HUN|>református	r ɛ f o r m aː t u ʃ
<|HUN|>rejtély	r ɛ j t eː j
<|HUN|>reklám	r ɛ k l aː m
<|HUN|>reklámszoftver	r ɛ k l aː m s o f t v ɛ r
<|HUN|>rendet	r ɛ n d ɛ t
<|HUN|>rendszerek	r ɛ n t s ɛ r ɛ k
<|HUN|>rendszernek	r ɛ n t s ɛ r n ɛ k
<|HUN|>reád	r ɛ aː d
<|HUN|>részekre	r eː s ɛ k r ɛ
<|HUN|>részleteit	r eː s l ɛ t ɛ j i t
<|HUN|>részletek	r eː s l ɛ t ɛ k
<|HUN|>róna	r oː n ɒ
<|HUN|>rögtön	r ø k t ø n
<|HUN|>rúd	r uː d
<|HUN|>sajtótájékoztatón	ʃ ɒ j t oː t aː j eː k o s t ɒ t oː n
<|HUN|>sebaj	ʃ ɛ b ɒ j
<|HUN|>segítettem	ʃ ɛ ɡ iː t ɛ tː ɛ m
<|HUN|>segítséget	ʃ ɛ ɡ iː t͡ʃː eː ɡ ɛ t
<|HUN|>segítése	ʃ ɛ ɡ iː t eː ʃ ɛ
<|HUN|>segítő	ʃ ɛ ɡ iː t øː
<|HUN|>semmiképp	ʃ ɛ mː i k eː pː
<|HUN|>semmit	ʃ ɛ mː i t
<|HUN|>sikerül	ʃ i k ɛ r y l
<|HUN|>soron	ʃ o r o n
<|HUN|>sorozatban	ʃ o r o z ɒ d b ɒ n
<|HUN|>sorozatokat	ʃ o r o z ɒ t o k ɒ t
<|HUN|>spirituális	ʃ p i r i t u aː l i ʃ
<|HUN|>sport	ʃ p o r t
<|HUN|>spárga	ʃ p aː r ɡ ɒ
<|HUN|>statisztikai	ʃ t ɒ t i s t i k ɒ j i
<|HUN|>strand	ʃ t r ɒ n d
<|HUN|>szabadnak	s ɒ b ɒ d n ɒ k
<|HUN|>szabadok	s ɒ b ɒ d o k
<|HUN|>szabadság	s ɒ b ɒ t͡ʃː aː ɡ
<|HUN|>szabályozás	s ɒ b aː j o z aː ʃ
<|HUN|>szakember	s ɒ k ɛ m b ɛ r
<|HUN|>szakrális	s ɒ k r aː l i ʃ
<|HUN|>szakszervezeti	s ɒ k s ɛ r v ɛ z ɛ t i
<|HUN|>szavát	s ɒ v aː t
<|HUN|>szelleme	s ɛ lː ɛ m ɛ
<|HUN|>szellős	s ɛ lː øː ʃ
<|HUN|>személy	s ɛ m eː j
<|HUN|>szentelt	s ɛ n t ɛ l t
<|HUN|>szerda	s ɛ r d ɒ
<|HUN|>szeretem	s ɛ r ɛ t ɛ m
<|HUN|>szerkesztett	s ɛ r k ɛ s t ɛ tː
<|HUN|>szervesen	s ɛ r v ɛ ʃ ɛ n
<|HUN|>szerzetes	s ɛ r z ɛ t ɛ ʃ
<|HUN|>szinte	s i n t ɛ
<|HUN|>szobra	s o b r ɒ
<|HUN|>szobát	s o b aː t
<|HUN|>szociális	s o t͡s i j aː l i ʃ
<|HUN|>szolgálatot	s o l ɡ aː l ɒ t o t
<|HUN|>szolgálhat	s o l ɡ aː l ɦ ɒ t
<|HUN|>szolgálnak	s o l ɡ aː l n ɒ k
<|HUN|>szolnok	s o l n o k
<|HUN|>szponzorok	s p o n z o r o k
<|HUN|>szállítás	s aː lː iː t aː ʃ
<|HUN|>számolja	s aː m o jː ɒ
<|HUN|>számítástechnikai	s aː m iː t aː ʃ t ɛ x n i k ɒ j i
<|HUN|>századi	s aː z ɒ d i
<|HUN|>százszorszépek	s aː sː o r s eː p ɛ k
<|HUN|>székel	s eː k ɛ l
<|HUN|>színekben	s iː n ɛ ɡ b ɛ n
<|HUN|>színvonalon	s iː ɱ v o n ɒ l o n
<|HUN|>szót	s oː t
<|HUN|>szőlő	s øː l øː
<|HUN|>szűz	s yː z
<|HUN|>sávos	ʃ aː v o ʃ
<|HUN|>sávszélesség	ʃ aː f s eː l ɛ ʃː eː ɡ
<|HUN|>sírva	ʃ iː r v ɒ
<|HUN|>talpraesett	t ɒ l p r ɒ ɛ ʃ ɛ tː
<|HUN|>tanfolyam	t ɒ ɱ f o j ɒ m
<|HUN|>tantárgyak	t ɒ n t aː r ɟ ɒ k
<|HUN|>tanácsi	t ɒ n aː t͡ʃ i
<|HUN|>tanácskozás	t ɒ n aː t͡ʃ k o z aː ʃ
<|HUN|>tanárok	t ɒ n aː r o k
<|HUN|>tartalom	t ɒ r t ɒ l o m
<|HUN|>tartana	t ɒ r t ɒ n ɒ
<|HUN|>tavak	t ɒ v ɒ k
<|HUN|>technikát	t ɛ x n i k aː t
<|HUN|>technológia	t ɛ x n o l oː ɡ i j ɒ
<|HUN|>technológiai	t ɛ x n o l oː ɡ i j ɒ j i
<|HUN|>technológiát	t ɛ x n o l oː ɡ i j aː t
<|HUN|>teendők	t ɛ ɛ n d øː k
<|HUN|>tegyenek	t ɛ ɟ ɛ n ɛ k
<|HUN|>tehetséges	t ɛ h ɛ t͡ʃː eː ɡ ɛ ʃ
<|HUN|>tehették	t ɛ h ɛ tː eː k
<|HUN|>tehát	t ɛ ɦ aː t
<|HUN|>teli	t ɛ l i
<|HUN|>teljesítenek	t ɛ jː ɛ ʃ iː t ɛ n ɛ k
<|HUN|>teljesül	t ɛ jː ɛ ʃ y l
<|HUN|>templom	t ɛ m p l o m
<|HUN|>terem	t ɛ r ɛ m
<|HUN|>természetes	t ɛ r m eː s ɛ t ɛ ʃ
<|HUN|>természetvédelem	t ɛ r m eː s ɛ t v eː d ɛ l ɛ m
<|HUN|>terve	t ɛ r v ɛ
<|HUN|>területe	t ɛ r y l ɛ t ɛ
<|HUN|>területei	t ɛ r y l ɛ t ɛ j i
<|HUN|>testet	t ɛ ʃ t ɛ t
<|HUN|>tetszik	t ɛ t͡sː i k
<|HUN|>tette	t ɛ tː ɛ
<|HUN|>tevékenységét	t ɛ v eː k ɛ ɲ ʃ eː ɡ eː t
<|HUN|>tipikus	t i p i k u ʃ
<|HUN|>tiszt	t i s t
<|HUN|>titka	t i t k ɒ
<|HUN|>titkot	t i t k o t
<|HUN|>tojást	t o j aː ʃ t
<|HUN|>tré	t r eː
<|HUN|>trójai	t r oː j ɒ j i
<|HUN|>tudatos	t u d ɒ t o ʃ
<|HUN|>tudja	t u ɟː ɒ
<|HUN|>tudniuk	t u d n i j u k
<|HUN|>tudod	t u d o d
<|HUN|>tudom	t u d o m
<|HUN|>tudomány	t u d o m aː ɲ
<|HUN|>tudományos	t u d o m aː ɲ o ʃ
<|HUN|>tudsz	t u t͡sː
<|HUN|>tudás	t u d aː ʃ
<|HUN|>tudásukat	t u d aː ʃ u k ɒ t
<|HUN|>táblázat	t aː b l aː z ɒ t
<|HUN|>tájékoztató	t aː j eː k o s t ɒ t oː
<|HUN|>támogatásokat	t aː m o ɡ ɒ t aː ʃ o k ɒ t
<|HUN|>tárca	t aː r t͡s ɒ
<|HUN|>tárgyaló	t aː r ɟ ɒ l oː
<|HUN|>társulás	t aː r ʃ u l aː ʃ
<|HUN|>távolsági	t aː v o l ʃ aː ɡ i
<|HUN|>tél	t eː l
<|HUN|>témája	t eː m aː j ɒ
<|HUN|>tények	t eː ɲ ɛ k
<|HUN|>tényező	t eː ɲ ɛ z øː
<|HUN|>tényleges	t eː ɲ l ɛ ɡ ɛ ʃ
<|HUN|>térséggel	t eː r ʃ eː ɡː ɛ l
<|HUN|>tét	t eː t
<|HUN|>többféle	t ø p f eː l ɛ
<|HUN|>többször	t ø p s ø r
<|HUN|>tölteni	t ø l t ɛ n i
<|HUN|>tömegben	t ø m ɛ ɡ b ɛ n
<|HUN|>tör	t ø r
<|HUN|>történelmi	t ø r t eː n ɛ l m i
<|HUN|>törvények	t ø r v eː ɲ ɛ k
<|HUN|>túlnyomó	t uː l ɲ o m oː
<|HUN|>túr	t uː r
<|HUN|>tükrözi	t y k r ø z i
<|HUN|>tükörreflexes	t y k ø rː ɛ f l ɛ k s ɛ ʃ
<|HUN|>tőke	t øː k ɛ
<|HUN|>ugranak	u ɡ r ɒ n ɒ k
<|HUN|>ugyanezt	u ɟ ɒ n ɛ s t
<|HUN|>ukrajna	u k r ɒ j n ɒ
<|HUN|>utak	u t ɒ k
<|HUN|>utas	u t ɒ ʃ
<|HUN|>utat	u t ɒ t
<|HUN|>utca	u t͡sː ɒ
<|HUN|>utcára	u t͡sː aː r ɒ
<|HUN|>utánoz	u t aː n o z
<|HUN|>utólagos	u t oː l ɒ ɡ o ʃ
<|HUN|>valamennyien	v ɒ l ɒ m ɛ ɲː i j ɛ n
<|HUN|>valamennyiünk	v ɒ l ɒ m ɛ ɲː i j y ŋ k
<|HUN|>valamilyen	v ɒ l ɒ m i j ɛ n
<|HUN|>vallások	v ɒ lː aː ʃ o k
<|HUN|>vannak	v ɒ nː ɒ k
<|HUN|>varga	v ɒ r ɡ ɒ
<|HUN|>vasárnap	v ɒ ʃ aː r n ɒ p
<|HUN|>veleszületett	v ɛ l ɛ s y l ɛ t ɛ tː
<|HUN|>vendégek	v ɛ n d eː ɡ ɛ k
<|HUN|>vernek	v ɛ r n ɛ k
<|HUN|>veszem	v ɛ s ɛ m
<|HUN|>vettünk	v ɛ tː y ŋ k
<|HUN|>vezetnek	v ɛ z ɛ t n ɛ k
<|HUN|>vezérigazgató	v ɛ z eː r i ɡ ɒ z ɡ ɒ t oː
<|HUN|>videót	v i d ɛ oː t
<|HUN|>vidéki	v i d eː k i
<|HUN|>viktor	v i k t o r
<|HUN|>világ	v i l aː ɡ
<|HUN|>világossá	v i l aː ɡ o ʃː aː
<|HUN|>viszonthallásra	v i s o n t h ɒ lː aː ʃ r ɒ
<|HUN|>vizet	v i z ɛ t
<|HUN|>vonat	v o n ɒ t
<|HUN|>vonták	v o n t aː k
<|HUN|>vonzza	v o n z ɒ
<|HUN|>vágya	v aː ɟ ɒ
<|HUN|>választhat	v aː l ɒ s t h ɒ t
<|HUN|>választható	v aː l ɒ s t h ɒ t oː
<|HUN|>választások	v aː l ɒ s t aː ʃ o k
<|HUN|>választók	v aː l ɒ s t oː k
<|HUN|>vállalkozások	v aː lː ɒ l k o z aː ʃ o k
<|HUN|>vállalkozó	v aː lː ɒ l k o z oː
<|HUN|>válni	v aː l n i
<|HUN|>válogatott	v aː l o ɡ ɒ t o tː
<|HUN|>változat	v aː l t o z ɒ t
<|HUN|>változást	v aː l t o z aː ʃ t
<|HUN|>várják	v aː r j aː k
<|HUN|>várjátok	v aː r j aː t o k
<|HUN|>végbe	v eː ɡ b ɛ
<|HUN|>végrehajtani	v eː ɡ r ɛ ɦ ɒ j t ɒ n i
<|HUN|>végzetes	v eː ɡ z ɛ t ɛ ʃ
<|HUN|>vélemény	v eː l ɛ m eː ɲ
<|HUN|>vér	v eː r
<|HUN|>víz	v iː z
<|HUN|>who	v eː ɦ aː oː
<|HUN|>zenészek	z ɛ n eː s ɛ k
<|HUN|>zichy	z i t͡ʃ i
<|HUN|>zárták	z aː r t aː k
<|HUN|>állampolgári	aː lː ɒ m p o l ɡ aː r i
<|HUN|>állnak	aː l n ɒ k
<|HUN|>állott	aː lː o tː
<|HUN|>álláspontját	aː lː aː ʃ p o ɲ c aː t
<|HUN|>állítása	aː lː iː t aː ʃ ɒ
<|HUN|>álmát	aː l m aː t
<|HUN|>álom	aː l o m
<|HUN|>ártatlanok	aː r t ɒ t l ɒ n o k
<|HUN|>áru	aː r u
<|HUN|>árut	aː r u t
<|HUN|>áshat	aː ʃ h ɒ t
<|HUN|>ásnak	aː ʃ n ɒ k
<|HUN|>átkelőhely	aː t k ɛ l øː ɦ ɛ j
<|HUN|>édesanyja	eː d ɛ ʃ ɒ ɲː ɒ
<|HUN|>édesapja	eː d ɛ ʃ ɒ p j ɒ
<|HUN|>élelme	eː l ɛ l m ɛ
<|HUN|>életem	eː l ɛ t ɛ m
<|HUN|>életmódot	eː l ɛ t m oː d o t
<|HUN|>életveszélyes	eː l ɛ t v ɛ s eː j ɛ ʃ
<|HUN|>életút	eː l ɛ t uː t
<|HUN|>én	eː n
<|HUN|>érik	eː r i k
<|HUN|>érmünk	eː r m y ŋ k
<|HUN|>ért	eː r t
<|HUN|>értenek	eː r t ɛ n ɛ k
<|HUN|>értékelés	eː r t eː k ɛ l eː ʃ
<|HUN|>érzelmi	eː r z ɛ l m i
<|HUN|>érzik	eː r z i k
<|HUN|>érzékenység	eː r z eː k ɛ ɲ ʃ eː ɡ
<|HUN|>érzés	eː r z eː ʃ
<|HUN|>északra	eː s ɒ k r ɒ
<|HUN|>évtized	eː f t i z ɛ d
<|HUN|>évtizede	eː f t i z ɛ d ɛ
<|HUN|>évvel	eː vː ɛ l
<|HUN|>ígéretet	iː ɡ eː r ɛ t ɛ t
<|HUN|>ígéri	iː ɡ eː r i
<|HUN|>íjászok	iː j aː s o k
<|HUN|>írj	iː r ʝ
<|HUN|>írást	iː r aː ʃ t
<|HUN|>írónő	iː r oː n øː
<|HUN|>összes	ø sː ɛ ʃ
<|HUN|>összesen	ø sː ɛ ʃ ɛ n
<|HUN|>övék	ø v eː k
<|HUN|>újból	uː j b oː l
<|HUN|>újjászületett	uː jː aː s y l ɛ t ɛ tː
<|HUN|>újjáépítés	uː jː aː j eː p iː t eː ʃ
<|HUN|>újnak	uː j n ɒ k
<|HUN|>újra	uː j r ɒ
<|HUN|>újságban	uː j ʃ aː ɡ b ɒ n
<|HUN|>útján	uː cː aː n
<|HUN|>útvonal	uː t v o n ɒ l
<|HUN|>ügyekben	y ɟ ɛ ɡ b ɛ n
<|HUN|>ügyes	y ɟ ɛ ʃ
<|HUN|>ügyfeleink	y c f ɛ l ɛ j i ŋ k
<|HUN|>ügyészség	y ɟ eː ʃː eː ɡ
<|HUN|>ült	y l t
<|HUN|>ünnepélyes	y nː ɛ p eː j ɛ ʃ
<|HUN|>ütközet	y t k ø z ɛ t
<|HUN|>üzleti	y z l ɛ t i
<|HUN|>ők	øː k
<|HUN|>őrizetbe	øː r i z ɛ d b ɛ
<|HUN|>őt	øː t
