<|РУС|>явственно	j a f s t vʲ i n a
<|РУС|>гомер	ɡ a mʲ e r
<|РУС|>сплетавший	s p lʲ i t a f ʂ i j
<|РУС|>усыновляйте	u s i n a v lʲ a j tʲ e
<|РУС|>льда	lʲ d a
<|РУС|>прозвучишь	p r a z v u t͡ɕ i ʂ
<|РУС|>сатирах	s a tʲ i r a x
<|РУС|>ремиксов	rʲ i mʲ i k s a f
<|РУС|>залепляю	z a lʲ i p lʲ a j u
<|РУС|>абсорбированиями	a p s a r bʲ i r a v a nʲ i j a mʲ i
<|РУС|>плавкою	p ɫ a f k a j u
<|РУС|>зашумит	z a ʂ u mʲ i t
<|РУС|>мужененавистничествам	m u ʐ i nʲ i n a vʲ i sʲ nʲ i t͡ɕ i s t v a m
<|РУС|>золотистым	z a ɫ a tʲ i s t i m
<|РУС|>катерочках	k a tʲ i r o t͡ɕ k a x
<|РУС|>смеялось	s mʲ i j a ɫ a sʲ
<|РУС|>замыслу	z a m i s ɫ u
<|РУС|>семиугольника	sʲ i mʲ i u ɡ o lʲ nʲ i k a
<|РУС|>присягнувши	p rʲ i sʲ i ɡ n u f ʂ i
<|РУС|>поносят	p a n o sʲ a t
<|РУС|>изучитесь	i z u t͡ɕ i tʲ i sʲ
<|РУС|>помойкою	p a m o j k a j u
<|РУС|>англицизациею	a n ɡ lʲ i t͡s i z a t͡s i j i j u
<|РУС|>прыщавый	p r i ɕː a v i j
<|РУС|>усопла	u s o p ɫ a
<|РУС|>полетать	p a lʲ i t a tʲ
<|РУС|>укутывающий	u k u t i v a j u ɕː i j
<|РУС|>муруй	m u r u j
<|РУС|>суммируешь	s u mʲ i r u j i ʂ
<|РУС|>секта	sʲ e k t a
<|РУС|>заклейте	z a k lʲ e j tʲ e
<|РУС|>амилазой	a mʲ i ɫ a z a j
<|РУС|>посодействовать	p a s a dʲ e j s t v a v a tʲ
<|РУС|>опьянивший	a p ⁽ʲ ⁾ j i nʲ i f ʂ i j
<|РУС|>заговаривайтесь	z a ɡ a v a rʲ i v a j tʲ i sʲ
<|РУС|>ужесточения	u ʐ i s t a t͡ɕ e nʲ i j a
<|РУС|>расправах	r a s p r a v a x
<|РУС|>летный	lʲ e t n i j
<|РУС|>дубу	d u b u
<|РУС|>загадит	z a ɡ a dʲ i t
<|РУС|>пропитайтесь	p r a pʲ i t a j tʲ i sʲ
<|РУС|>отсчётах	a t͡ɕ ɕː o t a x
<|РУС|>десницу	dʲ i sʲ nʲ i t͡s u
<|РУС|>обуевала	a b u j i v a ɫ a
<|РУС|>вертлуг	vʲ i r t ɫ u k
<|РУС|>навевавший	n a vʲ i v a f ʂ i j
<|РУС|>полиграфиях	p a lʲ i ɡ r a fʲ i j a x
<|РУС|>западаешь	z a p a d a j i ʂ
<|РУС|>дозрею	d a z rʲ e j u
<|РУС|>взыскиваете	v z i s kʲ i v a j i tʲ e
<|РУС|>изъянами	i z j a n a mʲ i
<|РУС|>метафизику	mʲ i t a fʲ i zʲ i k u
<|РУС|>веселеешь	vʲ i sʲ i lʲ e j i ʂ
<|РУС|>технократию	tʲ i x n a k r a tʲ i j u
<|РУС|>пригородом	p rʲ i ɡ a r a d a m
<|РУС|>пионеров	pʲ i a nʲ e r a f
<|РУС|>поручительством	p a r u t͡ɕ i tʲ i lʲ s t v a m
<|РУС|>гостьях	ɡ o sʲ tʲ j a x
<|РУС|>подтягиваюсь	p a tʲː a ɡʲ i v a j u sʲ
<|РУС|>присчитывай	p rʲ i ɕː i t i v a j
<|РУС|>оттаяло	a t a j i ɫ a
<|РУС|>опушалась	a p u ʂ a ɫ a sʲ
<|РУС|>поклонничество	p a k ɫ o nʲ i t͡ɕ i s t v a
<|РУС|>аблаутов	a b ɫ a u t a f
<|РУС|>отекаю	a tʲ i k a j u
<|РУС|>стипендий	sʲ tʲ i pʲ e nʲ dʲ i j
<|РУС|>кромкой	k r o m k a j
<|РУС|>вляпался	v lʲ a p a ɫ s ⁽ʲ ⁾ a
<|РУС|>уверовать	u vʲ e r a v a tʲ
<|РУС|>тускневши	t u s k nʲ e f ʂ i
<|РУС|>прокалываешь	p r a k a ɫ i v a j i ʂ
<|РУС|>сконфузят	s k a n f u zʲ a t
<|РУС|>извиняли	i z vʲ i nʲ a lʲ i
<|РУС|>пофигизмами	p a fʲ i ɡʲ i z m a mʲ i
<|РУС|>мурзиками	m u r zʲ i k a mʲ i
<|РУС|>реквизициями	rʲ i k vʲ i zʲ i t͡s i j a mʲ i
<|РУС|>администрациях	a d mʲ i nʲ i s t r a t͡s i j a x
<|РУС|>оттащила	a t a ɕː i ɫ a
<|РУС|>сроднивший	s r a dʲ nʲ i f ʂ i j
<|РУС|>недолюбливайте	nʲ i d a lʲ u b lʲ i v a j tʲ e
<|РУС|>множится	m n o ʐ i t͡s a
<|РУС|>нарды	n a r d i
<|РУС|>истеки	i sʲ tʲ i kʲ i
<|РУС|>правоохранительный	p r a v a a x r a nʲ i tʲ i lʲ n i j
<|РУС|>выскабливая	v i s k a b lʲ i v a j a
<|РУС|>аудите	a u dʲ i tʲ e
<|РУС|>обвил	a b vʲ i ɫ
<|РУС|>шепнув	ʂ i p n u f
<|РУС|>горкой	ɡ o r k a j
<|РУС|>флексийный	f lʲ i k sʲ i j n i j
<|РУС|>святою	s vʲ i t o j u
<|РУС|>кастаньеты	k a s t a nʲ j e t i
<|РУС|>подействовать	p a dʲ e j s t v a v a tʲ
<|РУС|>кебабах	kʲ i b a b a x
<|РУС|>оживляйтесь	a ʐ i v lʲ a j tʲ i sʲ
<|РУС|>осклабляю	a s k ɫ a b lʲ a j u
<|РУС|>уклонении	u k ɫ a nʲ e nʲ i i
<|РУС|>адекватностях	a d i k v a t n a sʲ tʲ a x
<|РУС|>анализирует	a n a lʲ i zʲ i r u j i t
<|РУС|>лосося	ɫ a s o sʲ a
<|РУС|>бабосам	b a b o s a m
<|РУС|>восстанут	v a s t a n u t
<|РУС|>красив	k r a sʲ i f
<|РУС|>чайковский	t͡ɕ i j k o f s kʲ i j
<|РУС|>асинхронный	a sʲ i n x r o n i j
<|РУС|>мировыми	mʲ i r a v i mʲ i
<|РУС|>вакансию	v a k a n ⁽ʲ ⁾ sʲ i j u
<|РУС|>водяного	v a dʲ i n o v a
<|РУС|>обросший	a b r o ʂ i j
<|РУС|>текилах	tʲ i kʲ i ɫ a x
<|РУС|>насаждавши	n a s a ʐ d a f ʂ i
<|РУС|>дискетах	dʲ i s kʲ e t a x
<|РУС|>приплясывать	p rʲ i p lʲ a s i v a tʲ
<|РУС|>плешь	p lʲ e ʂ
<|РУС|>предъявится	p rʲ i d j a vʲ i t͡s a
<|РУС|>размягчаемый	r a z mʲ i x t͡ɕ a j i m i j
<|РУС|>запрягут	z a p rʲ i ɡ u t
<|РУС|>настучав	n a s t u t͡ɕ a f
<|РУС|>губерниях	ɡ u bʲ e r nʲ i j a x
<|РУС|>унесётесь	u nʲ i sʲ o tʲ i sʲ
<|РУС|>раскачиваемся	r a s k a t͡ɕ i v a j i m sʲ a
<|РУС|>больнаи	b a lʲ n a i
<|РУС|>помазанников	p a m a z a nʲ i k a f
<|РУС|>нумерацией	n u mʲ i r a t͡s i j i j
<|РУС|>изготовлением	i z ɡ a t a v lʲ e nʲ i j i m
<|РУС|>держава	dʲ i r ʐ a v a
<|РУС|>умиришь	u mʲ i rʲ i ʂ
<|РУС|>убежим	u bʲ i ʐ i m
<|РУС|>доводят	d a v o dʲ a t
<|РУС|>отбудьте	a d b u tʲː e
<|РУС|>хиты	xʲ i t i
<|РУС|>силаче	sʲ i ɫ a t͡ɕ e
<|РУС|>прерывавши	p rʲ i r i v a f ʂ i
<|РУС|>зондируем	z a nʲ dʲ i r u j i m
<|РУС|>упроси	u p r a sʲ i
<|РУС|>гирям	ɡʲ i rʲ a m
<|РУС|>назначении	n a z n a t͡ɕ e nʲ i i
<|РУС|>облепляемый	a b lʲ i p lʲ a j i m i j
<|РУС|>реабилитируем	rʲ i a bʲ i lʲ i tʲ i r u j i m
<|РУС|>ликбезам	lʲ i ɡ bʲ e z a m
<|РУС|>мотылькам	m a t i lʲ k a m
<|РУС|>ускоришься	u s k o rʲ i ʂ sʲ a
<|РУС|>фасолей	f a s o lʲ i j
<|РУС|>дуэта	d u e t a
<|РУС|>мимикрий	mʲ i mʲ i k rʲ i j
<|РУС|>мейтнериев	mʲ i j tʲ nʲ e rʲ i j i f
<|РУС|>склеило	s k lʲ e i ɫ a
<|РУС|>буревестника	b u rʲ i vʲ e sʲ nʲ i k a
<|РУС|>благоустрой	b ɫ a ɡ a u s t r o j
<|РУС|>заглинизированности	z a ɡ lʲ i nʲ i zʲ i r a v a n a sʲ tʲ i
<|РУС|>укреплений	u k rʲ i p lʲ e nʲ i j
<|РУС|>гостю	ɡ o sʲ tʲ u
<|РУС|>сгущаюсь	z ɡ u ɕː a j u sʲ
<|РУС|>разговляются	r a z ɡ a v lʲ a j u t͡s a
<|РУС|>биотоксичность	bʲ i a t a k sʲ i t͡ɕ n a sʲ tʲ
<|РУС|>клавдия	k ɫ a v dʲ i j a
<|РУС|>деканаты	d i k a n a t i
<|РУС|>возобновите	v a z a b n a vʲ i tʲ e
<|РУС|>укрылся	u k r i ɫ s ⁽ʲ ⁾ a
<|РУС|>рожаете	r a ʐ a j i tʲ e
<|РУС|>угрожающий	u ɡ r a ʐ a j u ɕː i j
<|РУС|>толковании	t a ɫ k a v a nʲ i i
<|РУС|>деревяшкой	dʲ i rʲ i vʲ a ʂ k a j
<|РУС|>сачкуйте	s a t͡ɕ k u j tʲ e
<|РУС|>гвардейца	ɡ v a r dʲ e j t͡s a
<|РУС|>завешивайте	z a vʲ e ʂ i v a j tʲ e
<|РУС|>висело	vʲ i sʲ e ɫ a
<|РУС|>капибарами	k a pʲ i b a r a mʲ i
<|РУС|>растило	r a sʲ tʲ i ɫ a
<|РУС|>вазочками	v a z a t͡ɕ k a mʲ i
<|РУС|>льдинок	lʲ dʲ i n a k
<|РУС|>туземцами	t u zʲ e m t͡s a mʲ i
<|РУС|>чахотке	t͡ɕ i x o t kʲ e
<|РУС|>привстающий	p rʲ i f s t a j u ɕː i j
<|РУС|>реликта	rʲ i lʲ i k t a
<|РУС|>отдалять	a d a lʲ a tʲ
<|РУС|>блумфонтейн	b ɫ u m f a n t i j n
<|РУС|>отставший	a t͡s s t a f ʂ i j
<|РУС|>токсичный	t a k sʲ i t͡ɕ n i j
<|РУС|>валенком	v a lʲ i n k a m
<|РУС|>приземлявшийся	p rʲ i zʲ i m lʲ a f ʂ i j sʲ a
<|РУС|>невежественна	nʲ i vʲ e ʐ i s t vʲ i n a
<|РУС|>артистка	a r tʲ i s t k a
<|РУС|>шампуня	ʂ a m p u nʲ a
<|РУС|>негодованию	nʲ i ɡ a d a v a nʲ i j u
<|РУС|>приготовлением	p rʲ i ɡ a t a v lʲ e nʲ i j i m
<|РУС|>магнатов	m a ɡ n a t a f
<|РУС|>вступлениях	f s t u p lʲ e nʲ i j a x
<|РУС|>окопа	a k o p a
<|РУС|>озарила	a z a rʲ i ɫ a
<|РУС|>отворачивающийся	a t v a r a t͡ɕ i v a j u ɕː i j sʲ a
<|РУС|>простудивши	p r a s t u dʲ i f ʂ i
<|РУС|>комиссиями	k a mʲ i sʲ i j a mʲ i
<|РУС|>расхищав	r a s xʲ i ɕː a f
<|РУС|>нарекла	n a rʲ i k ɫ a
<|РУС|>сровняйте	s r a v nʲ a j tʲ e
<|РУС|>осияваешь	a sʲ i j i v a j i ʂ
<|РУС|>инактивирую	i n a k tʲ i vʲ i r u j u
<|РУС|>умудрит	u m u d rʲ i t
<|РУС|>гуглите	ɡ u ɡ lʲ i tʲ e
<|РУС|>пропитывав	p r a pʲ i t i v a f
<|РУС|>самоцвета	s a m a t͡s vʲ e t a
<|РУС|>толстяком	t a ɫ s ⁽ʲ ⁾ tʲ i k o m
<|РУС|>всклокоченный	f s k ɫ a k o t͡ɕ i n i j
<|РУС|>нервничавший	nʲ e r v nʲ i t͡ɕ i f ʂ i j
<|РУС|>борющийся	b o rʲ u ɕː i j sʲ a
<|РУС|>зачитывайся	z a t͡ɕ i t i v a j sʲ a
<|РУС|>остужав	a s t u ʐ a f
<|РУС|>лосьонам	ɫ a sʲ j o n a m
<|РУС|>вальцующий	v a lʲ t͡s u j u ɕː i j
<|РУС|>распиная	r a s pʲ i n a j a
<|РУС|>топазу	t a p a z u
<|РУС|>телетекстах	tʲ e lʲ i tʲ e k s t a x
<|РУС|>подзаголовков	p a d͡z z a ɡ a ɫ o f k a f
<|РУС|>ревел	rʲ i vʲ e ɫ
<|РУС|>благословимся	b ɫ a ɡ a s ɫ a vʲ i m sʲ a
<|РУС|>какую	k a k u j u
<|РУС|>зажглись	z a ʐ ɡ lʲ i sʲ
<|РУС|>орошу	a r a ʂ u
<|РУС|>шарахать	ʂ a r a x a tʲ
<|РУС|>руководств	r u k a v o t͡s t f
<|РУС|>клянчу	k lʲ a nʲ t͡ɕ u
<|РУС|>зацепляло	z a t͡s i p lʲ a ɫ a
<|РУС|>абаданце	a b a d a n t͡s i
<|РУС|>реяв	rʲ e j i f
<|РУС|>ранетки	r a nʲ e t kʲ i
<|РУС|>покладая	p a k ɫ a d a j a
<|РУС|>предпишем	p rʲ i t pʲ i ʂ i m
<|РУС|>бороздим	b a r a zʲ dʲ i m
<|РУС|>нуворишам	n u v a rʲ i ʂ a m
<|РУС|>арке	a r kʲ e
<|РУС|>взбегав	v z bʲ i ɡ a f
<|РУС|>гуманизме	ɡ u m a nʲ i z mʲ e
<|РУС|>рожью	r o ʐ j u
<|РУС|>гидраты	ɡʲ i d r a t i
<|РУС|>доверительностям	d a vʲ i rʲ i tʲ i lʲ n a sʲ tʲ a m
<|РУС|>холодавши	x a ɫ a d a f ʂ i
<|РУС|>тюльпана	tʲ u lʲ p a n a
<|РУС|>выкрасило	v i k r a sʲ i ɫ a
<|РУС|>взвинчивал	v z vʲ i nʲ t͡ɕ i v a ɫ
<|РУС|>вуй	v u j
<|РУС|>маразмы	m a r a z m i
<|РУС|>дисгармониею	dʲ i z ɡ a r m o nʲ i j i j u
<|РУС|>ломаку	ɫ a m a k u
<|РУС|>памятей	p a mʲ i tʲ i j
<|РУС|>вседозволенностях	f sʲ i d a z v o lʲ i n a sʲ tʲ a x
<|РУС|>куркумой	k u r k u m a j
<|РУС|>тушуй	t u ʂ u j
<|РУС|>заносит	z a n o sʲ i t
<|РУС|>киноаппаратом	kʲ i n a a p a r a t a m
<|РУС|>припоминаешь	p rʲ i p a mʲ i n a j i ʂ
<|РУС|>зевал	zʲ i v a ɫ
<|РУС|>накалывать	n a k a ɫ i v a tʲ
<|РУС|>контрактниках	k a n t r a k tʲ nʲ i k a x
<|РУС|>обучавшийся	a b u t͡ɕ a f ʂ i j sʲ a
<|РУС|>упоминаются	u p a mʲ i n a j u t͡s a
<|РУС|>абдеритами	a b dʲ i rʲ i t a mʲ i
<|РУС|>теребейчук	tʲ i rʲ i bʲ i j t͡ɕ u k
<|РУС|>учугов	u t͡ɕ u ɡ a f
<|РУС|>изведав	i z vʲ e d a f
<|РУС|>дополнивший	d a p o ɫ nʲ i f ʂ i j
<|РУС|>давлениям	d a v lʲ e nʲ i j a m
<|РУС|>приколоть	p rʲ i k a ɫ o tʲ
<|РУС|>колосьям	k a ɫ o sʲ j a m
<|РУС|>монголом	m a n ɡ o ɫ a m
<|РУС|>высевок	v i sʲ i v a k
<|РУС|>затешешь	z a tʲ e ʂ i ʂ
<|РУС|>дураков	d u r a k o f
<|РУС|>коренившись	k a rʲ i nʲ i f ʂ i sʲ
<|РУС|>тулии	t u lʲ i i
<|РУС|>выкраиваются	v i k r a i v a j u t͡s a
<|РУС|>мнений	m nʲ e nʲ i j
<|РУС|>просветлевший	p r a s vʲ i t lʲ e f ʂ i j
<|РУС|>первые	pʲ e r v i j e
<|РУС|>буханке	b u x a n kʲ e
<|РУС|>светиться	s vʲ i tʲ i t͡s a
<|РУС|>завораживать	z a v a r a ʐ i v a tʲ
<|РУС|>епитрахилей	j i pʲ i t r a xʲ i lʲ i j
<|РУС|>статейкой	s t a tʲ e j k a j
<|РУС|>вмазывай	v m a z i v a j
<|РУС|>прощанья	p r a ɕː a nʲ j a
<|РУС|>кочевнике	k a t͡ɕ e v nʲ i kʲ e
<|РУС|>хлебцем	x lʲ e p t͡s i m
<|РУС|>употребляли	u p a t rʲ i b lʲ a lʲ i
<|РУС|>хадиса	x a dʲ i s a
<|РУС|>ощетинила	a ɕː i tʲ i nʲ i ɫ a
<|РУС|>сочинением	s a t͡ɕ i nʲ e nʲ i j i m
<|РУС|>приползать	p rʲ i p a ɫ z a tʲ
<|РУС|>съедутся	s j e d u t͡s a
<|РУС|>цесарем	t͡s e s a rʲ i m
<|РУС|>сосною	s a s n o j u
<|РУС|>патрульному	p a t r u lʲ n a m u
<|РУС|>гобелене	ɡ a bʲ i lʲ e nʲ e
<|РУС|>анусах	a n u s a x
<|РУС|>исписывало	i s pʲ i s i v a ɫ a
<|РУС|>бесноватыми	bʲ i s n a v a t i mʲ i
<|РУС|>ризе	rʲ i zʲ e
<|РУС|>террористе	t i r a rʲ i sʲ tʲ e
<|РУС|>прислужили	p rʲ i s ɫ u ʐ i lʲ i
<|РУС|>ослихам	a s ⁽ʲ ⁾ lʲ i x a m
<|РУС|>артистке	a r tʲ i s t kʲ e
<|РУС|>облюю	a b lʲ u j u
<|РУС|>вкрадывалась	f k r a d i v a ɫ a sʲ
<|РУС|>перетекли	pʲ i rʲ i tʲ i k lʲ i
<|РУС|>поправишь	p a p r a vʲ i ʂ
<|РУС|>окаю	o k a j u
<|РУС|>резнями	rʲ i zʲ nʲ a mʲ i
<|РУС|>подворотне	p a d v a r o tʲ nʲ e
<|РУС|>жажда	ʐ a ʐ d a
<|РУС|>прожидях	p r o ʐ i dʲ a x
<|РУС|>хаяли	x a j i lʲ i
<|РУС|>свечнике	s vʲ i t͡ɕ nʲ i kʲ e
<|РУС|>обнажите	a b n a ʐ i tʲ e
<|РУС|>раздвинулись	r a z d vʲ i n u lʲ i sʲ
<|РУС|>подметайте	p a d mʲ i t a j tʲ e
<|РУС|>скороговорка	s k a r a ɡ a v o r k a
<|РУС|>осмотрами	a s m o t r a mʲ i
<|РУС|>крошенный	k r o ʂ i n i j
<|РУС|>растревоживают	r a s t rʲ i v o ʐ i v a j u t
<|РУС|>загар	z a ɡ a r
<|РУС|>толкалось	t a ɫ k a ɫ a sʲ
<|РУС|>сердцебиениях	sʲ i r t͡s i bʲ i j e nʲ i j a x
<|РУС|>обветшалый	a b vʲ i t͡ʂ ʂ a ɫ i j
<|РУС|>трактуете	t r a k t u j i tʲ e
<|РУС|>ненадобный	nʲ i n a d a b n i j
<|РУС|>слёзы	s ⁽ʲ ⁾ lʲ o z i
<|РУС|>перетягивавши	pʲ i rʲ i tʲ a ɡʲ i v a f ʂ i
<|РУС|>ободам	o b a d a m
<|РУС|>увезёшь	u vʲ i zʲ o ʂ
<|РУС|>преградивший	p rʲ i ɡ r a dʲ i f ʂ i j
<|РУС|>засвистим	z a s vʲ i sʲ tʲ i m
<|РУС|>киноактрисой	kʲ i n a a k t rʲ i s a j
<|РУС|>уединявшись	u j i dʲ i nʲ a f ʂ i sʲ
<|РУС|>активизируете	a k tʲ i vʲ i zʲ i r u j i tʲ e
<|РУС|>огонькам	a ɡ a nʲ k a m
<|РУС|>дымили	d i mʲ i lʲ i
<|РУС|>аккомпанировали	a k a m p a nʲ i r a v a lʲ i
<|РУС|>бутилируют	b u tʲ i lʲ i r u j u t
<|РУС|>владиславом	v ɫ a dʲ i s ɫ a v a m
<|РУС|>толкнёшь	t a ɫ k nʲ o ʂ
<|РУС|>затирая	z a tʲ i r a j a
<|РУС|>пользованиях	p o lʲ z a v a nʲ i j a x
<|РУС|>прапорщик	p r a p a r ɕː i k
<|РУС|>соревнуйтесь	s a rʲ i v n u j tʲ i sʲ
<|РУС|>фабрикую	f a b rʲ i k u j u
<|РУС|>восприняла	v a s p rʲ i nʲ i ɫ a
<|РУС|>похоронишь	p a x a r o nʲ i ʂ
<|РУС|>сходна	s x o d n a
<|РУС|>возвышенно	v a z v i ʂ i n a
<|РУС|>автогене	a f t a ɡʲ e nʲ e
<|РУС|>промокавший	p r a m a k a f ʂ i j
<|РУС|>перегрелись	pʲ i rʲ i ɡ rʲ e lʲ i sʲ
<|РУС|>подготовляйте	p a d ɡ a t a v lʲ a j tʲ e
<|РУС|>потребностях	p a t rʲ e b n a sʲ tʲ a x
<|РУС|>одаривая	a d a rʲ i v a j a
<|РУС|>чугунно	t͡ɕ u ɡ u n a
<|РУС|>отваживаемся	a t v a ʐ i v a j i m sʲ a
<|РУС|>презумпциями	p rʲ i z u m p t͡s i j a mʲ i
<|РУС|>расстраивался	r a s t r a i v a ɫ s ⁽ʲ ⁾ a
<|РУС|>довлело	d a v lʲ e ɫ a
<|РУС|>смрадишь	s m r a dʲ i ʂ
<|РУС|>адсорбировав	a t͡s s a r bʲ i r a v a f
<|РУС|>рефракторе	rʲ i f r a k t a rʲ e
<|РУС|>излияниями	i z ⁽ʲ ⁾ lʲ i j a nʲ i j a mʲ i
<|РУС|>гобеленами	ɡ a bʲ i lʲ e n a mʲ i
<|РУС|>приглядывавшийся	p rʲ i ɡ lʲ a d i v a f ʂ i j sʲ a
<|РУС|>эксцессов	i k s t͡s e s a f
<|РУС|>взяточникам	v zʲ a t a t͡ɕ nʲ i k a m
<|РУС|>потёрла	p a tʲ o r ɫ a
<|РУС|>абстрактам	a p s t r a k t a m
<|РУС|>сосками	s o s k a mʲ i
<|РУС|>брёха	b rʲ o x a
<|РУС|>поблагодарить	p a b ɫ a ɡ a d a rʲ i tʲ
<|РУС|>жучков	ʐ u t͡ɕ k o f
<|РУС|>осечкам	a sʲ e t͡ɕ k a m
<|РУС|>специализмы	s pʲ i t͡s i a lʲ i z m i
<|РУС|>сертификата	sʲ i r tʲ i fʲ i k a t a
<|РУС|>гонореи	ɡ a n a rʲ e i
<|РУС|>украдёшь	u k r a dʲ o ʂ
<|РУС|>воздадите	v a z d a dʲ i tʲ e
<|РУС|>прожигаем	p r a ʐ i ɡ a j i m
<|РУС|>бутафорией	b u t a f o rʲ i j i j
<|РУС|>дисциплинировала	dʲ i s t͡s i p lʲ i nʲ i r a v a ɫ a
<|РУС|>осунется	a s u nʲ i t͡s a
<|РУС|>виновницах	vʲ i n o v nʲ i t͡s a x
<|РУС|>питомце	pʲ i t o m t͡s i
<|РУС|>замяло	z a mʲ a ɫ a
<|РУС|>порочили	p a r o t͡ɕ i lʲ i
<|РУС|>деточка	dʲ e t a t͡ɕ k a
<|РУС|>пересказываем	pʲ i rʲ i s k a z i v a j i m
<|РУС|>башке	b a ʂ kʲ e
<|РУС|>поблагодарим	p a b ɫ a ɡ a d a rʲ i m
<|РУС|>дублёнки	d u b lʲ o n kʲ i
<|РУС|>развернувший	r a z vʲ i r n u f ʂ i j
<|РУС|>противоположу	p r o tʲ i v a p a ɫ a ʐ u
<|РУС|>нюхальщики	nʲ u x a lʲ ɕː i kʲ i
<|РУС|>озари	a z a rʲ i
<|РУС|>отчужу	a t͡ɕ u ʐ u
<|РУС|>буферах	b u fʲ i r a x
<|РУС|>дотягивающийся	d a tʲ a ɡʲ i v a j u ɕː i j sʲ a
<|РУС|>венчания	vʲ i nʲ t͡ɕ a nʲ i j a
<|РУС|>окупленный	a k u p lʲ i n i j
<|РУС|>построит	p a s t r o i t
<|РУС|>уязвляя	u j i z v lʲ a j a
<|РУС|>поговорите	p a ɡ a v a rʲ i tʲ e
<|РУС|>царевна	t͡s a rʲ e v n a
<|РУС|>болте	b a ɫ tʲ e
<|РУС|>забил	z a bʲ i ɫ
<|РУС|>люкс	lʲ u k s
<|РУС|>сбило	z bʲ i ɫ a
<|РУС|>чаячий	t͡ɕ a j i t͡ɕ i j
<|РУС|>надававший	n a d a v a f ʂ i j
<|РУС|>конку	k o n k u
<|РУС|>усмехаясь	u s mʲ i x a j i sʲ
<|РУС|>привязь	p rʲ i vʲ i sʲ
<|РУС|>парадигмам	p a r a dʲ i ɡ m a m
<|РУС|>зачёркиваем	z a t͡ɕ o r kʲ i v a j i m
<|РУС|>сущностью	s u ɕː n a sʲ tʲ j u
<|РУС|>подмечавший	p a d mʲ i t͡ɕ a f ʂ i j
<|РУС|>реек	rʲ e j i k
<|РУС|>просветишь	p r a s vʲ e tʲ i ʂ
<|РУС|>нидерландского	nʲ i dʲ i r ɫ a n t s k a v a
<|РУС|>поладив	p a ɫ a dʲ i f
<|РУС|>новоангличанах	n o v a a n ɡ lʲ i t͡ɕ a n a x
<|РУС|>пожирает	p a ʐ i r a j i t
<|РУС|>тарифов	t a rʲ i f a f
<|РУС|>насчёт	n a ɕː o t
<|РУС|>распускавшись	r a s p u s k a f ʂ i sʲ
<|РУС|>забывался	z a b i v a ɫ s ⁽ʲ ⁾ a
<|РУС|>оклемаетесь	a k lʲ i m a j i tʲ i sʲ
<|РУС|>провозя	p r a v a zʲ a
<|РУС|>уделах	u dʲ e ɫ a x
<|РУС|>вытряхивает	v i t rʲ a xʲ i v a j i t
<|РУС|>затрудни	z a t r u dʲ nʲ i
<|РУС|>принимавшись	p rʲ i nʲ i m a f ʂ i sʲ
<|РУС|>прокладывающий	p r a k ɫ a d i v a j u ɕː i j
<|РУС|>русифицируешься	r u sʲ i fʲ i t͡s i r u j i ʂ sʲ a
<|РУС|>створу	s t v o r u
<|РУС|>расходовали	r a s x o d a v a lʲ i
<|РУС|>зачаровав	z a t͡ɕ i r a v a f
<|РУС|>чемпионами	t͡ɕ i m ⁽ʲ ⁾ pʲ i o n a mʲ i
<|РУС|>расчёсывалась	r a ɕ t͡ɕ o s i v a ɫ a sʲ
<|РУС|>заревом	z a rʲ i v a m
<|РУС|>неформально	nʲ i f a r m a lʲ n a
<|РУС|>отслеживает	a t͡s s ⁽ʲ ⁾ lʲ e ʐ i v a j i t
<|РУС|>приглядываем	p rʲ i ɡ lʲ a d i v a j i m
<|РУС|>брюссельский	b rʲ u sʲ e lʲ s kʲ i j
<|РУС|>роках	r o k a x
<|РУС|>раскручивало	r a s k r u t͡ɕ i v a ɫ a
<|РУС|>челнок	t͡ɕ i ɫ n o k
<|РУС|>ремешкам	rʲ i mʲ i ʂ k a m
<|РУС|>ведавший	vʲ e d a f ʂ i j
<|РУС|>иволгою	i v a ɫ ɡ a j u
<|РУС|>колледж	k o lʲ i t͡ʂ ʂ
<|РУС|>проверив	p r a vʲ e rʲ i f
<|РУС|>микросхемы	mʲ i k r a s xʲ e m i
<|РУС|>выясняешь	v i j i sʲ nʲ a j i ʂ
<|РУС|>надколеннике	n a t k a lʲ e nʲ i kʲ e
<|РУС|>перекусят	pʲ i rʲ i k u sʲ a t
<|РУС|>покрученный	p a k r u t͡ɕ i n i j
<|РУС|>затирав	z a tʲ i r a f
<|РУС|>перечтём	pʲ i rʲ i t͡ɕ tʲ o m
<|РУС|>подданству	p o d a n s t v u
<|РУС|>выливался	v i lʲ i v a ɫ s ⁽ʲ ⁾ a
<|РУС|>порастёт	p a r a sʲ tʲ o t
<|РУС|>провайдеры	p r a v a j d i r i
<|РУС|>полемику	p a lʲ e mʲ i k u
<|РУС|>переломлю	pʲ i rʲ i ɫ a m lʲ u
<|РУС|>разъём	r a z j o m
<|РУС|>изменяло	i z mʲ i nʲ a ɫ a
<|РУС|>абсорбатам	a p s a r b a t a m
<|РУС|>писателями	pʲ i s a tʲ i lʲ a mʲ i
<|РУС|>лад	ɫ a t
<|РУС|>ахи	a xʲ i
<|РУС|>извлекут	i z v lʲ i k u t
<|РУС|>взбираетесь	v z bʲ i r a j i tʲ i sʲ
<|РУС|>фотокарточками	f a t a k a r t a t͡ɕ k a mʲ i
<|РУС|>объедаемый	a b j i d a j i m i j
<|РУС|>завалитесь	z a v a lʲ i tʲ i sʲ
<|РУС|>закладывай	z a k ɫ a d i v a j
<|РУС|>урезывав	u rʲ e z i v a f
<|РУС|>приделать	p rʲ i dʲ e ɫ a tʲ
<|РУС|>переставить	pʲ i rʲ i s t a vʲ i tʲ
<|РУС|>кремниев	k rʲ e m nʲ i j i f
<|РУС|>всовавши	f s a v a f ʂ i
<|РУС|>цингою	t͡s i n ɡ o j u
<|РУС|>криптонов	k rʲ i p t o n a f
<|РУС|>гомони	ɡ a m a nʲ i
<|РУС|>думаем	d u m a j i m
<|РУС|>повязанный	p a vʲ a z a n i j
<|РУС|>застрелив	z a s t rʲ i lʲ i f
<|РУС|>апограф	a p o ɡ r a f
<|РУС|>подсолнухе	p a t͡s s o ɫ n u xʲ e
<|РУС|>прививай	p rʲ i vʲ i v a j
<|РУС|>буккеры	b u kʲ i r i
<|РУС|>юмористическая	j u m a rʲ i sʲ tʲ i t͡ɕ i s k a j a
<|РУС|>выдворявши	v i d v a rʲ a f ʂ i
<|РУС|>подлодке	p a d ɫ o t kʲ e
<|РУС|>лапали	ɫ a p a lʲ i
<|РУС|>отщепляйте	a t͡ɕ ɕː i p lʲ a j tʲ e
<|РУС|>заведованием	z a vʲ e d a v a nʲ i j i m
<|РУС|>смудрит	s m u d rʲ i t
<|РУС|>здесь	zʲ dʲ e sʲ
<|РУС|>заимейте	z a i mʲ e j tʲ e
<|РУС|>кувшинках	k u f ʂ i n k a x
<|РУС|>покатаешь	p a k a t a j i ʂ
<|РУС|>подшипникам	p a t͡ʂ ʂ i p nʲ i k a m
<|РУС|>несбыточный	nʲ i z b i t a t͡ɕ n i j
<|РУС|>стоил	s t o i ɫ
<|РУС|>заебать	z a j i b a tʲ
<|РУС|>заразятся	z a r a zʲ a t͡s a
<|РУС|>спросонок	s p r a s o n a k
<|РУС|>заперлись	z a pʲ i r lʲ i sʲ
<|РУС|>героинях	ɡʲ i r a i nʲ a x
<|РУС|>мучу	m u t͡ɕ u
<|РУС|>запираюсь	z a pʲ i r a j u sʲ
<|РУС|>непогрешимый	nʲ i p a ɡ rʲ i ʂ i m i j
<|РУС|>пакистанцы	p a kʲ i s t a n t͡s i
<|РУС|>повертит	p a vʲ e r tʲ i t
<|РУС|>епархия	j i p a r xʲ i j a
<|РУС|>покрышка	p a k r i ʂ k a
<|РУС|>театре	tʲ i a t a rʲ e
<|РУС|>тучности	t u t͡ɕ n a sʲ tʲ i
<|РУС|>спёр	s pʲ o r
<|РУС|>вставишься	f s t a vʲ i ʂ sʲ a
<|РУС|>выправлять	v i p r a v lʲ a tʲ
<|РУС|>ветшаем	vʲ i t͡ʂ ʂ a j i m
<|РУС|>надушу	n a d u ʂ u
<|РУС|>лизнув	lʲ i z n u f
<|РУС|>опасения	a p a sʲ e nʲ i j a
<|РУС|>переливает	pʲ i rʲ i lʲ i v a j i t
<|РУС|>чувствуйте	t͡ɕ u s t v u j tʲ e
<|РУС|>осушал	a s u ʂ a ɫ
<|РУС|>вводимся	v o dʲ i m sʲ a
<|РУС|>секунды	sʲ i k u n d i
<|РУС|>походом	p a x o d a m
<|РУС|>осведомляющийся	a s vʲ i d a m lʲ a j u ɕː i j sʲ a
<|РУС|>плюрализмам	p lʲ u r a lʲ i z m a m
<|РУС|>звенеть	z vʲ i nʲ e tʲ
<|РУС|>пейджер	p e j d͡ʐ ʐ i r
<|РУС|>повалила	p a v a lʲ i ɫ a
<|РУС|>аскетом	a s kʲ e t a m
<|РУС|>синтеза	sʲ i n t i z a
<|РУС|>киноплёнках	kʲ i n a p lʲ o n k a x
<|РУС|>клетку	k lʲ e t k u
<|РУС|>отворачиваюсь	a t v a r a t͡ɕ i v a j u sʲ
<|РУС|>закопушкой	z a k a p u ʂ k a j
<|РУС|>преобразовывавшийся	p rʲ i a b r a z o v i v a f ʂ i j sʲ a
<|РУС|>отборы	a d b o r i
<|РУС|>алкинов	a ɫ kʲ i n a f
<|РУС|>треклистах	t r i k lʲ i s t a x
<|РУС|>обнадёживай	a b n a dʲ o ʐ i v a j
<|РУС|>постылевший	p a s t i lʲ i f ʂ i j
<|РУС|>накалялась	n a k a lʲ a ɫ a sʲ
<|РУС|>горячностей	ɡ a rʲ a t͡ɕ n a sʲ tʲ i j
<|РУС|>отворачивай	a t v a r a t͡ɕ i v a j
<|РУС|>симулируй	sʲ i m u lʲ i r u j
<|РУС|>туманностях	t u m a n a sʲ tʲ a x
<|РУС|>усложняем	u s ɫ a ʐ nʲ a j i m
<|РУС|>разгоняете	r a z ɡ a nʲ a j i tʲ e
<|РУС|>трансляциям	t r a n s ⁽ʲ ⁾ lʲ a t͡s i j a m
<|РУС|>ударяемся	u d a rʲ a j i m sʲ a
<|РУС|>осмысливаемый	a s m i s ⁽ʲ ⁾ lʲ i v a j i m i j
<|РУС|>властолюбия	v ɫ a s t a lʲ u bʲ i j a
<|РУС|>залепляя	z a lʲ i p lʲ a j a
<|РУС|>волокут	v a ɫ a k u t
<|РУС|>шаромыгой	ʂ a r a m i ɡ a j
<|РУС|>черемшах	t͡ɕ i rʲ i m ʂ a x
<|РУС|>остротой	a s t r o t a j
<|РУС|>дружественен	d r u ʐ i s t vʲ i nʲ i n
<|РУС|>ассемблера	a s e m b lʲ i r a
<|РУС|>попросись	p a p r a sʲ i sʲ
<|РУС|>темпераментами	tʲ i m ⁽ʲ ⁾ pʲ i r a mʲ i n t a mʲ i
<|РУС|>утком	u t k o m
<|РУС|>пробурчала	p r a b u r t͡ɕ a ɫ a
<|РУС|>опробованный	a p r o b a v a n i j
<|РУС|>потаскушки	p a t a s k u ʂ kʲ i
<|РУС|>заискивали	z a i s kʲ i v a lʲ i
<|РУС|>гидрологиях	ɡʲ i d r a ɫ o ɡʲ i j a x
<|РУС|>спокойствии	s p a k o j s t vʲ i i
<|РУС|>табличку	t a b lʲ i t͡ɕ k u
<|РУС|>информационный	i n f a r m a t͡s i o n i j
<|РУС|>потопталось	p a t a p t a ɫ a sʲ
<|РУС|>интерпретированный	i n t i r p rʲ i tʲ i r a v a n i j
<|РУС|>кусаем	k u s a j i m
<|РУС|>насылаем	n a s i ɫ a j i m
<|РУС|>сталкиваюсь	s t a ɫ kʲ i v a j u sʲ
<|РУС|>накапливаем	n a k a p lʲ i v a j i m
<|РУС|>систола	sʲ i s t a ɫ a
<|РУС|>миньетчиком	mʲ i nʲ j e t͡ɕ i k a m
<|РУС|>краткам	k r a t k a m
<|РУС|>арумынкой	a r u m i n k a j
<|РУС|>вырисовываться	v i rʲ i s o v i v a t͡s a
<|РУС|>обидами	a bʲ i d a mʲ i
<|РУС|>состряпаете	s a s t rʲ a p a j i tʲ e
<|РУС|>одышка	a d i ʂ k a
<|РУС|>тротуару	t r a t u a r u
<|РУС|>безобразием	bʲ i z a b r a zʲ i j i m
<|РУС|>выспрашиваемый	v i s p r a ʂ i v a j i m i j
<|РУС|>плацента	p ɫ a t͡s e n t a
<|РУС|>фургону	f u r ɡ o n u
<|РУС|>выворачиваете	v i v a r a t͡ɕ i v a j i tʲ e
<|РУС|>выражен	v i r a ʐ i n
<|РУС|>соизволением	s a i z v a lʲ e nʲ i j i m
<|РУС|>раздельно	r a zʲ dʲ e lʲ n a
<|РУС|>олимпийкою	a lʲ i m ⁽ʲ ⁾ pʲ i j k a j u
<|РУС|>сформулировал	s f a r m u lʲ i r a v a ɫ
<|РУС|>вскинул	f s kʲ i n u ɫ
<|РУС|>переболевала	pʲ i rʲ i b a lʲ i v a ɫ a
<|РУС|>съязвил	s j i z vʲ i ɫ
<|РУС|>должные	d o ɫ ʐ n i j e
<|РУС|>вытворяешь	v i t v a rʲ a j i ʂ
<|РУС|>поведываете	p a vʲ e d i v a j i tʲ e
<|РУС|>пригибают	p rʲ i ɡʲ i b a j u t
<|РУС|>сигало	sʲ i ɡ a ɫ a
<|РУС|>опаску	a p a s k u
<|РУС|>амбра	a m b r a
<|РУС|>катране	k a t r a nʲ e
<|РУС|>снашивала	s n a ʂ i v a ɫ a
<|РУС|>смыкал	s m i k a ɫ
<|РУС|>сигналю	sʲ i ɡ n a lʲ u
<|РУС|>разрознивши	r a z r o zʲ nʲ i f ʂ i
<|РУС|>заменялись	z a mʲ i nʲ a lʲ i sʲ
<|РУС|>ухаживавши	u x a ʐ i v a f ʂ i
<|РУС|>налегке	n a lʲ i xʲ kʲ e
<|РУС|>жидкостями	ʐ i t k a sʲ tʲ a mʲ i
<|РУС|>свинина	s vʲ i nʲ i n a
<|РУС|>рисовал	rʲ i s a v a ɫ
<|РУС|>ливийка	lʲ i vʲ i j k a
<|РУС|>чохой	t͡ɕ i x o j
<|РУС|>аллюзиями	a lʲ u zʲ i j a mʲ i
<|РУС|>шумов	ʂ u m a f
<|РУС|>хачике	x a t͡ɕ i kʲ e
<|РУС|>текил	tʲ i kʲ i ɫ
<|РУС|>понудит	p a n u dʲ i t
<|РУС|>самосвалах	s a m a s v a ɫ a x
<|РУС|>вскриков	f s k rʲ i k a f
<|РУС|>силиконы	sʲ i lʲ i k o n i
<|РУС|>плевав	p lʲ i v a f
<|РУС|>тыква	t i k v a
<|РУС|>распространяйся	r a s p r a s t r a nʲ a j sʲ a
<|РУС|>варьируют	v a rʲ j i r u j u t
<|РУС|>интриган	i n t rʲ i ɡ a n
<|РУС|>просвещай	p r a s vʲ i ɕː a j
<|РУС|>завернуть	z a vʲ i r n u tʲ
<|РУС|>поживавший	p a ʐ i v a f ʂ i j
<|РУС|>адсорбируя	a t͡s s a r bʲ i r u j a
<|РУС|>оперативностью	a pʲ i r a tʲ i v n a sʲ tʲ j u
<|РУС|>пополнять	p a p a ɫ nʲ a tʲ
<|РУС|>врезаете	v rʲ i z a j i tʲ e
<|РУС|>приятны	p rʲ i j a t n i
<|РУС|>утопаем	u t o p a j i m
<|РУС|>поели	p a j e lʲ i
<|РУС|>манкой	m a n k a j
<|РУС|>садит	s a dʲ i t
<|РУС|>опушавшись	a p u ʂ a f ʂ i sʲ
<|РУС|>антидоте	a nʲ tʲ i d o tʲ e
<|РУС|>комбинируешь	k a m ⁽ʲ ⁾ bʲ i nʲ i r u j i ʂ
<|РУС|>сопроводишь	s a p r a v a dʲ i ʂ
<|РУС|>нормированиями	n a r mʲ i r a v a nʲ i j a mʲ i
<|РУС|>кувшинку	k u f ʂ i n k u
<|РУС|>досадовавший	d a s a d a v a f ʂ i j
<|РУС|>орешь	o rʲ i ʂ
<|РУС|>пригодность	p rʲ i ɡ o d n a sʲ tʲ
<|РУС|>сыроваров	s i r a v a r a f
<|РУС|>октябрь	a k tʲ a b rʲ
<|РУС|>прожёвываемый	p r a ʐ o v i v a j i m i j
<|РУС|>касайтесь	k a s a j tʲ i sʲ
<|РУС|>женит	ʐ e nʲ i t
<|РУС|>жёрнов	ʐ o r n a f
<|РУС|>отпугивало	a t p u ɡʲ i v a ɫ a
<|РУС|>файликах	f a j lʲ i k a x
<|РУС|>изобарою	i z a b a r a j u
<|РУС|>размежует	r a z mʲ i ʐ u j i t
<|РУС|>опушайся	a p u ʂ a j sʲ a
<|РУС|>баклага	b a k ɫ a ɡ a
<|РУС|>категоричностей	k a tʲ i ɡ a rʲ i t͡ɕ n a sʲ tʲ i j
<|РУС|>выводкам	v i v a t k a m
<|РУС|>взвешивавши	v z vʲ e ʂ i v a f ʂ i
<|РУС|>проиграешь	p r a i ɡ r a j i ʂ
<|РУС|>энергоносители	i n e r ɡ a n a sʲ i tʲ i lʲ i
<|РУС|>погрешу	p a ɡ rʲ i ʂ u
<|РУС|>промахах	p r o m a x a x
<|РУС|>опером	o pʲ i r a m
<|РУС|>заела	z a j e ɫ a
<|РУС|>котировать	k a tʲ i r a v a tʲ
<|РУС|>неустроенностям	nʲ i u s t r o j i n a sʲ tʲ a m
<|РУС|>подчёркивают	p a t͡ɕ o r kʲ i v a j u t
<|РУС|>генетикам	ɡʲ i n e tʲ i k a m
<|РУС|>каскадам	k a s k a d a m
<|РУС|>вкладывают	f k ɫ a d i v a j u t
<|РУС|>питону	pʲ i t o n u
<|РУС|>искалечило	i s k a lʲ e t͡ɕ i ɫ a
<|РУС|>неумерен	nʲ i u mʲ e rʲ i n
<|РУС|>финансировало	fʲ i n a n ⁽ʲ ⁾ sʲ i r a v a ɫ a
<|РУС|>общо	a p ɕː o
<|РУС|>вампирах	v a m ⁽ʲ ⁾ pʲ i r a x
<|РУС|>выловят	v i ɫ a vʲ a t
<|РУС|>наноса	n a n o s a
<|РУС|>присмотрев	p rʲ i s m a t rʲ e f
<|РУС|>богословы	b a ɡ a s ɫ o v i
<|РУС|>расстилавши	r a sʲ tʲ i ɫ a f ʂ i
<|РУС|>искорёжило	i s k a rʲ o ʐ i ɫ a
<|РУС|>отчисляем	a t͡ɕ i s ⁽ʲ ⁾ lʲ a j i m
<|РУС|>выдачею	v i d a t͡ɕ i j u
<|РУС|>родословными	r a d a s ɫ o v n i mʲ i
<|РУС|>околёсицах	a k a lʲ o sʲ i t͡s a x
<|РУС|>мораторий	m a r a t o rʲ i j
<|РУС|>штрафовал	ʂ t r a f a v a ɫ
<|РУС|>заутрень	z a u t rʲ i nʲ
<|РУС|>придаваемый	p rʲ i d a v a j i m i j
<|РУС|>сдавило	z d a vʲ i ɫ a
<|РУС|>стремянку	s t rʲ i mʲ a n k u
<|РУС|>времечке	v rʲ e mʲ i t͡ɕ kʲ e
<|РУС|>понимаетесь	p a nʲ i m a j i tʲ i sʲ
<|РУС|>присудим	p rʲ i s u dʲ i m
<|РУС|>скорректировал	s k a rʲ i k tʲ i r a v a ɫ
<|РУС|>искусите	i s k u sʲ i tʲ e
<|РУС|>свергала	s vʲ i r ɡ a ɫ a
<|РУС|>трудовой	t r u d a v o j
<|РУС|>заблагорассудим	z a b ɫ a ɡ a r a s u dʲ i m
<|РУС|>пожелтеем	p a ʐ i ɫ tʲ e j i m
<|РУС|>грузимый	ɡ r u zʲ i m i j
<|РУС|>спарывали	s p a r i v a lʲ i
<|РУС|>востоковедам	v a s t a k a vʲ e d a m
<|РУС|>правобережный	p r a v a bʲ i rʲ e ʐ n i j
<|РУС|>жерлах	ʐ e r ɫ a x
<|РУС|>бесполезный	bʲ i s p a lʲ e z n i j
<|РУС|>выпрямлял	v i p rʲ i m lʲ a ɫ
<|РУС|>вытряхнешь	v i t rʲ i x nʲ i ʂ
<|РУС|>ватка	v a t k a
<|РУС|>садку	s a t k u
<|РУС|>заколебать	z a k a lʲ i b a tʲ
<|РУС|>разживалась	r a ʐ i v a ɫ a sʲ
<|РУС|>ворвитесь	v a r vʲ i tʲ i sʲ
<|РУС|>задремлют	z a d rʲ e m lʲ u t
<|РУС|>раскраской	r a s k r a s k a j
<|РУС|>курский	k u r s kʲ i j
<|РУС|>гувернантку	ɡ u vʲ i r n a n t k u
<|РУС|>бризантностях	b rʲ i z a n t n a sʲ tʲ a x
<|РУС|>дружила	d r u ʐ i ɫ a
<|РУС|>контроллера	k a n t r o lʲ i r a
<|РУС|>оканчивавшись	a k a nʲ t͡ɕ i v a f ʂ i sʲ
<|РУС|>тупишь	t u pʲ i ʂ
<|РУС|>библиотекарша	bʲ i b lʲ i a tʲ e k a r ʂ a
<|РУС|>сраженью	s r a ʐ e nʲ j u
<|РУС|>кошелях	k a ʂ i lʲ a x
<|РУС|>вкалывая	f k a ɫ i v a j a
<|РУС|>сливами	s ⁽ʲ ⁾ lʲ i v a mʲ i
<|РУС|>полутьмах	p a ɫ u tʲ m a x
<|РУС|>выдают	v i d a j u t
<|РУС|>путаюсь	p u t a j u sʲ
<|РУС|>совратили	s a v r a tʲ i lʲ i
<|РУС|>мановении	m a n a vʲ e nʲ i i
<|РУС|>матрасами	m a t r a s a mʲ i
<|РУС|>лесоматериалам	lʲ e s a m a tʲ i rʲ i a ɫ a m
<|РУС|>привяжу	p rʲ i vʲ i ʐ u
<|РУС|>деспотами	dʲ e s p a t a mʲ i
<|РУС|>пропитаниях	p r a pʲ i t a nʲ i j a x
<|РУС|>отворяв	a t v a rʲ a f
<|РУС|>мясорубками	mʲ i s a r u p k a mʲ i
<|РУС|>укутавши	u k u t a f ʂ i
<|РУС|>дынями	d i nʲ a mʲ i
<|РУС|>мудоёба	m u d a j o b a
<|РУС|>подстраховал	p a t͡s s t r a x a v a ɫ
<|РУС|>обзвонит	a b z v a nʲ i t
<|РУС|>лейкозом	lʲ i j k o z a m
<|РУС|>установит	u s t a n o vʲ i t
<|РУС|>совершатся	s a vʲ i r ʂ a t͡s a
<|РУС|>десятиугольнику	dʲ i sʲ i tʲ i u ɡ o lʲ nʲ i k u
<|РУС|>упрятав	u p rʲ a t a f
<|РУС|>щитках	ɕː i t k a x
<|РУС|>недоедавший	nʲ i d a j i d a f ʂ i j
<|РУС|>запросят	z a p r o sʲ a t
<|РУС|>лженаука	ɫ ʐ i n a u k a
<|РУС|>вёзся	vʲ o sʲ a
<|РУС|>одинока	a dʲ i n o k a
<|РУС|>выдавливая	v i d a v lʲ i v a j a
<|РУС|>котелки	k a tʲ i ɫ kʲ i
<|РУС|>придерусь	p rʲ i dʲ i r u sʲ
<|РУС|>типажах	tʲ i p a ʐ a x
<|РУС|>ангстрем	a n k s t r i m
<|РУС|>жестокий	ʐ i s t o kʲ i j
<|РУС|>посвистывали	p a s vʲ i s t i v a lʲ i
<|РУС|>удочерениях	u d a t͡ɕ i rʲ e nʲ i j a x
<|РУС|>азиками	a zʲ i k a mʲ i
<|РУС|>привинти	p rʲ i vʲ i nʲ tʲ i
<|РУС|>синхронизаций	sʲ i n x r a nʲ i z a t͡s i j
<|РУС|>заржаветь	z a r ʐ a vʲ i tʲ
<|РУС|>отлежалась	a t lʲ i ʐ a ɫ a sʲ
<|РУС|>девайсам	dʲ i v a j s a m
<|РУС|>эликсиром	i lʲ i k sʲ i r a m
<|РУС|>взмётываемый	v z mʲ o t i v a j i m i j
<|РУС|>откраиваешь	a t k r a i v a j i ʂ
<|РУС|>пионеру	pʲ i a nʲ e r u
<|РУС|>акойт	a k o j t
<|РУС|>дотаскав	d a t a s k a f
<|РУС|>завершало	z a vʲ i r ʂ a ɫ a
<|РУС|>нику	nʲ i k u
<|РУС|>разъяряете	r a z j i rʲ a j i tʲ e
<|УКР|>демократично	d ɪ m ɔ k r ɛ t ɪ t͡ʃ n ɔ
<|УКР|>самобутній	s ɛ m ɔ b u tʲ nʲ i i
<|УКР|>сатана	s ɛ t ɛ n ɑ
<|УКР|>афганський	ɛ f ɦ ɑ nʲ sʲ k ɪ i
<|УКР|>літ	lʲ i t
<|УКР|>автобусна	ɛ u t ɔ b u s n ɛ
<|УКР|>щокою	ʃ t͡ʃ ɔ k ɔ j u
<|УКР|>оленина	ɔ ɫ ɪ n ɪ n ɛ
<|УКР|>космодром	k ɔ s m ɔ d r ɔ m
<|УКР|>поступку	p ɔ s t u p k u
<|УКР|>ознайомлення	ɔ z n ɛ j ɔ m ɫ ɪ nʲ ɛ
<|УКР|>другий	d r u ɦ ɪ i
<|УКР|>свіча	sʲ ʋ i t͡ʃ ɛ
<|УКР|>капітал	k ɛ p i t ɑ ɫ
<|УКР|>ім'я	i m j ɛ
<|УКР|>насолодитися	n ɛ s ɔ ɫ ɔ d ɪ t ɪ sʲ ɛ
<|УКР|>чорт	t͡ʃ ɔ r t
<|УКР|>каплиці	k ɛ p ɫ ɪ t͡sʲ i
<|УКР|>перевиховати	p ɪ r ɪ ʋ ɪ x ɔ ʋ ɛ t ɪ
<|УКР|>свояк	s ʋ ɔ j ɑ k
<|УКР|>незалежности	n ɪ z ɛ ɫ ɛ ʒ n ɔ s t ɪ
<|УКР|>досягнення	d ɔ sʲ ɑ ɦ n ɪ nʲ ɛ
<|УКР|>ідеальний	i d ɪ ɑ lʲ n ɪ i
<|УКР|>завдяки	z ɛ u dʲ ɛ k ɪ
<|УКР|>тунелях	t u n ɛ lʲ ɛ x
<|УКР|>обговорювати	ɔ b ɦ ɔ ʋ ɔ rʲ u ʋ ɛ t ɪ
<|УКР|>лакрос	ɫ ɛ k r ɔ s
<|УКР|>занотувати	z ɛ n ɔ t u ʋ ɑ t ɪ
<|УКР|>епохи	ɪ p ɔ x ɪ
<|УКР|>неприйнятний	n ɪ p r ɪ i nʲ ɛ t n ɪ i
<|УКР|>причинний	p r ɪ t͡ʃ ɪ n ɪ i
<|УКР|>щотижневий	ʃ t͡ʃ ɔ t ɪ ʒ n ɛ ʋ ɪ i
<|УКР|>капітулювати	k ɛ p i t u lʲ u ʋ ɑ t ɪ
<|УКР|>протитанковий	p r ɔ t ɪ t ɑ n k ɔ ʋ ɪ i
<|УКР|>трактор	t r ɑ k t ɔ r
<|УКР|>конфлікт	k ɔ n f lʲ i k t
<|УКР|>лебединий	ɫ ɪ b ɪ d ɪ n ɪ i
<|УКР|>пшениця	p ʃ ɪ n ɪ t͡sʲ ɛ
<|УКР|>краб	k r ɑ b
<|УКР|>недоступний	n ɪ d ɔ s t u p n ɪ i
<|УКР|>роззброювати	r ɔ z b r ɔ j u ʋ ɛ t ɪ
<|УКР|>клавіатур	k ɫ ɛ ʋ i ɛ t u r
<|УКР|>тротуари	t r ɔ t u ɑ r ɪ
<|УКР|>ізраїльтянин	i z r ɛ j i lʲ tʲ ɑ n ɪ n
<|УКР|>чудовисько	t͡ʃ u d ɔ ʋ ɪ sʲ k ɔ
<|УКР|>уста	u s t ɑ
<|УКР|>розпочати	r ɔ z p ɔ t͡ʃ ɑ t ɪ
<|УКР|>динаміка	d ɪ n ɑ m i k ɛ
<|УКР|>госпіталізація	ɦ ɔ sʲ p i t ɛ lʲ i z ɑ t͡sʲ i j ɛ
<|УКР|>африканець	ɛ f r ɪ k ɑ n ɪ t͡sʲ
<|УКР|>повість	p ɔ ʋ i sʲ tʲ
<|УКР|>гірський	ɦ i r sʲ k ɪ i
<|УКР|>остаточний	ɔ s t ɛ t ɔ t͡ʃ n ɪ i
<|УКР|>погнати	p ɔ ɦ n ɑ t ɪ
<|УКР|>сірий	sʲ i r ɪ i
<|УКР|>покарань	p ɔ k ɛ r ɑ nʲ
<|УКР|>поширити	p ɔ ʃ ɪ r ɪ t ɪ
<|УКР|>плівка	p lʲ i u k ɛ
<|УКР|>поліціях	p ɔ lʲ i t͡sʲ i j ɛ x
<|УКР|>потворний	p ɔ t ʋ ɔ r n ɪ i
<|УКР|>мотоцикл	m ɔ t ɔ t͡s ɪ k ɫ
<|УКР|>поступки	p ɔ s t u p k ɪ
<|УКР|>позбавляти	p ɔ z b ɛ u lʲ ɑ t ɪ
<|УКР|>виснажувати	ʋ ɪ s n ɑ ʒ u ʋ ɛ t ɪ
<|УКР|>смертоносний	s m ɪ r t ɔ n ɔ s n ɪ i
<|УКР|>глава	ɦ ɫ ɛ ʋ ɑ
<|УКР|>розділ	r ɔ zʲ dʲ i ɫ
<|УКР|>поздоровляти	p ɔ z d ɔ r ɔ u lʲ ɑ t ɪ
<|УКР|>дорога	d ɔ r ɔ ɦ ɛ
<|УКР|>аналізувати	ɛ n ɛ lʲ i z u ʋ ɑ t ɪ
<|УКР|>ілюзія	i lʲ u zʲ i j ɛ
<|УКР|>персональний	p ɪ r s ɔ n ɑ lʲ n ɪ i
<|УКР|>коронавірус	k ɔ r ɔ n ɛ ʋ i r u s
<|УКР|>заспокійливий	z ɛ s p ɔ k i i ɫ ɪ ʋ ɪ i
<|УКР|>дев'яностий	d ɪ ʋ j ɛ n ɔ s t ɪ i
<|УКР|>вступати	ʋ s t u p ɑ t ɪ
<|УКР|>вибирати	ʋ ɪ b ɪ r ɑ t ɪ
<|УКР|>заручати	z ɛ r u t͡ʃ ɑ t ɪ
<|УКР|>помирати	p ɔ m ɪ r ɑ t ɪ
<|УКР|>промовляти	p r ɔ m ɔ u lʲ ɑ t ɪ
<|УКР|>мікроскоп	m i k r ɔ s k ɔ p
<|УКР|>співробітник	sʲ p i u r ɔ b i t n ɪ k
<|УКР|>номінальний	n ɔ m i n ɑ lʲ n ɪ i
<|УКР|>прибічниця	p r ɪ b i t͡ʃ n ɪ t͡sʲ ɛ
<|УКР|>день	d ɛ nʲ
<|УКР|>з'ясувати	z j ɛ s u ʋ ɑ t ɪ
<|УКР|>віртуальний	ʋ i r t u ɑ lʲ n ɪ i
<|УКР|>пересічний	p ɪ r ɪ sʲ i t͡ʃ n ɪ i
<|УКР|>співіснування	sʲ p i ʋ i s n u ʋ ɑ nʲ ɛ
<|УКР|>мелодіям	m ɪ ɫ ɔ dʲ i j ɛ m
<|УКР|>відокремити	ʋ i d ɔ k r ɛ m ɪ t ɪ
<|УКР|>процедурний	p r ɔ t͡s ɪ d u r n ɪ i
<|УКР|>алло	ɛ ɫ ɔ
<|УКР|>гіпотеза	ɦ i p ɔ t ɪ z ɛ
<|УКР|>розв'язувати	r ɔ z ʋ j ɑ z u ʋ ɛ t ɪ
<|УКР|>ті	tʲ i
<|УКР|>антидот	ɛ n t ɪ d ɔ t
<|УКР|>мовознавець	m ɔ ʋ ɔ z n ɑ ʋ ɪ t͡sʲ
<|УКР|>забобон	z ɛ b ɔ b ɔ n
<|УКР|>оренда	ɔ r ɛ n d ɛ
<|УКР|>етап	ɪ t ɑ p
<|УКР|>повіки	p ɔ ʋ i k ɪ
<|УКР|>австромарксист	ɛ u s t r ɔ m ɛ r k s ɪ s t
<|УКР|>етика	ɛ t ɪ k ɛ
<|УКР|>болгарин	b ɔ ɫ ɦ ɑ r ɪ n
<|УКР|>постать	p ɔ s t ɛ tʲ
<|УКР|>мільйон	m i lʲ j ɔ n
<|УКР|>щі	ʃ t͡ʃʲ i
<|УКР|>лавандовий	ɫ ɛ ʋ ɑ n d ɔ ʋ ɪ i
<|УКР|>шведський	ʃ ʋ ɛ d͡zʲ sʲ k ɪ i
<|УКР|>оцими	ɔ t͡s ɪ m ɪ
<|УКР|>вчитель	ʋ t͡ʃ ɪ t ɪ lʲ
<|УКР|>безжурний	b ɪ ʒ u r n ɪ i
<|УКР|>хотітися	x ɔ tʲ i t ɪ sʲ ɛ
<|УКР|>слина	s ɫ ɪ n ɛ
<|УКР|>варіантами	ʋ ɛ rʲ i ɑ n t ɛ m ɪ
<|УКР|>відчути	ʋ i d͡ʒ t͡ʃ u t ɪ
<|УКР|>перлина	p ɪ r ɫ ɪ n ɛ
<|УКР|>релігійний	r ɪ lʲ i ɦ i i n ɪ i
<|УКР|>стать	s t ɑ tʲ
<|УКР|>стримати	s t r ɪ m ɛ t ɪ
<|УКР|>випроменити	ʋ ɪ p r ɔ m ɪ n ɪ t ɪ
<|УКР|>нагромаджувати	n ɛ ɦ r ɔ m ɑ d͡ʒ u ʋ ɛ t ɪ
<|УКР|>корінь	k ɔ rʲ i nʲ
<|УКР|>класовий	k ɫ ɑ s ɔ ʋ ɪ i
<|УКР|>ворота	ʋ ɔ r ɔ t ɛ
<|УКР|>й	j
<|УКР|>дивний	d ɪ u n ɪ i
<|УКР|>відпочивати	ʋ i d p ɔ t͡ʃ ɪ ʋ ɑ t ɪ
<|УКР|>жодний	ʒ ɔ d n ɪ i
<|УКР|>змова	z m ɔ ʋ ɛ
<|УКР|>відданий	ʋ i d ɛ n ɪ i
<|УКР|>теплота	t ɪ p ɫ ɔ t ɑ
<|УКР|>хрест	x r ɛ s t
<|УКР|>овід	ɔ ʋ i d
<|УКР|>козел	k ɔ z ɛ ɫ
<|УКР|>борщ	b ɔ r ʃ t͡ʃ
<|УКР|>роділля	r ɔ dʲ i lʲ ɛ
<|УКР|>періодизаціям	p ɪ rʲ i ɔ d ɪ z ɑ t͡sʲ i j ɛ m
<|УКР|>органічна	ɔ r ɦ ɛ nʲ i t͡ʃ n ɛ
<|УКР|>вирізнятися	ʋ ɪ rʲ i zʲ nʲ ɑ t ɪ sʲ ɛ
<|УКР|>дріжджі	dʲ rʲ i ʒ d͡ʒ i
<|УКР|>крикливий	k r ɪ k ɫ ɪ ʋ ɪ i
<|УКР|>вимикати	ʋ ɪ m ɪ k ɑ t ɪ
<|УКР|>уособити	u ɔ s ɔ b ɪ t ɪ
<|УКР|>видатний	ʋ ɪ d ɛ t n ɪ i
<|УКР|>інтенсивність	i n t ɪ n s ɪ u nʲ i sʲ tʲ
<|УКР|>тощо	t ɔ ʃ t͡ʃ ɔ
<|УКР|>повсюдний	p ɔ u sʲ u d n ɪ i
<|УКР|>перезаписати	p ɪ r ɪ z ɛ p ɪ s ɑ t ɪ
<|УКР|>феє	f ɛ j ɪ
<|УКР|>менше	m ɛ n ʃ ɪ
<|УКР|>чарівник	t͡ʃ ɛ rʲ i u n ɪ k
<|УКР|>зимовий	z ɪ m ɔ ʋ ɪ i
<|УКР|>ламати	ɫ ɛ m ɑ t ɪ
<|УКР|>зара	z ɑ r ɛ
<|УКР|>науковий	n ɛ u k ɔ ʋ ɪ i
<|УКР|>авіапідживлення	ɛ ʋ i ɛ p i d͡ʒ ɪ u ɫ ɪ nʲ ɛ
<|УКР|>принизити	p r ɪ n ɪ z ɪ t ɪ
<|УКР|>брест	b r ɛ s t
<|УКР|>японіє	j ɛ p ɔ nʲ i j ɪ
<|УКР|>диктатор	d ɪ k t ɑ t ɔ r
<|УКР|>шестигранник	ʃ ɪ s t ɪ ɦ r ɑ n ɪ k
<|УКР|>авіапасажир	ɛ ʋ i ɛ p ɛ s ɛ ʒ ɪ r
<|УКР|>бельгійський	b ɪ lʲ ɦ i i sʲ k ɪ i
<|УКР|>легеня	ɫ ɪ ɦ ɛ nʲ ɛ
<|УКР|>сюди	sʲ u d ɪ
<|УКР|>охопити	ɔ x ɔ p ɪ t ɪ
<|УКР|>шинок	ʃ ɪ n ɔ k
<|УКР|>трагічний	t r ɛ ɦ i t͡ʃ n ɪ i
<|УКР|>вкус	ʋ k u s
<|УКР|>брехнями	b r ɛ x nʲ ɛ m ɪ
<|УКР|>високосний	ʋ ɪ s ɔ k ɔ s n ɪ i
<|УКР|>блокадою	b ɫ ɔ k ɑ d ɔ j u
<|УКР|>трав'яний	t r ɛ ʋ j ɛ n ɪ i
<|УКР|>заявити	z ɛ j ɛ ʋ ɪ t ɪ
<|УКР|>біржа	b i r ʒ ɛ
<|УКР|>пінистий	p i n ɪ s t ɪ i
<|УКР|>щоку	ʃ t͡ʃ ɔ k u
<|УКР|>відважний	ʋ i d ʋ ɑ ʒ n ɪ i
<|УКР|>бойко	b ɔ i k ɔ
<|УКР|>технократичний	t ɪ x n ɔ k r ɛ t ɪ t͡ʃ n ɪ i
<|УКР|>михайло	m ɪ x ɑ i ɫ ɔ
<|УКР|>упасти	u p ɑ s t ɪ
<|УКР|>таємницями	t ɛ j ɪ m n ɪ t͡sʲ ɛ m ɪ
<|УКР|>компактний	k ɔ m p ɑ k t n ɪ i
<|УКР|>епідеміологія	ɪ p i d ɪ m i ɔ ɫ ɔ ɦ i j ɛ
<|УКР|>страх	s t r ɑ x
<|УКР|>речі	r ɛ t͡ʃʲ i
<|УКР|>споживчий	s p ɔ ʒ ɪ u t͡ʃ ɪ i
<|УКР|>скаржитися	s k ɑ r ʒ ɪ t ɪ sʲ ɛ
<|УКР|>біологія	b i ɔ ɫ ɔ ɦ i j ɛ
<|УКР|>коханий	k ɔ x ɛ n ɪ i
<|УКР|>водосховище	ʋ ɔ d ɔ s x ɔ ʋ ɪ ʃ t͡ʃ ɪ
<|УКР|>атеїстичний	ɛ t ɪ j i s t ɪ t͡ʃ n ɪ i
<|УКР|>звідкись	zʲ ʋ i d k ɪ sʲ
<|УКР|>липа	ɫ ɪ p ɛ
<|УКР|>стіна	sʲ tʲ i n ɑ
<|УКР|>класти	k ɫ ɑ s t ɪ
<|УКР|>мислити	m ɪ s ɫ ɪ t ɪ
<|УКР|>аброгація	ɛ b r ɔ ɦ ɑ t͡sʲ i j ɛ
<|УКР|>джгут	d͡ʒ ɦ u t
<|УКР|>глек	ɦ ɫ ɛ k
<|УКР|>досьє	d ɔ sʲ j ɛ
<|УКР|>вулиця	ʋ u ɫ ɪ t͡sʲ ɛ
<|УКР|>еволюціонувати	ɪ ʋ ɔ lʲ u t͡sʲ i ɔ n u ʋ ɑ t ɪ
<|УКР|>цнотливий	t͡s n ɔ t ɫ ɪ ʋ ɪ i
<|УКР|>організаціє	ɔ r ɦ ɛ nʲ i z ɑ t͡sʲ i j ɪ
<|УКР|>добувати	d ɔ b u ʋ ɑ t ɪ
<|УКР|>перемир'я	p ɪ r ɪ m ɪ r j ɛ
<|УКР|>сплачувати	s p ɫ ɑ t͡ʃ u ʋ ɛ t ɪ
<|УКР|>ресторан	r ɪ s t ɔ r ɑ n
<|УКР|>мріями	m rʲ i j ɛ m ɪ
<|УКР|>паузу	p ɑ u z u
<|УКР|>емігрувати	ɪ m i ɦ r u ʋ ɑ t ɪ
<|УКР|>наймати	n ɛ i m ɑ t ɪ
<|УКР|>почати	p ɔ t͡ʃ ɑ t ɪ
<|УКР|>мікрофон	m i k r ɔ f ɔ n
<|УКР|>границя	ɦ r ɛ n ɪ t͡sʲ ɛ
<|УКР|>бидло	b ɪ d ɫ ɔ
<|УКР|>піраміда	p i r ɛ m i d ɛ
<|УКР|>бере	b ɪ r ɛ
<|УКР|>херсон	x ɪ r s ɔ n
<|УКР|>легітимація	ɫ ɪ ɦ i t ɪ m ɑ t͡sʲ i j ɛ
<|УКР|>рукою	r u k ɔ j u
<|УКР|>благий	b ɫ ɛ ɦ ɪ i
<|УКР|>позаземний	p ɔ z ɛ z ɛ m n ɪ i
<|УКР|>бувати	b u ʋ ɑ t ɪ
<|УКР|>рослина	r ɔ s ɫ ɪ n ɛ
<|УКР|>дитсадків	d ɪ t͡s ɛ dʲ k i u
<|УКР|>революція	r ɪ ʋ ɔ lʲ u t͡sʲ i j ɛ
<|УКР|>фірма	f i r m ɛ
<|УКР|>рейтузи	r ɪ i t u z ɪ
<|УКР|>легеневий	ɫ ɪ ɦ ɪ n ɛ ʋ ɪ i
<|УКР|>каштан	k ɛ ʃ t ɑ n
<|УКР|>підвищувати	p i d ʋ ɪ ʃ t͡ʃ u ʋ ɛ t ɪ
<|УКР|>спланувати	s p ɫ ɛ n u ʋ ɑ t ɪ
<|УКР|>мовити	m ɔ ʋ ɪ t ɪ
<|УКР|>турнір	t u r nʲ i r
<|УКР|>песимістичний	p ɪ s ɪ m i s t ɪ t͡ʃ n ɪ i
<|УКР|>церковний	t͡s ɪ r k ɔ u n ɪ i
<|УКР|>шаповал	ʃ ɛ p ɔ ʋ ɑ ɫ
<|УКР|>підхожий	p i d x ɔ ʒ ɪ i
<|УКР|>переорієнтувати	p ɪ r ɪ ɔ rʲ i j ɪ n t u ʋ ɑ t ɪ
<|УКР|>відсвяткувати	ʋ i d͡z sʲ ʋ ɛ t k u ʋ ɑ t ɪ
<|УКР|>тригліцерид	t r ɪ ɦ lʲ i t͡s ɪ r ɪ d
<|УКР|>безперебійний	b ɪ z p ɪ r ɪ b i i n ɪ i
<|УКР|>пісня	p i sʲ nʲ ɛ
<|УКР|>портфелях	p ɔ r t f ɛ lʲ ɛ x
<|УКР|>велосипед	ʋ ɪ ɫ ɔ s ɪ p ɛ d
<|УКР|>кончина	k ɔ n t͡ʃ ɪ n ɛ
<|УКР|>міфологія	m i f ɔ ɫ ɔ ɦ i j ɛ
<|УКР|>домашнє	d ɔ m ɑ ʃ nʲ ɪ
<|УКР|>роман	r ɔ m ɑ n
<|УКР|>патріотизмі	p ɛ tʲ rʲ i ɔ t ɪ zʲ m i
<|УКР|>авіатраса	ɛ ʋ i ɛ t r ɑ s ɛ
<|УКР|>порівняння	p ɔ rʲ i u nʲ ɑ nʲ ɛ
<|УКР|>стабільний	s t ɛ b i lʲ n ɪ i
<|УКР|>прибічник	p r ɪ b i t͡ʃ n ɪ k
<|УКР|>відвага	ʋ i d ʋ ɑ ɦ ɛ
<|УКР|>згодний	z ɦ ɔ d n ɪ i
<|УКР|>герцогиня	ɦ ɪ r t͡s ɔ ɦ ɪ nʲ ɛ
<|УКР|>акул	ɛ k u ɫ
<|УКР|>гони	ɦ ɔ n ɪ
<|УКР|>риба	r ɪ b ɛ
<|УКР|>відрізнятися	ʋ i dʲ rʲ i zʲ nʲ ɑ t ɪ sʲ ɛ
<|УКР|>навігаційний	n ɛ ʋ i ɦ ɛ t͡sʲ i i n ɪ i
<|УКР|>рушниця	r u ʃ n ɪ t͡sʲ ɛ
<|УКР|>афганістан	ɛ f ɦ ɛ nʲ i s t ɑ n
<|УКР|>освіжити	ɔ sʲ ʋ i ʒ ɪ t ɪ
<|УКР|>перевага	p ɪ r ɪ ʋ ɑ ɦ ɛ
<|УКР|>арістотель	ɛ rʲ i s t ɔ t ɪ lʲ
<|УКР|>квадратний	k ʋ ɛ d r ɑ t n ɪ i
<|УКР|>вибиратися	ʋ ɪ b ɪ r ɑ t ɪ sʲ ɛ
<|УКР|>змагатися	z m ɛ ɦ ɑ t ɪ sʲ ɛ
<|УКР|>абсолютно	ɛ b s ɔ lʲ u t n ɔ
<|УКР|>довоєнний	d ɔ ʋ ɔ j ɛ n ɪ i
<|УКР|>різноманітний	rʲ i z n ɔ m ɛ nʲ i t n ɪ i
<|УКР|>злочинець	z ɫ ɔ t͡ʃ ɪ n ɪ t͡sʲ
<|УКР|>веретено	ʋ ɪ r ɪ t ɛ n ɔ
<|УКР|>постійно	p ɔ sʲ tʲ i i n ɔ
<|УКР|>брухт	b r u x t
<|УКР|>звернення	z ʋ ɛ r n ɪ nʲ ɛ
<|УКР|>мева	m ɛ ʋ ɛ
<|УКР|>внаслідок	ʋ n ɑ sʲ lʲ i d ɔ k
<|УКР|>другові	d r u ɦ ɔ ʋ i
<|УКР|>феях	f ɛ j ɛ x
<|УКР|>чверті	t͡ʃ ʋ ɛ r tʲ i
<|УКР|>кишенькові	k ɪ ʃ ɪ nʲ k ɔ ʋ i
<|УКР|>дивізіях	d ɪ ʋ i zʲ i j ɛ x
<|УКР|>цікавий	t͡sʲ i k ɑ ʋ ɪ i
<|УКР|>критеріям	k r ɪ t ɛ rʲ i j ɛ m
<|УКР|>аероскопія	ɛ ɪ r ɔ s k ɔ p i j ɛ
<|УКР|>завершення	z ɛ ʋ ɛ r ʃ ɪ nʲ ɛ
<|УКР|>вільнодумець	ʋ i lʲ n ɔ d u m ɪ t͡sʲ
<|УКР|>скловидний	s k ɫ ɔ ʋ ɪ d n ɪ i
<|УКР|>довічний	d ɔ ʋ i t͡ʃ n ɪ i
<|УКР|>нирка	n ɪ r k ɛ
<|УКР|>ковзкий	k ɔ u z k ɪ i
<|УКР|>доброчесний	d ɔ b r ɔ t͡ʃ ɛ s n ɪ i
<|УКР|>обстежувати	ɔ b s t ɛ ʒ u ʋ ɛ t ɪ
<|УКР|>танцювати	t ɛ nʲ t͡sʲ u ʋ ɑ t ɪ
<|УКР|>опитати	ɔ p ɪ t ɑ t ɪ
<|УКР|>ради	r ɑ d ɪ
<|УКР|>слимак	s ɫ ɪ m ɑ k
<|УКР|>зелен	z ɛ ɫ ɪ n
<|УКР|>епох	ɪ p ɔ x
<|УКР|>румунський	r u m u nʲ sʲ k ɪ i
<|УКР|>грізний	ɦ rʲ i z n ɪ i
<|УКР|>ситуаціях	s ɪ t u ɑ t͡sʲ i j ɛ x
<|УКР|>безжальний	b ɪ ʒ ɑ lʲ n ɪ i
<|УКР|>така	t ɛ k ɑ
<|УКР|>драматургічний	d r ɛ m ɛ t u r ɦ i t͡ʃ n ɪ i
<|УКР|>автовласник	ɛ u t ɔ u ɫ ɑ s n ɪ k
<|УКР|>українськими	u k r ɛ j i nʲ sʲ k ɪ m ɪ
<|УКР|>город	ɦ ɔ r ɔ d
<|УКР|>унікальний	u nʲ i k ɑ lʲ n ɪ i
<|УКР|>споживання	s p ɔ ʒ ɪ ʋ ɑ nʲ ɛ
<|УКР|>посуд	p ɔ s u d
<|УКР|>нас	n ɑ s
<|УКР|>діафрагмами	dʲ i ɛ f r ɑ ɦ m ɛ m ɪ
<|УКР|>критикувати	k r ɪ t ɪ k u ʋ ɑ t ɪ
<|УКР|>болниця	b ɔ ɫ n ɪ t͡sʲ ɛ
<|УКР|>привітати	p r ɪ ʋ i t ɑ t ɪ
<|УКР|>ворожнеча	ʋ ɔ r ɔ ʒ n ɛ t͡ʃ ɛ
<|УКР|>недооцінювати	n ɪ d ɔ ɔ t͡sʲ i nʲ u ʋ ɛ t ɪ
<|УКР|>стілець	sʲ tʲ i ɫ ɛ t͡sʲ
<|УКР|>туризм	t u r ɪ z m
<|УКР|>албанія	ɛ ɫ b ɑ nʲ i j ɛ
<|УКР|>глід	ɦ lʲ i d
<|УКР|>медитація	m ɪ d ɪ t ɑ t͡sʲ i j ɛ
<|УКР|>діафрагмі	dʲ i ɛ f r ɑ ɦ m i
<|УКР|>засновник	z ɛ s n ɔ u n ɪ k
<|УКР|>скло	s k ɫ ɔ
<|УКР|>дошках	d ɔ ʃ k ɛ x
<|УКР|>кільце	k i lʲ t͡s ɛ
<|УКР|>ізумрудний	i z u m r u d n ɪ i
<|УКР|>келих	k ɛ ɫ ɪ x
<|УКР|>антибіотики	ɛ n t ɪ b i ɔ t ɪ k ɪ
<|УКР|>сукня	s u k nʲ ɛ
<|УКР|>кишенях	k ɪ ʃ ɛ nʲ ɛ x
<|УКР|>радість	r ɑ dʲ i sʲ tʲ
<|УКР|>портфеля	p ɔ r t f ɛ lʲ ɛ
<|УКР|>можна	m ɔ ʒ n ɛ
<|УКР|>різноманіття	rʲ i z n ɔ m ɛ nʲ i tʲ ɛ
<|УКР|>амбіція	ɛ m b i t͡sʲ i j ɛ
<|УКР|>родзинка	r ɔ d͡z ɪ n k ɛ
<|УКР|>ненароджений	n ɪ n ɛ r ɔ d͡ʒ ɪ n ɪ i
<|УКР|>щоко	ʃ t͡ʃ ɔ k ɔ
<|УКР|>карась	k ɛ r ɑ sʲ
<|УКР|>суспільство	s u sʲ p i lʲ s t ʋ ɔ
<|УКР|>прати	p r ɑ t ɪ
<|УКР|>серцевий	s ɪ r t͡s ɛ ʋ ɪ i
<|УКР|>щавель	ʃ t͡ʃ ɛ ʋ ɛ lʲ
<|УКР|>термометричний	t ɪ r m ɔ m ɪ t r ɪ t͡ʃ n ɪ i
<|УКР|>для	dʲ lʲ ɑ
<|УКР|>шовковий	ʃ ɔ u k ɔ ʋ ɪ i
<|УКР|>склянка	s k lʲ ɑ n k ɛ
<|УКР|>волейболістка	ʋ ɔ ɫ ɪ i b ɔ lʲ i s t k ɛ
<|УКР|>зима	z ɪ m ɑ
<|УКР|>змі	zʲ m i
<|УКР|>помста	p ɔ m s t ɛ
<|УКР|>кара	k ɑ r ɛ
<|УКР|>пархоменко	p ɛ r x ɔ m ɪ n k ɔ
<|УКР|>енергій	ɪ n ɛ r ɦ i i
<|УКР|>терпеливість	t ɪ r p ɪ ɫ ɪ ʋ i sʲ tʲ
<|УКР|>здогадуватися	z d ɔ ɦ ɑ d u ʋ ɛ t ɪ sʲ ɛ
<|УКР|>яловичину	j ɑ ɫ ɔ ʋ ɪ t͡ʃ ɪ n u
<|УКР|>динамічно	d ɪ n ɛ m i t͡ʃ n ɔ
<|УКР|>ягода	j ɑ ɦ ɔ d ɛ
<|УКР|>дієвий	dʲ i j ɛ ʋ ɪ i
<|УКР|>вижлоктати	ʋ ɪ ʒ ɫ ɔ k t ɛ t ɪ
<|УКР|>трагедія	t r ɛ ɦ ɛ dʲ i j ɛ
<|УКР|>підприємство	p i d p r ɪ j ɛ m s t ʋ ɔ
<|УКР|>теща	t ɛ ʃ t͡ʃ ɛ
<|УКР|>дебютувати	d ɪ b u t u ʋ ɑ t ɪ
<|УКР|>відчиняти	ʋ i d͡ʒ t͡ʃ ɪ nʲ ɑ t ɪ
<|УКР|>упевненість	u p ɛ u n ɪ nʲ i sʲ tʲ
<|УКР|>наявний	n ɛ j ɑ u n ɪ i
<|УКР|>комора	k ɔ m ɔ r ɛ
<|УКР|>подібність	p ɔ dʲ i b nʲ i sʲ tʲ
<|УКР|>суб'єкт	s u b j ɛ k t
<|УКР|>звідси	zʲ ʋ i d͡z s ɪ
<|УКР|>неврологія	n ɪ u r ɔ ɫ ɔ ɦ i j ɛ
<|УКР|>долонях	d ɔ ɫ ɔ nʲ ɛ x
<|УКР|>мексиканка	m ɪ k s ɪ k ɑ n k ɛ
<|УКР|>побачення	p ɔ b ɑ t͡ʃ ɪ nʲ ɛ
<|УКР|>маскат	m ɛ s k ɑ t
<|УКР|>обідати	ɔ b i d ɛ t ɪ
<|УКР|>цегла	t͡s ɛ ɦ ɫ ɛ
<|УКР|>трансформаціях	t r ɛ n s f ɔ r m ɑ t͡sʲ i j ɛ x
<|УКР|>двадцятиоднокутник	d ʋ ɛ d͡zʲ t͡sʲ ɛ t ɪ ɔ d n ɔ k u t n ɪ k
<|УКР|>підняти	p i dʲ nʲ ɑ t ɪ
<|УКР|>постатях	p ɔ s t ɛ tʲ ɛ x
<|УКР|>білий	b i ɫ ɪ i
<|УКР|>підвіконня	p i dʲ ʋ i k ɔ nʲ ɛ
<|УКР|>візовий	ʋ i z ɔ ʋ ɪ i
<|УКР|>антагонізм	ɛ n t ɛ ɦ ɔ nʲ i z m
<|УКР|>синтезувати	s ɪ n t ɪ z u ʋ ɑ t ɪ
<|УКР|>зоровий	z ɔ r ɔ ʋ ɪ i
<|УКР|>сприйняття	s p r ɪ i nʲ ɛ tʲ ɑ
<|УКР|>концепт	k ɔ n t͡s ɛ p t
<|УКР|>шанувальник	ʃ ɛ n u ʋ ɑ lʲ n ɪ k
<|УКР|>положення	p ɔ ɫ ɔ ʒ ɪ nʲ ɛ
<|УКР|>забороняти	z ɛ b ɔ r ɔ nʲ ɑ t ɪ
<|УКР|>помідор	p ɔ m i d ɔ r
<|УКР|>аборт	ɛ b ɔ r t
<|УКР|>обчислювати	ɔ b t͡ʃ ɪ sʲ lʲ u ʋ ɛ t ɪ
<|УКР|>галстук	ɦ ɑ ɫ s t u k
<|УКР|>друг	d r u ɦ
<|УКР|>скоро	s k ɔ r ɔ
<|УКР|>акцентувати	ɛ k t͡s ɪ n t u ʋ ɑ t ɪ
<|УКР|>частка	t͡ʃ ɑ s t k ɛ
<|УКР|>скроні	s k r ɔ nʲ i
<|УКР|>комедія	k ɔ m ɛ dʲ i j ɛ
<|УКР|>позиція	p ɔ z ɪ t͡sʲ i j ɛ
<|УКР|>міф	m i f
<|УКР|>ліцензія	lʲ i t͡s ɛ nʲ zʲ i j ɛ
<|УКР|>команда	k ɔ m ɑ n d ɛ
<|УКР|>арка	ɑ r k ɛ
<|УКР|>аероліт	ɛ ɪ r ɔ lʲ i t
<|УКР|>приймати	p r ɪ i m ɑ t ɪ
<|УКР|>добривечір	d ɔ b r ɪ ʋ ɛ t͡ʃʲ i r
<|УКР|>схематизувати	s x ɪ m ɛ t ɪ z u ʋ ɑ t ɪ
<|УКР|>колись	k ɔ ɫ ɪ sʲ
<|УКР|>жасмин	ʒ ɛ s m ɪ n
<|УКР|>авіаметеослужба	ɛ ʋ i ɛ m ɪ t ɪ ɔ s ɫ u ʒ b ɛ
<|УКР|>категоричний	k ɛ t ɪ ɦ ɔ r ɪ t͡ʃ n ɪ i
<|УКР|>гуцульщина	ɦ u t͡s u lʲ ʃ t͡ʃ ɪ n ɛ
<|УКР|>масть	m ɑ sʲ tʲ
<|УКР|>портативний	p ɔ r t ɛ t ɪ u n ɪ i
<|УКР|>репресивний	r ɪ p r ɪ s ɪ u n ɪ i
<|УКР|>просьба	p r ɔ zʲ b ɛ
<|УКР|>убогий	u b ɔ ɦ ɪ i
<|УКР|>безпілотний	b ɪ zʲ p i ɫ ɔ t n ɪ i
<|УКР|>лисиця	ɫ ɪ s ɪ t͡sʲ ɛ
<|УКР|>гладіатор	ɦ ɫ ɛ dʲ i ɑ t ɔ r
<|УКР|>гуманістка	ɦ u m ɛ nʲ i s t k ɛ
<|УКР|>пласт	p ɫ ɑ s t
<|УКР|>єврейський	j ɪ u r ɛ i sʲ k ɪ i
<|УКР|>волокти	ʋ ɔ ɫ ɔ k t ɪ
<|УКР|>нідерланди	nʲ i d ɪ r ɫ ɑ n d ɪ
<|УКР|>органи	ɔ r ɦ ɛ n ɪ
<|УКР|>щитоподібна	ʃ t͡ʃ ɪ t ɔ p ɔ dʲ i b n ɛ
<|УКР|>руку	r u k u
<|УКР|>тісний	tʲ i s n ɪ i
<|УКР|>журнал	ʒ u r n ɑ ɫ
<|УКР|>ліс	lʲ i s
<|УКР|>наблизити	n ɛ b ɫ ɪ z ɪ t ɪ
<|УКР|>квантова	k ʋ ɑ n t ɔ ʋ ɛ
<|УКР|>нестерпний	n ɪ s t ɛ r p n ɪ i
<|УКР|>плавець	p ɫ ɛ ʋ ɛ t͡sʲ
<|УКР|>виборами	ʋ ɪ b ɔ r ɛ m ɪ
<|УКР|>неперервний	n ɪ p ɪ r ɛ r ʋ n ɪ i
<|УКР|>тяжкий	tʲ ɛ ʒ k ɪ i
<|УКР|>експонат	ɪ k s p ɔ n ɑ t
<|УКР|>артеріям	ɛ r t ɛ rʲ i j ɛ m
<|УКР|>богослов'я	b ɔ ɦ ɔ s ɫ ɔ ʋ j ɛ
<|УКР|>парашутизм	p ɛ r ɛ ʃ u t ɪ z m
<|УКР|>родитися	r ɔ d ɪ t ɪ sʲ ɛ
<|УКР|>молекулярна	m ɔ ɫ ɪ k u lʲ ɑ r n ɛ
<|УКР|>авторизувати	ɛ u t ɔ r ɪ z u ʋ ɑ t ɪ
<|УКР|>поєднання	p ɔ j ɪ d n ɑ nʲ ɛ
<|УКР|>листопад	ɫ ɪ s t ɔ p ɑ d
<|УКР|>ікра	i k r ɑ
<|УКР|>працівниці	p r ɛ t͡sʲ i u n ɪ t͡sʲ i
<|УКР|>самоціль	s ɛ m ɔ t͡sʲ i lʲ
<|УКР|>тренер	t r ɛ n ɪ r
<|УКР|>болото	b ɔ ɫ ɔ t ɔ
<|УКР|>існуючий	i s n u j u t͡ʃ ɪ i
<|УКР|>сприятливий	s p r ɪ j ɑ t ɫ ɪ ʋ ɪ i
<|УКР|>можливість	m ɔ ʒ ɫ ɪ ʋ i sʲ tʲ
<|УКР|>родовий	r ɔ d ɔ ʋ ɪ i
<|УКР|>стимул	s t ɪ m u ɫ
<|УКР|>населити	n ɛ s ɪ ɫ ɪ t ɪ
<|УКР|>терем	t ɛ r ɪ m
<|УКР|>крим	k r ɪ m
<|УКР|>аркуш	ɑ r k u ʃ
<|УКР|>гнати	ɦ n ɑ t ɪ
<|УКР|>вівсів	ʋ i u sʲ i u
<|УКР|>прислівниковий	p r ɪ sʲ lʲ i u n ɪ k ɔ ʋ ɪ i
<|УКР|>безвідсотковий	b ɪ zʲ ʋ i d͡z s ɔ t k ɔ ʋ ɪ i
<|УКР|>навруз	n ɛ u r u z
<|УКР|>пень	p ɛ nʲ
<|УКР|>дзиґа	d͡z ɪ ɡ ɛ
<|УКР|>блокадами	b ɫ ɔ k ɑ d ɛ m ɪ
<|УКР|>гаманець	ɦ ɛ m ɛ n ɛ t͡sʲ
<|УКР|>шведка	ʃ ʋ ɛ d k ɛ
<|УКР|>поема	p ɔ ɛ m ɛ
<|УКР|>чайна	t͡ʃ ɛ i n ɑ
<|УКР|>коровай	k ɔ r ɔ ʋ ɑ i
<|УКР|>календарем	k ɛ ɫ ɪ n d ɛ r ɛ m
<|УКР|>орнітологія	ɔ r nʲ i t ɔ ɫ ɔ ɦ i j ɛ
<|УКР|>різновид	rʲ i z n ɔ ʋ ɪ d
<|УКР|>бонусом	b ɔ n u s ɔ m
<|УКР|>досвідчений	d ɔ sʲ ʋ i d͡ʒ t͡ʃ ɪ n ɪ i
<|УКР|>геймплей	ɦ ɪ i m p ɫ ɛ i
<|УКР|>гривень	ɦ r ɪ ʋ ɪ nʲ
<|УКР|>вжити	ʋ ʒ ɪ t ɪ
<|УКР|>корчма	k ɔ r t͡ʃ m ɛ
<|УКР|>ензим	ɪ n z ɪ m
<|УКР|>поступці	p ɔ s t u p t͡sʲ i
<|УКР|>морозиво	m ɔ r ɔ z ɪ ʋ ɔ
<|УКР|>батяри	b ɛ tʲ ɑ r ɪ
<|УКР|>благо	b ɫ ɑ ɦ ɔ
<|УКР|>уособлювати	u ɔ s ɔ b lʲ u ʋ ɛ t ɪ
<|УКР|>ідеалістичний	i d ɪ ɛ lʲ i s t ɪ t͡ʃ n ɪ i
<|УКР|>пропорції	p r ɔ p ɔ r t͡sʲ i j i
<|УКР|>промокнути	p r ɔ m ɔ k n u t ɪ
<|УКР|>монополіст	m ɔ n ɔ p ɔ lʲ i s t
<|УКР|>собівартість	s ɔ b i ʋ ɑ r tʲ i sʲ tʲ
<|УКР|>швидкість	ʃ ʋ ɪ dʲ k i sʲ tʲ
<|УКР|>слухач	s ɫ u x ɑ t͡ʃ
<|УКР|>позбутися	p ɔ z b u t ɪ sʲ ɛ
<|УКР|>тістечко	tʲ i s t ɪ t͡ʃ k ɔ
<|УКР|>соня	s ɔ nʲ ɛ
<|УКР|>нейтралітет	n ɪ i t r ɛ lʲ i t ɛ t
<|УКР|>кіш	k i ʃ
<|УКР|>фільтр	f i lʲ t r
<|УКР|>текстовий	t ɪ k s t ɔ ʋ ɪ i
<|УКР|>імперія	i m p ɛ rʲ i j ɛ
<|УКР|>хмельницький	x m ɪ lʲ n ɪ t͡sʲ k ɪ i
<|УКР|>фактичний	f ɛ k t ɪ t͡ʃ n ɪ i
<|УКР|>тисяч	t ɪ sʲ ɛ t͡ʃ
<|УКР|>відданість	ʋ i d ɛ nʲ i sʲ tʲ
<|УКР|>пріоритет	p rʲ i ɔ r ɪ t ɛ t
<|УКР|>маніпулювати	m ɛ nʲ i p u lʲ u ʋ ɑ t ɪ
<|УКР|>академічний	ɛ k ɛ d ɪ m i t͡ʃ n ɪ i
<|УКР|>гриб	ɦ r ɪ b
<|УКР|>україною	u k r ɛ j i n ɔ j u
<|УКР|>аґрусівка	ɛ ɡ r u sʲ i u k ɛ
<|УКР|>супругою	s u p r u ɦ ɔ j u
<|УКР|>аб'юрація	ɛ b j u r ɑ t͡sʲ i j ɛ
<|УКР|>дисбаланс	d ɪ z b ɛ ɫ ɑ n s
<|УКР|>переоцінювати	p ɪ r ɪ ɔ t͡sʲ i nʲ u ʋ ɛ t ɪ
<|УКР|>позбавити	p ɔ z b ɑ ʋ ɪ t ɪ
<|УКР|>гібридний	ɦ i b r ɪ d n ɪ i
<|УКР|>душ	d u ʃ
<|УКР|>філософія	f i ɫ ɔ s ɔ f i j ɛ
<|УКР|>сусідка	s u sʲ i d k ɛ
<|УКР|>першість	p ɛ r ʃ i sʲ tʲ
<|УКР|>інтенсифікувати	i n t ɪ n s ɪ f i k u ʋ ɑ t ɪ
<|УКР|>феміністичний	f ɪ m i nʲ i s t ɪ t͡ʃ n ɪ i
<|УКР|>дати	d ɑ t ɪ
<|УКР|>підмет	p i d m ɪ t
<|УКР|>прамова	p r ɛ m ɔ ʋ ɛ
<|УКР|>каплицею	k ɛ p ɫ ɪ t͡s ɪ j u
<|УКР|>систематичний	s ɪ s t ɪ m ɛ t ɪ t͡ʃ n ɪ i
<|УКР|>росіянин	r ɔ sʲ i j ɑ n ɪ n
<|УКР|>тополі	t ɔ p ɔ lʲ i
<|УКР|>активність	ɛ k t ɪ u nʲ i sʲ tʲ
<|УКР|>авіасалон	ɛ ʋ i ɛ s ɛ ɫ ɔ n
<|УКР|>даремність	d ɛ r ɛ m nʲ i sʲ tʲ
<|УКР|>головний	ɦ ɔ ɫ ɔ u n ɪ i
<|УКР|>спортивний	s p ɔ r t ɪ u n ɪ i
<|УКР|>кліматичний	k lʲ i m ɛ t ɪ t͡ʃ n ɪ i
<|УКР|>вищий	ʋ ɪ ʃ t͡ʃ ɪ i
<|УКР|>відпочилий	ʋ i d p ɔ t͡ʃ ɪ ɫ ɪ i
<|УКР|>чабер	t͡ʃ ɛ b ɛ r
<|УКР|>психологічний	p s ɪ x ɔ ɫ ɔ ɦ i t͡ʃ n ɪ i
<|УКР|>мізерний	m i z ɪ r n ɪ i
<|УКР|>токар	t ɔ k ɛ r
<|УКР|>угорськомовний	u ɦ ɔ r sʲ k ɔ m ɔ u n ɪ i
<|УКР|>шоколад	ʃ ɔ k ɔ ɫ ɑ d
<|УКР|>яма	j ɑ m ɛ
<|УКР|>дані	d ɑ nʲ i
<|УКР|>зовні	z ɔ u nʲ i
<|УКР|>сумніватися	s u m nʲ i ʋ ɑ t ɪ sʲ ɛ
<|УКР|>вітебськ	ʋ i t ɪ b sʲ k
<|УКР|>друже	d r u ʒ ɪ
<|УКР|>називати	n ɛ z ɪ ʋ ɑ t ɪ
<|УКР|>концепція	k ɔ n t͡s ɛ p t͡sʲ i j ɛ
<|УКР|>конлі	k ɔ nʲ lʲ i
<|УКР|>рости	r ɔ s t ɪ
<|УКР|>будда	b u d ɛ
<|УКР|>активувати	ɛ k t ɪ ʋ u ʋ ɑ t ɪ
<|УКР|>візантійський	ʋ i z ɛ nʲ tʲ i i sʲ k ɪ i
<|УКР|>судно	s u d n ɔ
<|УКР|>фразеологічний	f r ɛ z ɪ ɔ ɫ ɔ ɦ i t͡ʃ n ɪ i
<|УКР|>артеріє	ɛ r t ɛ rʲ i j ɪ
<|УКР|>міжвоєнний	m i ʒ ʋ ɔ j ɛ n ɪ i
<|УКР|>зекономити	z ɪ k ɔ n ɔ m ɪ t ɪ
<|УКР|>апатичний	ɛ p ɛ t ɪ t͡ʃ n ɪ i
<|УКР|>дислокація	d ɪ s ɫ ɔ k ɑ t͡sʲ i j ɛ
<|УКР|>щонайменше	ʃ t͡ʃ ɔ n ɛ i m ɛ n ʃ ɪ
<|УКР|>куток	k u t ɔ k
<|УКР|>несподіваний	n ɪ s p ɔ dʲ i ʋ ɛ n ɪ i
<|УКР|>матеріальний	m ɛ t ɪ rʲ i ɑ lʲ n ɪ i
<|УКР|>хворіти	x ʋ ɔ rʲ i t ɪ
<|УКР|>кошуля	k ɔ ʃ u lʲ ɛ
<|УКР|>продавати	p r ɔ d ɛ ʋ ɑ t ɪ
<|УКР|>петиція	p ɪ t ɪ t͡sʲ i j ɛ
<|УКР|>абластика	ɛ b ɫ ɑ s t ɪ k ɛ
<|УКР|>авіаучилище	ɛ ʋ i ɛ u t͡ʃ ɪ ɫ ɪ ʃ t͡ʃ ɪ
<|УКР|>довг	d ɔ u ɦ
<|УКР|>обмеження	ɔ b m ɛ ʒ ɪ nʲ ɛ
<|УКР|>жолудь	ʒ ɔ ɫ u dʲ
<|УКР|>плювати	p lʲ u ʋ ɑ t ɪ
<|УКР|>салон	s ɛ ɫ ɔ n
<|УКР|>розуміння	r ɔ z u m i nʲ ɛ
<|УКР|>світанок	sʲ ʋ i t ɑ n ɔ k
<|УКР|>неформальний	n ɪ f ɔ r m ɑ lʲ n ɪ i
<|УКР|>продавщиця	p r ɔ d ɛ u ʃ t͡ʃ ɪ t͡sʲ ɛ
<|УКР|>трок	t r ɔ k
<|УКР|>декларацію	d ɪ k ɫ ɛ r ɑ t͡sʲ i j u
<|УКР|>лихоманка	ɫ ɪ x ɔ m ɑ n k ɛ
<|УКР|>матрьошка	m ɛ tʲ rʲ ɔ ʃ k ɛ
<|УКР|>дитсадок	d ɪ t͡s ɛ d ɔ k
<|УКР|>симпатичний	s ɪ m p ɛ t ɪ t͡ʃ n ɪ i
<|УКР|>повідомлення	p ɔ ʋ i d ɔ m ɫ ɪ nʲ ɛ
<|УКР|>довгий	d ɔ u ɦ ɪ i
<|УКР|>репродуктивний	r ɪ p r ɔ d u k t ɪ u n ɪ i
<|УКР|>погрожувати	p ɔ ɦ r ɔ ʒ u ʋ ɛ t ɪ
<|УКР|>батальйон	b ɛ t ɛ lʲ j ɔ n
<|УКР|>травень	t r ɑ ʋ ɪ nʲ
<|УКР|>напружити	n ɛ p r u ʒ ɪ t ɪ
<|УКР|>третій	t r ɛ tʲ i i
<|УКР|>стрічки	s tʲ rʲ i t͡ʃ k ɪ
<|УКР|>працівниками	p r ɛ t͡sʲ i u n ɪ k ɑ m ɪ
<|УКР|>розмова	r ɔ z m ɔ ʋ ɛ
<|УКР|>офіра	ɔ f i r ɛ
<|УКР|>литва	ɫ ɪ t ʋ ɑ
<|УКР|>начиння	n ɛ t͡ʃ ɪ nʲ ɛ
<|УКР|>слух	s ɫ u x
<|УКР|>південь	p i u d ɪ nʲ
<|УКР|>абразія	ɛ b r ɑ zʲ i j ɛ
<|УКР|>цвях	t͡sʲ ʋ ɑ x
<|УКР|>реконструкція	r ɪ k ɔ n s t r u k t͡sʲ i j ɛ
<|УКР|>хороший	x ɔ r ɔ ʃ ɪ i
<|УКР|>зовнішній	z ɔ u nʲ i ʃ nʲ i i
<|УКР|>установа	u s t ɛ n ɔ ʋ ɛ
<|УКР|>присвійний	p r ɪ sʲ ʋ i i n ɪ i
<|УКР|>власті	ʋ ɫ ɑ sʲ tʲ i
<|УКР|>законослухняний	z ɛ k ɔ n ɔ s ɫ u x nʲ ɑ n ɪ i
<|УКР|>пришвидшити	p r ɪ ʃ ʋ ɪ d͡ʒ ʃ ɪ t ɪ
<|УКР|>слівця	sʲ lʲ i u t͡sʲ ɛ
<|УКР|>житній	ʒ ɪ tʲ nʲ i i
<|УКР|>оточувати	ɔ t ɔ t͡ʃ u ʋ ɛ t ɪ
<|УКР|>здатен	z d ɑ t ɪ n
<|УКР|>негативно	n ɪ ɦ ɛ t ɪ u n ɔ
<|УКР|>інфікування	i nʲ f i k u ʋ ɑ nʲ ɛ
<|УКР|>теорію	t ɪ ɔ rʲ i j u
<|УКР|>еротика	ɪ r ɔ t ɪ k ɛ
<|УКР|>федерації	f ɪ d ɪ r ɑ t͡sʲ i j i
<|УКР|>проблема	p r ɔ b ɫ ɛ m ɛ
<|УКР|>брехню	b r ɪ x nʲ u
<|УКР|>психіка	p s ɪ x i k ɛ
<|УКР|>білок	b i ɫ ɔ k
<|УКР|>лист	ɫ ɪ s t
<|УКР|>австралопітек	ɛ u s t r ɛ ɫ ɔ p i t ɛ k
<|УКР|>кайман	k ɛ i m ɑ n
<|УКР|>ніготь	nʲ i ɦ ɔ tʲ
<|УКР|>марія	m ɛ rʲ i j ɛ
<|УКР|>звикнути	z ʋ ɪ k n u t ɪ
<|УКР|>бонусами	b ɔ n u s ɛ m ɪ
<|УКР|>конкурс	k ɔ n k u r s
<|УКР|>птиця	p t ɪ t͡sʲ ɛ
<|УКР|>кота	k ɔ t ɑ
<|УКР|>могутній	m ɔ ɦ u tʲ nʲ i i
<|УКР|>дитсадки	d ɪ t͡s ɛ d k ɪ
<|УКР|>авіамаяк	ɛ ʋ i ɛ m ɛ j ɑ k
<|УКР|>новини	n ɔ ʋ ɪ n ɪ
<|УКР|>безпритульний	b ɪ z p r ɪ t u lʲ n ɪ i
<|УКР|>скандинавія	s k ɛ n d ɪ n ɑ ʋ i j ɛ
<|УКР|>кишенею	k ɪ ʃ ɛ n ɪ j u
<|УКР|>жона	ʒ ɔ n ɑ
<|УКР|>працівницям	p r ɛ t͡sʲ i u n ɪ t͡sʲ ɛ m
<|УКР|>індустріалізувати	i n d u s tʲ rʲ i ɛ lʲ i z u ʋ ɑ t ɪ
<|УКР|>цією	t͡sʲ i j ɛ j u
<|УКР|>катастрофи	k ɛ t ɛ s t r ɔ f ɪ
<|УКР|>в'язниця	ʋ j ɛ z n ɪ t͡sʲ ɛ
<|УКР|>козирок	k ɔ z ɪ r ɔ k
<|УКР|>дорогий	d ɔ r ɔ ɦ ɪ i
<|УКР|>потилице	p ɔ t ɪ ɫ ɪ t͡s ɪ
<|УКР|>грязь	ɦ rʲ ɑ zʲ
<|УКР|>бацяр	b ɑ t͡sʲ ɛ r
<|УКР|>абрикос	ɛ b r ɪ k ɔ s
<|УКР|>заєць	z ɑ j ɪ t͡sʲ
<|УКР|>школа	ʃ k ɔ ɫ ɛ
<|УКР|>курити	k u r ɪ t ɪ
<|УКР|>імпортувати	i m p ɔ r t u ʋ ɑ t ɪ
<|УКР|>тисячоліттями	t ɪ sʲ ɛ t͡ʃ ɔ lʲ i tʲ ɛ m ɪ
<|УКР|>фіскальний	f i s k ɑ lʲ n ɪ i
<|УКР|>абсанс	ɛ b s ɑ n s
<|УКР|>автобусик	ɛ u t ɔ b u s ɪ k
<|УКР|>утомлений	u t ɔ m ɫ ɪ n ɪ i
<|УКР|>ізраїльтянка	i z r ɛ j i lʲ tʲ ɑ n k ɛ
<|УКР|>повернути	p ɔ ʋ ɪ r n u t ɪ
<|УКР|>позичати	p ɔ z ɪ t͡ʃ ɑ t ɪ
<|УКР|>район	r ɛ j ɔ n
<|УКР|>більшати	b i lʲ ʃ ɛ t ɪ
<|УКР|>заїр	z ɛ j i r
<|УКР|>масштаб	m ɛ ʃ t ɑ b
<|УКР|>золото	z ɔ ɫ ɔ t ɔ
<|УКР|>феями	f ɛ j ɛ m ɪ
<|УКР|>снідати	sʲ nʲ i d ɛ t ɪ
<|УКР|>втручання	ʋ t r u t͡ʃ ɑ nʲ ɛ
<|УКР|>бюрократка	b u r ɔ k r ɑ t k ɛ
<|УКР|>трансформаціям	t r ɛ n s f ɔ r m ɑ t͡sʲ i j ɛ m
<|УКР|>білоруський	b i ɫ ɔ r u sʲ k ɪ i
<|УКР|>невидимий	n ɪ ʋ ɪ d ɪ m ɪ i
<|УКР|>смак	s m ɑ k
<|УКР|>наприкінці	n ɛ p r ɪ k i nʲ t͡sʲ i
<|УКР|>автобіограф	ɛ u t ɔ b i ɔ ɦ r ɛ f
<|УКР|>небога	n ɪ b ɔ ɦ ɛ
<|УКР|>заохотити	z ɛ ɔ x ɔ t ɪ t ɪ
<|УКР|>конфета	k ɔ n f ɛ t ɛ
<|УКР|>логістичний	ɫ ɔ ɦ i s t ɪ t͡ʃ n ɪ i
<|УКР|>вирішення	ʋ ɪ rʲ i ʃ ɪ nʲ ɛ
<|УКР|>театр	t ɪ ɑ t r
<|УКР|>кубічний	k u b i t͡ʃ n ɪ i
<|УКР|>додатках	d ɔ d ɑ t k ɛ x
<|УКР|>америка	ɛ m ɛ r ɪ k ɛ
<|УКР|>ними	n ɪ m ɪ
<|УКР|>виконання	ʋ ɪ k ɔ n ɑ nʲ ɛ
<|УКР|>абстракція	ɛ b s t r ɑ k t͡sʲ i j ɛ
<|УКР|>чотирикутний	t͡ʃ ɔ t ɪ r ɪ k u t n ɪ i
<|УКР|>п'ятдесят	p j ɛ d d ɪ sʲ ɑ t
<|УКР|>гуманістичний	ɦ u m ɛ nʲ i s t ɪ t͡ʃ n ɪ i
<|УКР|>батьківщина	b ɛ tʲ k i u ʃ t͡ʃ ɪ n ɛ
<|УКР|>пропорціях	p r ɔ p ɔ r t͡sʲ i j ɛ x
<|УКР|>повечеряти	p ɔ ʋ ɪ t͡ʃ ɛ rʲ ɛ t ɪ
<|УКР|>невідворотний	n ɪ ʋ i d ʋ ɔ r ɔ t n ɪ i
<|УКР|>інна	i n ɛ
<|УКР|>система	s ɪ s t ɛ m ɛ
<|УКР|>геометричний	ɦ ɪ ɔ m ɪ t r ɪ t͡ʃ n ɪ i
<|УКР|>забагти	z ɛ b ɑ ɦ t ɪ
<|УКР|>гомосексуалізм	ɦ ɔ m ɔ s ɪ k s u ɛ lʲ i z m
<|УКР|>троє	t r ɔ j ɪ
<|УКР|>вмерти	ʋ m ɛ r t ɪ
<|УКР|>альбатрос	ɛ lʲ b ɛ t r ɔ s
<|УКР|>ратифікація	r ɛ t ɪ f i k ɑ t͡sʲ i j ɛ
<|УКР|>тож	t ɔ ʒ
<|УКР|>співпереживання	sʲ p i u p ɪ r ɪ ʒ ɪ ʋ ɑ nʲ ɛ
<|УКР|>діагностика	dʲ i ɛ ɦ n ɔ s t ɪ k ɛ
<|УКР|>відвернути	ʋ i d ʋ ɪ r n u t ɪ
<|УКР|>кубинець	k u b ɪ n ɪ t͡sʲ
<|УКР|>вимкнути	ʋ ɪ m k n u t ɪ
<|УКР|>своєрідний	s ʋ ɔ j ɪ rʲ i d n ɪ i
<|УКР|>пропорціям	p r ɔ p ɔ r t͡sʲ i j ɛ m
<|УКР|>янтар	j ɛ n t ɑ r
<|УКР|>станіслав	s t ɛ nʲ i s ɫ ɑ u
<|УКР|>меланія	m ɪ ɫ ɑ nʲ i j ɛ
<|УКР|>багато	b ɛ ɦ ɑ t ɔ
<|УКР|>цитрина	t͡s ɪ t r ɪ n ɛ
<|УКР|>розпізнавання	r ɔ zʲ p i z n ɛ ʋ ɑ nʲ ɛ
<|УКР|>свекруха	s ʋ ɪ k r u x ɛ
<|УКР|>тисячоліттях	t ɪ sʲ ɛ t͡ʃ ɔ lʲ i tʲ ɛ x
<|УКР|>батько	b ɑ tʲ k ɔ
<|УКР|>неправді	n ɪ p r ɑ u dʲ i
<|УКР|>діаграма	dʲ i ɛ ɦ r ɑ m ɛ
<|УКР|>дзеркало	d͡z ɛ r k ɛ ɫ ɔ
<|УКР|>мур	m u r
<|УКР|>молодий	m ɔ ɫ ɔ d ɪ i
<|УКР|>візуальний	ʋ i z u ɑ lʲ n ɪ i
<|УКР|>зоопарк	z ɔ ɔ p ɑ r k
<|УКР|>авіапарк	ɛ ʋ i ɛ p ɑ r k
<|УКР|>плюш	p lʲ u ʃ
<|УКР|>п'ятниця	p j ɑ t n ɪ t͡sʲ ɛ
<|УКР|>письменний	p ɪ sʲ m ɛ n ɪ i
<|УКР|>українських	u k r ɛ j i nʲ sʲ k ɪ x
<|УКР|>хліб	x lʲ i b
<|УКР|>залежний	z ɛ ɫ ɛ ʒ n ɪ i
<|УКР|>мовознавство	m ɔ ʋ ɔ z n ɑ u s t ʋ ɔ
<|УКР|>участь	u t͡ʃ ɛ sʲ tʲ
<|УКР|>сауна	s ɑ u n ɛ
<|УКР|>місяць	m i sʲ ɛ t͡sʲ
<|УКР|>фольклор	f ɔ lʲ k ɫ ɔ r
<|УКР|>успішний	u sʲ p i ʃ n ɪ i
<|УКР|>засмутити	z ɛ s m u t ɪ t ɪ
<|УКР|>тацею	t ɑ t͡s ɪ j u
<|УКР|>критерієм	k r ɪ t ɛ rʲ i j ɪ m
<|УКР|>авіавиставка	ɛ ʋ i ɛ ʋ ɪ s t ɛ u k ɛ
<|УКР|>підкреслювати	p i d k r ɛ sʲ lʲ u ʋ ɛ t ɪ
<|УКР|>тільки	tʲ i lʲ k ɪ
<|УКР|>возити	ʋ ɔ z ɪ t ɪ
<|УКР|>зменшень	z m ɛ n ʃ ɪ nʲ
<|УКР|>тріска	tʲ rʲ i s k ɛ
<|УКР|>рішити	rʲ i ʃ ɪ t ɪ
<|УКР|>інтуїтивно	i n t u j i t ɪ u n ɔ
<|УКР|>хлопчик	x ɫ ɔ p t͡ʃ ɪ k
<|УКР|>коліно	k ɔ lʲ i n ɔ
<|УКР|>жорстокий	ʒ ɔ r s t ɔ k ɪ i
<|УКР|>амфібія	ɛ m f i b i j ɛ
<|УКР|>транзит	t r ɛ n z ɪ t
<|УКР|>виявитися	ʋ ɪ j ɛ ʋ ɪ t ɪ sʲ ɛ
<|УКР|>спростити	s p r ɔ s t ɪ t ɪ
<|УКР|>криголам	k r ɪ ɦ ɔ ɫ ɑ m
<|УКР|>мокнути	m ɔ k n u t ɪ
<|УКР|>ростити	r ɔ s t ɪ t ɪ
<|УКР|>зрости	z r ɔ s t ɪ
<|УКР|>куди	k u d ɪ
<|УКР|>відродження	ʋ i d r ɔ d͡ʒ ɪ nʲ ɛ
<|УКР|>посталий	p ɔ s t ɑ ɫ ɪ i
<|УКР|>його	j ɔ ɦ ɔ
<|УКР|>кривавий	k r ɪ ʋ ɑ ʋ ɪ i
<|УКР|>нескладовий	n ɪ s k ɫ ɛ d ɔ ʋ ɪ i
<|УКР|>автодидакт	ɛ u t ɔ d ɪ d ɑ k t
<|УКР|>їжакевич	j i ʒ ɛ k ɛ ʋ ɪ t͡ʃ
<|УКР|>мем	m ɛ m
<|БЪЛ|>холандски	x o ɫ a n t s kʲ i
<|БЪЛ|>браташ	b r ɐ t a ʃ
<|БЪЛ|>овластителен	o v ɫ ɐ s t i t ɛ lʲ ɛ n
<|БЪЛ|>саламандър	s ɐ ɫ ɐ m a n d ɐ r
<|БЪЛ|>легла	lʲ ɛ ɡ ɫ a
<|БЪЛ|>лакът	ɫ a k ɐ t
<|БЪЛ|>липа	lʲ i p a
<|БЪЛ|>съзра	s ɐ z r ɤ
<|БЪЛ|>състояние	s ɐ s t o j a n i ɛ
<|БЪЛ|>викам	v i k ɐ m
<|БЪЛ|>хидроелектричен	xʲ i d r o ɛ lʲ ɛ k t r i t͡ʃ ɛ n
<|БЪЛ|>диона	d i ɔ n ɐ
<|БЪЛ|>събудя	s ɐ b u dʲ ɐ
<|БЪЛ|>хомосексуалистка	x ɔ m o s ɛ k s u ɐ lʲ i s k ɐ
<|БЪЛ|>морелетник	m o r ɛ lʲ ɛ t n i k
<|БЪЛ|>панпсихизъм	p ɐ n p s i xʲ i z ɐ m
<|БЪЛ|>абанос	ɐ b ɐ n ɔ s
<|БЪЛ|>кои	k o i
<|БЪЛ|>улица	u lʲ i t͡s ɐ
<|БЪЛ|>вашта	v a ʃ t ɐ
<|БЪЛ|>туркменистан	t u r k m ɛ n i s t a n
<|БЪЛ|>къжлица	k ɐ ʒ lʲ i t͡s ɐ
<|БЪЛ|>бида	b i d ɐ
<|БЪЛ|>материя	m ɐ t ɛ r i j ɐ
<|БЪЛ|>узаконяваха	u z ɐ k o nʲ a v ɐ x ɐ
<|БЪЛ|>зрян	z rʲ a n
<|БЪЛ|>лавка	ɫ a f k ɐ
<|БЪЛ|>андора	ɐ n d ɔ r ɐ
<|БЪЛ|>стръмнина	s t r ɐ m n i n a
<|БЪЛ|>работилница	r ɐ b o t i ɫ n i t͡s ɐ
<|БЪЛ|>съобщавам	s ɐ o p ʃ t a v ɐ m
<|БЪЛ|>върху	v ɐ r x u
<|БЪЛ|>съветвам	s ɐ v ɛ t v ɐ m
<|БЪЛ|>драка	d r a k ɐ
<|БЪЛ|>цезий	t͡s ɛ z i
<|БЪЛ|>начало	n ɐ t͡ʃ a ɫ o
<|БЪЛ|>протека	p r o t ɛ k ɤ
<|БЪЛ|>париж	p ɐ r i ʃ
<|БЪЛ|>примирам	p r i m i r ɐ m
<|БЪЛ|>галба	ɡ ɐ ɫ b a
<|БЪЛ|>щирица	ʃ t i r i t͡s ɐ
<|БЪЛ|>въстание	v ɐ s t a n i ɛ
<|БЪЛ|>художник	x u d ɔ ʒ n i k
<|БЪЛ|>доверчив	d o v ɛ r t͡ʃ i f
<|БЪЛ|>чешма	t͡ʃ ɛ ʃ m a
<|БЪЛ|>успех	u s p ɛ x
<|БЪЛ|>катерица	k a t ɛ r i t͡s ɐ
<|БЪЛ|>трепетлика	t r ɛ p ɛ t lʲ i k ɐ
<|БЪЛ|>видра	v i d r ɐ
<|БЪЛ|>врабче	v r ɐ p t͡ʃ ɛ
<|БЪЛ|>светлосянка	s v ɛ t ɫ o sʲ a n k ɐ
<|БЪЛ|>щастие	ʃ t a s t i ɛ
<|БЪЛ|>живот	ʒ i v ɔ t
<|БЪЛ|>проститутка	p r o s t i t u t k ɐ
<|БЪЛ|>крехък	k r ɛ x ɐ k
<|БЪЛ|>сивкав	s i f k ɐ f
<|БЪЛ|>модел	m o d ɛ ɫ
<|БЪЛ|>липък	lʲ i p ɐ k
<|БЪЛ|>случаен	s ɫ u t͡ʃ ɐ ɛ n
<|БЪЛ|>ароматен	ɐ r o m a t ɛ n
<|БЪЛ|>мързел	m ɤ r z ɛ ɫ
<|БЪЛ|>кое	k o ɛ
<|БЪЛ|>платя	p ɫ ɐ tʲ ɤ
<|БЪЛ|>цербер	t͡s ɛ r b ɛ r
<|БЪЛ|>печален	p ɛ t͡ʃ a lʲ ɛ n
<|БЪЛ|>брания	b r a n i j ɐ
<|БЪЛ|>първи	p ɤ r v i
<|БЪЛ|>зарист	z ɐ r i s t
<|БЪЛ|>албания	ɐ ɫ b a n i j ɐ
<|БЪЛ|>върша	v ɐ r ʃ a
<|БЪЛ|>занимая	z ɐ n i m a j ɐ
<|БЪЛ|>абдикиралия	ɐ b d i kʲ i r ɐ lʲ i j ɐ
<|БЪЛ|>ама	a m ɐ
<|БЪЛ|>как	k a k
<|БЪЛ|>декември	d ɛ kʲ ɛ m v r i
<|БЪЛ|>забождам	z ɐ b ɔ ʒ d ɐ m
<|БЪЛ|>минск	m i n s k
<|БЪЛ|>изпея	i s p ɛ j ɐ
<|БЪЛ|>стреме	s t r ɛ m ɛ
<|БЪЛ|>абсолютен	ɐ p s o lʲ u t ɛ n
<|БЪЛ|>селекционен	s ɛ lʲ ɛ k t͡s i ɔ n ɛ n
<|БЪЛ|>чуващ	t͡ʃ u v ɐ ʃ t
<|БЪЛ|>слава	s ɫ a v ɐ
<|БЪЛ|>смрад	s m r a t
<|БЪЛ|>хамбургер	x a m b u r ɡʲ ɛ r
<|БЪЛ|>крава	k r a v ɐ
<|БЪЛ|>ему	ɛ m u
<|БЪЛ|>мускулен	m u s k u lʲ ɛ n
<|БЪЛ|>ловец	ɫ o v ɛ t͡s
<|БЪЛ|>мръсен	m r ɤ s ɛ n
<|БЪЛ|>гангстер	ɡ a n k s t ɛ r
<|БЪЛ|>кур	k u r
<|БЪЛ|>мойто	m ɔ j t o
<|БЪЛ|>явен	j a v ɛ n
<|БЪЛ|>немкиня	n ɛ m kʲ i nʲ ɐ
<|БЪЛ|>светлана	s v ɛ t ɫ a n ɐ
<|БЪЛ|>опера	ɔ p ɛ r ɐ
<|БЪЛ|>черква	t͡ʃ ɛ r k v ɐ
<|БЪЛ|>околен	o k ɔ lʲ ɛ n
<|БЪЛ|>паткан	p ɐ t k a n
<|БЪЛ|>представям	p r ɛ t s t a vʲ ɐ m
<|БЪЛ|>холмий	x ɔ ɫ m i
<|БЪЛ|>какъвто	k ɐ k ɤ f t o
<|БЪЛ|>алка	a ɫ k ɐ
<|БЪЛ|>бижу	b i ʒ u
<|БЪЛ|>узаконили	u z ɐ k o n i lʲ i
<|БЪЛ|>социален	s o t͡s i a lʲ ɛ n
<|БЪЛ|>дъх	d ɤ x
<|БЪЛ|>гуждам	ɡ u ʒ d ɐ m
<|БЪЛ|>изслушам	i s ɫ u ʃ ɐ m
<|БЪЛ|>езичен	ɛ z i t͡ʃ ɛ n
<|БЪЛ|>вървите	v ɐ r v i t ɛ
<|БЪЛ|>склонен	s k ɫ ɔ n ɛ n
<|БЪЛ|>върволяк	v ɐ r v o lʲ a k
<|БЪЛ|>тъкан	t ɐ k a n
<|БЪЛ|>рай	r a j
<|БЪЛ|>панкреатит	p ɐ n k r ɛ ɐ t i t
<|БЪЛ|>хладък	x ɫ a d ɐ k
<|БЪЛ|>добре	d o b r ɛ
<|БЪЛ|>легален	lʲ ɛ ɡ a lʲ ɛ n
<|БЪЛ|>алармен	ɐ ɫ a r m ɛ n
<|БЪЛ|>възголям	v ɐ z ɡ o lʲ a m
<|БЪЛ|>кюлоти	kʲ u ɫ ɔ t i
<|БЪЛ|>хамбар	x ɐ m b a r
<|БЪЛ|>зърнест	z ɤ r n ɛ s t
<|БЪЛ|>нос	n ɔ s
<|БЪЛ|>възсин	v ɐ s s i n
<|БЪЛ|>побеждавам	p o b ɛ ʒ d a v ɐ m
<|БЪЛ|>прага	p r a ɡ ɐ
<|БЪЛ|>едноличен	ɛ d n o lʲ i t͡ʃ ɛ n
<|БЪЛ|>подпиша	p o t p i ʃ ɐ
<|БЪЛ|>височина	v i s o t͡ʃ i n a
<|БЪЛ|>наредба	n ɐ r ɛ d b ɐ
<|БЪЛ|>прахоляк	p r ɐ x o lʲ a k
<|БЪЛ|>зло	z ɫ ɔ
<|БЪЛ|>кожа	k ɔ ʒ ɐ
<|БЪЛ|>бахър	b a x ɐ r
<|БЪЛ|>яд	j a t
<|БЪЛ|>кълва	k ɐ ɫ v a
<|БЪЛ|>издател	i z d a t ɛ ɫ
<|БЪЛ|>напластяване	n ɐ p ɫ ɐ s tʲ a v ɐ n ɛ
<|БЪЛ|>продам	p r o d a m
<|БЪЛ|>членувана	t͡ʃ lʲ ɛ n u v ɐ n ɐ
<|БЪЛ|>изгреба	i z ɡ r ɛ b ɐ
<|БЪЛ|>държава	d ɐ r ʒ a v ɐ
<|БЪЛ|>изучаем	i z u t͡ʃ a ɛ m
<|БЪЛ|>кошара	k o ʃ a r ɐ
<|БЪЛ|>пеганка	p ɛ ɡ a n k ɐ
<|БЪЛ|>кожарница	k o ʒ a r n i t͡s ɐ
<|БЪЛ|>икона	i k ɔ n ɐ
<|БЪЛ|>ядяхте	j a dʲ a x t ɛ
<|БЪЛ|>затворен	z ɐ t v ɔ r ɛ n
<|БЪЛ|>свойство	s v ɔ j s t v o
<|БЪЛ|>абдоминалния	ɐ b d o m i n a ɫ n i j ɐ
<|БЪЛ|>гледам	ɡ lʲ ɛ d ɐ m
<|БЪЛ|>поп	p ɔ p
<|БЪЛ|>история	i s t ɔ r i j ɐ
<|БЪЛ|>повтор	p o f t ɔ r
<|БЪЛ|>данък	d a n ɐ k
<|БЪЛ|>граната	ɡ r ɐ n a t ɐ
<|БЪЛ|>предприемач	p r ɛ t p r i ɛ m a t͡ʃ
<|БЪЛ|>каца	k a t͡s ɐ
<|БЪЛ|>абонаментен	ɐ b o n ɐ m ɛ n t ɛ n
<|БЪЛ|>бекон	b ɛ k ɔ n
<|БЪЛ|>технеций	t ɛ x n ɛ t͡s i
<|БЪЛ|>кокоши	k o k ɔ ʃ i
<|БЪЛ|>пропаст	p r ɔ p ɐ s t
<|БЪЛ|>авиобомба	a v i o b ɔ m b ɐ
<|БЪЛ|>прекален	p r ɛ k ɐ lʲ ɛ n
<|БЪЛ|>кофа	k ɔ f ɐ
<|БЪЛ|>чия	t͡ʃ i j a
<|БЪЛ|>вашия	v a ʃ i j ɐ
<|БЪЛ|>забележа	z ɐ b ɛ lʲ ɛ ʒ ɐ
<|БЪЛ|>щъркел	ʃ t ɤ r kʲ ɛ ɫ
<|БЪЛ|>резултат	r ɛ z u ɫ t a t
<|БЪЛ|>неразбория	n ɛ r ɐ z b o r i j ɐ
<|БЪЛ|>ноември	n o ɛ m v r i
<|БЪЛ|>пафкам	p a f k ɐ m
<|БЪЛ|>миг	m i k
<|БЪЛ|>сияехте	s i j a ɛ x t ɛ
<|БЪЛ|>патица	p a t i t͡s ɐ
<|БЪЛ|>преда	p r ɛ d ɤ
<|БЪЛ|>длан	d ɫ a n
<|БЪЛ|>готов	ɡ ɔ t o f
<|БЪЛ|>блед	b lʲ ɛ t
<|БЪЛ|>век	v ɛ k
<|БЪЛ|>поилка	p o i ɫ k ɐ
<|БЪЛ|>досега	d o s ɛ ɡ a
<|БЪЛ|>ядящото	j a dʲ a ʃ t o t o
<|БЪЛ|>извадя	i z v a dʲ ɐ
<|БЪЛ|>повторим	p o f t o r i m
<|БЪЛ|>глупост	ɡ ɫ u p o s t
<|БЪЛ|>завинаги	z ɐ v i n ɐ ɡʲ i
<|БЪЛ|>бърне	b ɐ r n ɛ
<|БЪЛ|>сврачи	s v r a t͡ʃ i
<|БЪЛ|>хидра	xʲ i d r ɐ
<|БЪЛ|>завивка	z ɐ v i f k ɐ
<|БЪЛ|>читателка	t͡ʃ i t a t ɛ ɫ k ɐ
<|БЪЛ|>плен	p lʲ ɛ n
<|БЪЛ|>цупя	t͡s u pʲ ɐ
<|БЪЛ|>швейцарски	ʃ v ɛ j t͡s a r s kʲ i
<|БЪЛ|>гадина	ɡ ɐ d i n ɐ
<|БЪЛ|>девойка	d ɛ v ɔ j k ɐ
<|БЪЛ|>ерида	ɛ r i d ɐ
<|БЪЛ|>зрящ	z rʲ a ʃ t
<|БЪЛ|>инакво	i n a k v o
<|БЪЛ|>деймос	d ɛ j m o s
<|БЪЛ|>служа	s ɫ u ʒ ɐ
<|БЪЛ|>надолу	n ɐ d ɔ ɫ u
<|БЪЛ|>шифър	ʃ i f ɐ r
<|БЪЛ|>предупредя	p r ɛ d u p r ɛ dʲ ɤ
<|БЪЛ|>карти	k a r t i
<|БЪЛ|>ищай	i ʃ t a j
<|БЪЛ|>среда	s r ɛ d a
<|БЪЛ|>буляк	b u lʲ ɐ k
<|БЪЛ|>стоя	s t o j ɤ
<|БЪЛ|>възхищение	v ɐ s xʲ i ʃ t ɛ n i ɛ
<|БЪЛ|>яла	j a ɫ ɐ
<|БЪЛ|>пруст	p r u s t
<|БЪЛ|>волфрам	v ɔ ɫ f r ɐ m
<|БЪЛ|>премяна	p r ɛ mʲ a n ɐ
<|БЪЛ|>кавал	k ɐ v a ɫ
<|БЪЛ|>юрод	j u r o t
<|БЪЛ|>блия	b lʲ i j ɐ
<|БЪЛ|>рог	r ɔ k
<|БЪЛ|>тухла	t u x ɫ ɐ
<|БЪЛ|>мечок	m ɛ t͡ʃ ɔ k
<|БЪЛ|>нека	n ɛ k ɐ
<|БЪЛ|>зрител	z r i t ɛ ɫ
<|БЪЛ|>апологет	ɐ p o ɫ o ɡʲ ɛ t
<|БЪЛ|>почти	p o t͡ʃ t i
<|БЪЛ|>техничен	t ɛ x n i t͡ʃ ɛ n
<|БЪЛ|>анархия	ɐ n a r xʲ i j ɐ
<|БЪЛ|>свра	s v r ɤ
<|БЪЛ|>индий	i n d i
<|БЪЛ|>супермаркет	s u p ɛ r m a r kʲ ɛ t
<|БЪЛ|>меч	m ɛ t͡ʃ
<|БЪЛ|>парещ	p a r ɛ ʃ t
<|БЪЛ|>русалия	r u s a lʲ i j ɐ
<|БЪЛ|>щене	ʃ t ɛ n ɛ
<|БЪЛ|>зареждам	z ɐ r ɛ ʒ d ɐ m
<|БЪЛ|>дрозен	d r ɔ z ɛ n
<|БЪЛ|>тъпочовка	t ɐ p o t͡ʃ ɔ f k ɐ
<|БЪЛ|>отнеса	o t n ɛ s ɤ
<|БЪЛ|>говно	ɡ o v n ɔ
<|БЪЛ|>харамия	x ɐ r ɐ m i j ɐ
<|БЪЛ|>ваше	v a ʃ ɛ
<|БЪЛ|>абстрактен	ɐ p s t r a k t ɛ n
<|БЪЛ|>зреше	z r ɛ ʃ ɛ
<|БЪЛ|>творя	t v o rʲ a
<|БЪЛ|>спомня	s p ɔ m nʲ ɐ
<|БЪЛ|>панкреас	p a n k r ɛ ɐ s
<|БЪЛ|>дърволазка	d ɐ r v o ɫ a s k ɐ
<|БЪЛ|>пек	p ɛ k
<|БЪЛ|>чутура	t͡ʃ u t u r ɐ
<|БЪЛ|>дъхна	d ɤ x n ɐ
<|БЪЛ|>население	n ɐ s ɛ lʲ ɛ n i ɛ
<|БЪЛ|>сък	s ɤ k
<|БЪЛ|>апология	ɐ p o ɫ ɔ ɡʲ i j ɐ
<|БЪЛ|>тон	t ɔ n
<|БЪЛ|>керамика	kʲ ɛ r a m i k ɐ
<|БЪЛ|>билото	b i ɫ o t o
<|БЪЛ|>трева	t r ɛ v a
<|БЪЛ|>доказателство	d o k ɐ z a t ɛ ɫ s t v o
<|БЪЛ|>абсорбирания	ɐ p s o r b i r ɐ n i j ɐ
<|БЪЛ|>сладко	s ɫ a t k o
<|БЪЛ|>отделен	o d d ɛ lʲ ɛ n
<|БЪЛ|>стихия	s t i xʲ i j ɐ
<|БЪЛ|>чиито	t͡ʃ i i t o
<|БЪЛ|>пролом	p r o ɫ ɔ m
<|БЪЛ|>лидер	lʲ i d ɛ r
<|БЪЛ|>дотичам	d o t i t͡ʃ ɐ m
<|БЪЛ|>дигна	d i ɡ n ɐ
<|БЪЛ|>нет	n ɛ t
<|БЪЛ|>какаду	k ɐ k ɐ d u
<|БЪЛ|>текстилен	t ɛ k s t i lʲ ɛ n
<|БЪЛ|>обсъждам	o p s ɤ ʒ d ɐ m
<|БЪЛ|>корморан	k o r m o r a n
<|БЪЛ|>местност	m ɛ s n o s t
<|БЪЛ|>членувам	t͡ʃ lʲ ɛ n u v ɐ m
<|БЪЛ|>тарос	t a r o s
<|БЪЛ|>небеса	n ɛ b ɛ s a
<|БЪЛ|>анкетен	ɐ n kʲ ɛ t ɛ n
<|БЪЛ|>имала	i m a ɫ ɐ
<|БЪЛ|>внезапен	v n ɛ z a p ɛ n
<|БЪЛ|>конгрес	k o n ɡ r ɛ s
<|БЪЛ|>пепеляв	p ɛ p ɛ lʲ a f
<|БЪЛ|>август	a v ɡ u s t
<|БЪЛ|>гяур	ɡʲ ɐ u r
<|БЪЛ|>стърга	s t ɤ r ɡ ɐ
<|БЪЛ|>софийски	s o f i s kʲ i
<|БЪЛ|>неопределен	n ɛ o p r ɛ d ɛ lʲ ɛ n
<|БЪЛ|>кайгана	k ɐ j ɡ ɐ n a
<|БЪЛ|>швейцарка	ʃ v ɛ j t͡s a r k ɐ
<|БЪЛ|>заплитам	z ɐ p lʲ i t ɐ m
<|БЪЛ|>летя	lʲ ɛ tʲ a
<|БЪЛ|>зърнен	z ɤ r n ɛ n
<|БЪЛ|>мартеница	m a r t ɛ n i t͡s ɐ
<|БЪЛ|>средновековие	s r ɛ d n o v ɛ k ɔ v i ɛ
<|БЪЛ|>градус	ɡ r a d u s
<|БЪЛ|>отвор	o t v ɔ r
<|БЪЛ|>проклитичен	p r o k lʲ i t i t͡ʃ ɛ n
<|БЪЛ|>чуя	t͡ʃ u j ɐ
<|БЪЛ|>зрак	z r a k
<|БЪЛ|>мирта	m i r t ɐ
<|БЪЛ|>март	m a r t
<|БЪЛ|>напека	n ɐ p ɛ k ɤ
<|БЪЛ|>карам	k a r ɐ m
<|БЪЛ|>палав	p a ɫ ɐ f
<|БЪЛ|>зашивам	z ɐ ʃ i v ɐ m
<|БЪЛ|>шум	ʃ u m
<|БЪЛ|>накаже	n ɐ k a ʒ ɛ
<|БЪЛ|>управителен	u p r a v i t ɛ lʲ ɛ n
<|БЪЛ|>автобиографично	ɐ f t o b i o ɡ r ɐ f i t͡ʃ n o
<|БЪЛ|>лъжи	ɫ ɐ ʒ i
<|БЪЛ|>показвам	p o k a z v ɐ m
<|БЪЛ|>къртица	k ɐ r t i t͡s ɐ
<|БЪЛ|>южнячка	j u ʒ nʲ a t͡ʃ k ɐ
<|БЪЛ|>обърна	o b ɤ r n ɐ
<|БЪЛ|>зор	z ɔ r
<|БЪЛ|>град	ɡ r a t
<|БЪЛ|>обесвам	o b ɛ s v ɐ m
<|БЪЛ|>зярвам	zʲ a r v ɐ m
<|БЪЛ|>русе	r u s ɛ
<|БЪЛ|>биографичен	b i o ɡ r ɐ f i t͡ʃ ɛ n
<|БЪЛ|>чествам	t͡ʃ ɛ s t v ɐ m
<|БЪЛ|>връст	v r ɤ s t
<|БЪЛ|>сплав	s p ɫ a f
<|БЪЛ|>гургулица	ɡ u r ɡ u lʲ i t͡s ɐ
<|БЪЛ|>намака	n ɐ m a k ɐ
<|БЪЛ|>противоречив	p r o t i v o r ɛ t͡ʃ i f
<|БЪЛ|>куфар	k u f ɐ r
<|БЪЛ|>парфюм	p ɐ r fʲ u m
<|БЪЛ|>ден	d ɛ n
<|БЪЛ|>спя	s pʲ ɤ
<|БЪЛ|>затека	z ɐ t ɛ k ɤ
<|БЪЛ|>корист	k ɔ r i s t
<|БЪЛ|>азот	ɐ z ɔ t
<|БЪЛ|>театър	t ɛ a t ɐ r
<|БЪЛ|>гемия	ɡʲ ɛ m i j ɐ
<|БЪЛ|>предполагам	p r ɛ t p o ɫ a ɡ ɐ m
<|БЪЛ|>мишца	m i ʃ t͡s ɐ
<|БЪЛ|>пека	p ɛ k ɤ
<|БЪЛ|>инстинкт	i n s t i n k t
<|БЪЛ|>вестник	v ɛ s n i k
<|БЪЛ|>абсциса	ɐ p s t͡s i s ɐ
<|БЪЛ|>пигментен	p i ɡ m ɛ n t ɛ n
<|БЪЛ|>свалям	s v a lʲ ɐ m
<|БЪЛ|>ласка	ɫ a s k ɐ
<|БЪЛ|>кимна	kʲ i m n ɐ
<|БЪЛ|>пасох	p a s o x
<|БЪЛ|>дизя	d i zʲ ɐ
<|БЪЛ|>роднина	r o d n i n ɐ
<|БЪЛ|>пакет	p ɐ kʲ ɛ t
<|БЪЛ|>богиня	b o ɡʲ i nʲ ɐ
<|БЪЛ|>щяхме	ʃ tʲ a x m ɛ
<|БЪЛ|>исландски	i s ɫ a n t s kʲ i
<|БЪЛ|>жужел	ʒ u ʒ ɛ ɫ
<|БЪЛ|>феникс	f ɛ n i k s
<|БЪЛ|>хирургически	xʲ i r u r ɡʲ i t͡ʃ ɛ s kʲ i
<|БЪЛ|>имахте	i m a x t ɛ
<|БЪЛ|>апс	a p s
<|БЪЛ|>мъгла	m ɐ ɡ ɫ a
<|БЪЛ|>тъмница	t ɐ m n i t͡s ɐ
<|БЪЛ|>авлия	ɐ v lʲ i j ɐ
<|БЪЛ|>става	s t a v ɐ
<|БЪЛ|>индикативен	i n d i k ɐ t i v ɛ n
<|БЪЛ|>взривен	v z r i v ɛ n
<|БЪЛ|>лук	ɫ u k
<|БЪЛ|>бургас	b u r ɡ a s
<|БЪЛ|>нагриза	n ɐ ɡ r i z ɐ
<|БЪЛ|>дрехи	d r ɛ xʲ i
<|БЪЛ|>токачка	t o k a t͡ʃ k ɐ
<|БЪЛ|>моля	m ɔ lʲ ɐ
<|БЪЛ|>бълха	b ɐ ɫ x a
<|БЪЛ|>основателност	o s n o v a t ɛ ɫ n o s t
<|БЪЛ|>защо	z ɐ ʃ t ɔ
<|БЪЛ|>брегът	b r ɛ ɡ ɤ t
<|БЪЛ|>кубик	k u b i k
<|БЪЛ|>строг	s t r ɔ k
<|БЪЛ|>черта	t͡ʃ ɛ r t a
<|БЪЛ|>котка	k ɔ t k ɐ
<|БЪЛ|>узаконях	u z ɐ k o nʲ a x
<|БЪЛ|>сой	s ɔ j
<|БЪЛ|>юрган	j u r ɡ a n
<|БЪЛ|>острие	o s t r i ɛ
<|БЪЛ|>мрящото	m rʲ a ʃ t o t o
<|БЪЛ|>ледовит	lʲ ɛ d o v i t
<|БЪЛ|>конкретен	k o n k r ɛ t ɛ n
<|БЪЛ|>огромен	o ɡ r ɔ m ɛ n
<|БЪЛ|>махам	m a x ɐ m
<|БЪЛ|>разлог	r ɐ z ɫ ɔ k
<|БЪЛ|>арка	a r k ɐ
<|БЪЛ|>лава	ɫ a v ɐ
<|БЪЛ|>мушитрънка	m u ʃ i t r ɤ n k ɐ
<|БЪЛ|>дрипав	d r i p ɐ f
<|БЪЛ|>изтребя	i s t r ɛ bʲ ɐ
<|БЪЛ|>узаконяваше	u z ɐ k o nʲ a v ɐ ʃ ɛ
<|БЪЛ|>узаконяват	u z ɐ k o nʲ a v ɐ t
<|БЪЛ|>авиационен	a v i ɐ t͡s i ɔ n ɛ n
<|БЪЛ|>узаконените	u z ɐ k o n ɛ n i t ɛ
<|БЪЛ|>офис	ɔ f i s
<|БЪЛ|>прям	p rʲ a m
<|БЪЛ|>зависим	z ɐ v i s i m
<|БЪЛ|>пуйка	p u j k ɐ
<|БЪЛ|>шествие	ʃ ɛ s t v i ɛ
<|БЪЛ|>тръгна	t r ɐ ɡ n a
<|БЪЛ|>операция	o p ɛ r a t͡s i j ɐ
<|БЪЛ|>надонеса	n ɐ d o n ɛ s ɤ
<|БЪЛ|>оръдие	o r ɤ d i ɛ
<|БЪЛ|>продавам	p r o d a v ɐ m
<|БЪЛ|>безсмъртен	b ɛ s s m ɤ r t ɛ n
<|БЪЛ|>солен	s o lʲ ɛ n
<|БЪЛ|>ухапете	u x a p ɛ t ɛ
<|БЪЛ|>арестувахме	a r ɛ s t u v a x m ɛ
<|БЪЛ|>спътник	s p ɤ t n i k
<|БЪЛ|>долар	d ɔ ɫ ɐ r
<|БЪЛ|>жертва	ʒ ɛ r t v ɐ
<|БЪЛ|>падина	p ɐ d i n a
<|БЪЛ|>забранявам	z ɐ b r ɐ nʲ a v ɐ m
<|БЪЛ|>допринасям	d o p r i n a sʲ ɐ m
<|БЪЛ|>литий	lʲ i t i
<|БЪЛ|>градовете	ɡ r ɐ d o v ɛ t ɛ
<|БЪЛ|>трудно	t r u d n o
<|БЪЛ|>физичен	f i z i t͡ʃ ɛ n
<|БЪЛ|>отпущам	o t p u ʃ t ɐ m
<|БЪЛ|>тук	t u k
<|БЪЛ|>вашто	v a ʃ t o
<|БЪЛ|>освен	o s v ɛ n
<|БЪЛ|>боже	b ɔ ʒ ɛ
<|БЪЛ|>свитък	s v i t ɐ k
<|БЪЛ|>странен	s t r a n ɛ n
<|БЪЛ|>сквозе	s k v ɔ z ɛ
<|БЪЛ|>основателно	o s n o v a t ɛ ɫ n o
<|БЪЛ|>къделя	k ɐ d ɛ lʲ ɐ
<|БЪЛ|>река	r ɛ k a
<|БЪЛ|>у	u
<|БЪЛ|>съединител	s ɐ ɛ d i n i t ɛ ɫ
<|БЪЛ|>горест	ɡ ɔ r ɛ s t
<|БЪЛ|>отново	o t n ɔ v o
<|БЪЛ|>дворец	d v o r ɛ t͡s
<|БЪЛ|>чък	t͡ʃ ɤ k
<|БЪЛ|>боец	b o ɛ t͡s
<|БЪЛ|>дилянка	d i lʲ a n k ɐ
<|БЪЛ|>четири	t͡ʃ ɛ t i r i
<|БЪЛ|>затресе	z ɐ t r ɛ s ɛ
<|БЪЛ|>маниак	m ɐ n i a k
<|БЪЛ|>изковавам	i s k o v a v ɐ m
<|БЪЛ|>екип	ɛ kʲ i p
<|БЪЛ|>адет	ɐ d ɛ t
<|БЪЛ|>фабрика	f a b r i k ɐ
<|БЪЛ|>законен	z ɐ k ɔ n ɛ n
<|БЪЛ|>помолвам	p o m ɔ ɫ v ɐ m
<|БЪЛ|>бивам	b i v ɐ m
<|БЪЛ|>учителски	u t͡ʃ i t ɛ ɫ s kʲ i
<|БЪЛ|>отвес	o t v ɛ s
<|БЪЛ|>такава	t ɐ k a v ɐ
<|БЪЛ|>прозорче	p r o z ɔ r t͡ʃ ɛ
<|БЪЛ|>британия	b r i t a n i j ɐ
<|БЪЛ|>костница	k ɔ s n i t͡s ɐ
<|БЪЛ|>кожух	k o ʒ u x
<|БЪЛ|>аварски	ɐ v a r s kʲ i
<|БЪЛ|>бъди	b ɐ d i
<|БЪЛ|>пари	p a r i
<|БЪЛ|>книжен	k n i ʒ ɛ n
<|БЪЛ|>гадолиний	ɡ ɐ d o lʲ i n i
<|БЪЛ|>твойто	t v ɔ j t o
<|БЪЛ|>заема	z ɐ ɛ m ɐ
<|БЪЛ|>глас	ɡ ɫ a s
<|БЪЛ|>единица	ɛ d i n i t͡s ɐ
<|БЪЛ|>стилистка	s t i lʲ i s k ɐ
<|БЪЛ|>пате	p a t ɛ
<|БЪЛ|>ирландски	i r ɫ a n t s kʲ i
<|БЪЛ|>депонентен	d ɛ p o n ɛ n t ɛ n
<|БЪЛ|>тайна	t a j n ɐ
<|БЪЛ|>купи	k u p i
<|БЪЛ|>вирус	v i r u s
<|БЪЛ|>ламаринен	ɫ ɐ m ɐ r i n ɛ n
<|БЪЛ|>бележит	b ɛ lʲ ɛ ʒ i t
<|БЪЛ|>експедиция	ɛ k s p ɛ d i t͡s i j ɐ
<|БЪЛ|>любов	lʲ u b ɔ f
<|БЪЛ|>танц	t a n t͡s
<|БЪЛ|>граждански	ɡ r a ʒ d ɐ n s kʲ i
<|БЪЛ|>енциклопедия	ɛ n t͡s i k ɫ o p ɛ d i j ɐ
<|БЪЛ|>антре	ɐ n t r ɛ
<|БЪЛ|>шибой	ʃ i b ɔ j
<|БЪЛ|>почва	p o t͡ʃ v a
<|БЪЛ|>венера	v ɛ n ɛ r ɐ
<|БЪЛ|>ален	a lʲ ɛ n
<|БЪЛ|>авантюристически	ɐ v ɐ n tʲ u r i s t i t͡ʃ ɛ s kʲ i
<|БЪЛ|>свойто	s v ɔ j t o
<|БЪЛ|>калай	k ɐ ɫ a j
<|БЪЛ|>сатанински	s ɐ t ɐ n i n s kʲ i
<|БЪЛ|>елементарен	ɛ lʲ ɛ m ɛ n t a r ɛ n
<|БЪЛ|>як	j a k
<|БЪЛ|>прочут	p r o t͡ʃ u t
<|БЪЛ|>пристоен	p r i s t ɔ ɛ n
<|БЪЛ|>писмо	p i s m ɔ
<|БЪЛ|>узаконилото	u z ɐ k o n i ɫ o t o
<|БЪЛ|>алигатор	ɐ lʲ i ɡ a t o r
<|БЪЛ|>въоръжавам	v ɐ o r ɐ ʒ a v ɐ m
<|БЪЛ|>полуостров	p o ɫ u ɔ s t r o f
<|БЪЛ|>коноп	k o n ɔ p
<|БЪЛ|>подчертавам	p o t t͡ʃ ɛ r t a v ɐ m
<|БЪЛ|>пречупвам	p r ɛ t͡ʃ u p v ɐ m
<|БЪЛ|>лебедица	lʲ ɛ b ɛ d i t͡s ɐ
<|БЪЛ|>философия	f i ɫ o s ɔ f i j ɐ
<|БЪЛ|>полувреме	p o ɫ u v r ɛ m ɛ
<|БЪЛ|>кино	kʲ i n o
<|БЪЛ|>регистрационен	r ɛ ɡʲ i s t r ɐ t͡s i ɔ n ɛ n
<|БЪЛ|>любопитен	lʲ u b o p i t ɛ n
<|БЪЛ|>жаба	ʒ a b ɐ
<|БЪЛ|>родителен	r o d i t ɛ lʲ ɛ n
<|БЪЛ|>майтнерий	m ɐ j t n ɛ r i
<|БЪЛ|>игрив	i ɡ r i f
<|БЪЛ|>чужденец	t͡ʃ u ʒ d ɛ n ɛ t͡s
<|БЪЛ|>извикам	i z v i k ɐ m
<|БЪЛ|>отдел	o d d ɛ ɫ
<|БЪЛ|>жълтеникав	ʒ ɐ ɫ t ɛ n i k ɐ f
<|БЪЛ|>никта	n i k t ɐ
<|БЪЛ|>чушле	t͡ʃ u ʃ lʲ ɛ
<|БЪЛ|>ядящо	j a dʲ a ʃ t o
<|БЪЛ|>имате	i m ɐ t ɛ
<|БЪЛ|>монако	m o n a k o
<|БЪЛ|>вид	v i t
<|БЪЛ|>фалшив	f ɐ ɫ ʃ i f
<|БЪЛ|>водород	v o d o r ɔ t
<|БЪЛ|>лимони	lʲ i m ɔ n i
<|БЪЛ|>тербий	t ɛ r b i
<|БЪЛ|>дойда	d ɔ j d ɐ
<|БЪЛ|>разпределение	r ɐ s p r ɛ d ɛ lʲ ɛ n i ɛ
<|БЪЛ|>бруя	b r u j ɐ
<|БЪЛ|>бъдеш	b ɤ d ɛ ʃ
<|БЪЛ|>начален	n ɐ t͡ʃ a lʲ ɛ n
<|БЪЛ|>червеношийка	t͡ʃ ɛ r v ɛ n o ʃ i k ɐ
<|БЪЛ|>хокам	x ɔ k ɐ m
<|БЪЛ|>октомври	o k t ɔ m v r i
<|БЪЛ|>тигър	t i ɡ ɐ r
<|БЪЛ|>ватикана	v ɐ t i k a n ɐ
<|БЪЛ|>магаре	m ɐ ɡ a r ɛ
<|БЪЛ|>мир	m i r
<|БЪЛ|>смущение	s m u ʃ t ɛ n i ɛ
<|БЪЛ|>средище	s r ɛ d i ʃ t ɛ
<|БЪЛ|>узаконеният	u z ɐ k o n ɛ n i j ɐ t
<|БЪЛ|>оженя	o ʒ ɛ nʲ ɐ
<|БЪЛ|>българка	b ɤ ɫ ɡ ɐ r k ɐ
<|БЪЛ|>торба	t o r b a
<|БЪЛ|>за	z a
<|БЪЛ|>акумулатор	ɐ k u m u ɫ a t o r
<|БЪЛ|>мразовит	m r ɐ z o v i t
<|БЪЛ|>брош	b r ɔ ʃ
<|БЪЛ|>звънлив	z v ɐ n lʲ i f
<|БЪЛ|>йерарх	j ɛ r a r x
<|БЪЛ|>промеждутък	p r o m ɛ ʒ d u t ɐ k
<|БЪЛ|>фир	f i r
<|БЪЛ|>ладия	ɫ ɐ d i j ɐ
<|БЪЛ|>понапека	p o n ɐ p ɛ k ɤ
<|БЪЛ|>абисински	ɐ b i s i n s kʲ i
<|БЪЛ|>членувано	t͡ʃ lʲ ɛ n u v ɐ n o
<|БЪЛ|>чивия	t͡ʃ i v i j ɐ
<|БЪЛ|>чук	t͡ʃ u k
<|БЪЛ|>кукувица	k u k u v i t͡s ɐ
<|БЪЛ|>избия	i z b i j ɐ
<|БЪЛ|>мазен	m a z ɛ n
<|БЪЛ|>лактационен	ɫ ɐ k t ɐ t͡s i ɔ n ɛ n
<|БЪЛ|>мрели	m r ɛ lʲ i
<|БЪЛ|>случай	s ɫ u t͡ʃ a j
<|БЪЛ|>шоколад	ʃ o k o ɫ a t
<|БЪЛ|>узаконявахте	u z ɐ k o nʲ a v ɐ x t ɛ
<|БЪЛ|>разлат	r ɐ z ɫ a t
<|БЪЛ|>всякаква	f sʲ a k ɐ k v ɐ
<|БЪЛ|>мъжкар	m ɐ ʃ k a r
<|БЪЛ|>бедя	b ɛ dʲ ɤ
<|БЪЛ|>кон	k ɔ n
<|БЪЛ|>беларус	b ɛ ɫ ɐ r u s
<|БЪЛ|>двойствен	d v ɔ j s t v ɛ n
<|БЪЛ|>толкоз	t ɔ ɫ k o s
<|БЪЛ|>машина	m ɐ ʃ i n ɐ
<|БЪЛ|>дърводелец	d ɐ r v o d ɛ lʲ ɛ t͡s
<|БЪЛ|>мощ	m ɔ ʃ t
<|БЪЛ|>техни	t ɛ x n i
<|БЪЛ|>драгой	d r ɐ ɡ ɔ j
<|БЪЛ|>откриваем	o t k r i v a ɛ m
<|БЪЛ|>загивам	z ɐ ɡʲ i v ɐ m
<|БЪЛ|>съдебен	s ɐ d ɛ b ɛ n
<|БЪЛ|>сеизмичен	s ɛ i z m i t͡ʃ ɛ n
<|БЪЛ|>дайка	d a j k ɐ
<|БЪЛ|>вадя	v a dʲ ɐ
<|БЪЛ|>благоевград	b ɫ ɐ ɡ ɔ ɛ v ɡ r ɐ t
<|БЪЛ|>лиляк	lʲ i lʲ ɐ k
<|БЪЛ|>пирон	p i r ɔ n
<|БЪЛ|>швеция	ʃ v ɛ t͡s i j ɐ
<|БЪЛ|>ядящата	j a dʲ a ʃ t ɐ t ɐ
<|БЪЛ|>право	p r a v o
<|БЪЛ|>робия	r o b i j ɐ
<|БЪЛ|>странноприемница	s t r ɐ n n o p r i ɛ m n i t͡s ɐ
<|БЪЛ|>дръвце	d r ɐ f t͡s ɛ
<|БЪЛ|>вина	v i n a
<|БЪЛ|>оцветявам	o t͡s v ɛ tʲ a v ɐ m
<|БЪЛ|>варшава	v ɐ r ʃ a v ɐ
<|БЪЛ|>израстък	i z r a s t ɐ k
<|БЪЛ|>електронен	ɛ lʲ ɛ k t r ɔ n ɛ n
<|БЪЛ|>съществувам	s ɐ ʃ t ɛ s t v u v ɐ m
<|БЪЛ|>мренетата	m r ɛ n ɛ t ɐ t ɐ
<|БЪЛ|>подозра	p o d o z r ɤ
<|БЪЛ|>говорете	ɡ o v o r ɛ t ɛ
<|БЪЛ|>било	b i ɫ o
<|БЪЛ|>разум	r a z u m
<|БЪЛ|>абдоминален	ɐ b d o m i n a lʲ ɛ n
<|БЪЛ|>клоун	k ɫ ɔ u n
<|БЪЛ|>вероятно	v ɛ r o j a t n o
<|БЪЛ|>кадифе	k ɐ d i f ɛ
<|БЪЛ|>едновременен	ɛ d n o v r ɛ m ɛ n ɛ n
<|БЪЛ|>дреха	d r ɛ x ɐ
<|БЪЛ|>шугав	ʃ u ɡ ɐ f
<|БЪЛ|>мастит	m ɐ s t i t
<|БЪЛ|>тайван	t ɐ j v a n
<|БЪЛ|>матрак	m ɐ t r a k
<|БЪЛ|>раждане	r a ʒ d ɐ n ɛ
<|БЪЛ|>чедо	t͡ʃ ɛ d o
<|БЪЛ|>избоде	i z b o d ɛ
<|БЪЛ|>черешарка	t͡ʃ ɛ r ɛ ʃ a r k ɐ
<|БЪЛ|>доверие	d o v ɛ r i ɛ
<|БЪЛ|>архитектурен	ɐ r xʲ i t ɛ k t u r ɛ n
<|БЪЛ|>сияехме	s i j a ɛ x m ɛ
<|БЪЛ|>грънчарница	ɡ r ɐ n t͡ʃ a r n i t͡s ɐ
<|БЪЛ|>гълъбица	ɡ ɐ ɫ ɐ b i t͡s ɐ
<|БЪЛ|>ястребов	j a s t r ɛ b o f
<|БЪЛ|>щем	ʃ t ɛ m
<|БЪЛ|>напълно	n ɐ p ɤ ɫ n o
<|БЪЛ|>неголям	n ɛ ɡ o lʲ ɐ m
<|БЪЛ|>зрете	z r ɛ t ɛ
<|БЪЛ|>кей	kʲ ɛ j
<|БЪЛ|>лейди	lʲ ɛ j d i
<|БЪЛ|>трескав	t r ɛ s k ɐ f
<|БЪЛ|>иглика	i ɡ lʲ i k ɐ
<|БЪЛ|>поличба	p o lʲ i d͡ʒ b ɐ
<|БЪЛ|>бъдете	b ɐ d ɛ t ɛ
<|БЪЛ|>пошъл	p ɔ ʃ ɐ ɫ
<|БЪЛ|>изговори	i z ɡ o v o r i
<|БЪЛ|>носия	n o s i j ɐ
<|БЪЛ|>боб	b ɔ p
<|БЪЛ|>криеница	k r i ɛ n i t͡s ɐ
<|БЪЛ|>членестоного	t͡ʃ lʲ ɛ n ɛ s t o n ɔ ɡ o
<|БЪЛ|>хлорофил	x ɫ o r o f i ɫ
<|БЪЛ|>луча	ɫ u t͡ʃ ɐ
<|БЪЛ|>жираф	ʒ i r a f
<|БЪЛ|>особняк	o s o b nʲ a k
<|БЪЛ|>неговото	n ɛ ɡ o v o t o
<|БЪЛ|>единайсет	ɛ d i n a j s ɛ t
<|БЪЛ|>нещастие	n ɛ ʃ t a s t i ɛ
<|БЪЛ|>снощи	s n ɔ ʃ t i
<|БЪЛ|>мряхме	m rʲ a x m ɛ
<|БЪЛ|>ясмин	j ɐ s m i n
<|БЪЛ|>протоме	p r o t ɔ m ɛ
<|БЪЛ|>панаир	p ɐ n ɐ i r
<|БЪЛ|>шести	ʃ ɛ s t i
<|БЪЛ|>струга	s t r u ɡ ɐ
<|БЪЛ|>често	t͡ʃ ɛ s t o
<|БЪЛ|>волан	v o ɫ a n
<|БЪЛ|>срака	s r a k ɐ
<|БЪЛ|>работничка	r ɐ b ɔ t n i t͡ʃ k ɐ
<|БЪЛ|>ваште	v a ʃ t ɛ
<|БЪЛ|>школа	ʃ k ɔ ɫ ɐ
<|БЪЛ|>въвра	v ɐ v r ɤ
<|БЪЛ|>бог	b ɔ k
<|БЪЛ|>тези	t ɛ z i
<|БЪЛ|>къртичи	k ɐ r t i t͡ʃ i
<|БЪЛ|>пасохме	p a s o x m ɛ
<|БЪЛ|>принц	p r i n t͡s
<|БЪЛ|>съчетавам	s ɐ t͡ʃ ɛ t a v ɐ m
<|БЪЛ|>равен	r a v ɛ n
<|БЪЛ|>нейни	n ɛ j n i
<|БЪЛ|>дори	d o r i
<|БЪЛ|>прощален	p r o ʃ t a lʲ ɛ n
<|БЪЛ|>оцет	o t͡s ɛ t
<|БЪЛ|>храм	x r a m
<|БЪЛ|>джийн	d ʒ i n
<|БЪЛ|>шептя	ʃ ɛ p tʲ ɤ
<|БЪЛ|>стилов	s t i ɫ o f
<|БЪЛ|>рухо	r u x o
<|БЪЛ|>управителка	u p r a v i t ɛ ɫ k ɐ
<|БЪЛ|>разшифровам	r ɐ ʃ ʃ i f r ɔ v ɐ m
<|БЪЛ|>киноцентър	kʲ i n o t͡s ɛ n t ɐ r
<|БЪЛ|>телефон	t ɛ lʲ ɛ f ɔ n
<|БЪЛ|>пасящия	p ɐ sʲ a ʃ t i j ɐ
<|БЪЛ|>чукундур	t͡ʃ u k u n d u r
<|БЪЛ|>оберон	ɔ b ɛ r o n
<|БЪЛ|>запреда	z ɐ p r ɛ d ɤ
<|БЪЛ|>татко	t a t k o
<|БЪЛ|>плавей	p ɫ a v ɛ j
<|БЪЛ|>канара	k ɐ n ɐ r a
<|БЪЛ|>ганимед	ɡ ɐ n i m ɛ t
<|БЪЛ|>къщо	k ɤ ʃ t o
<|БЪЛ|>коля	k ɔ lʲ ɐ
<|БЪЛ|>хулиганство	x u lʲ i ɡ a n s t v o
<|БЪЛ|>собол	s o b ɔ ɫ
<|БЪЛ|>деспотизъм	d ɛ s p o t i z ɐ m
<|БЪЛ|>движа	d v i ʒ ɐ
<|БЪЛ|>би	b i
<|БЪЛ|>отличим	o t lʲ i t͡ʃ i m
<|БЪЛ|>доя	d o j ɤ
<|БЪЛ|>дециметър	d ɛ t͡s i m ɛ t ɐ r
<|БЪЛ|>акушерка	ɐ k u ʃ ɛ r k ɐ
<|БЪЛ|>злъч	z ɫ ɤ t͡ʃ
<|БЪЛ|>долина	d o lʲ i n a
<|БЪЛ|>загреб	z a ɡ r ɛ p
<|БЪЛ|>рунтав	r u n t ɐ f
<|БЪЛ|>радвам	r a d v ɐ m
<|БЪЛ|>тоалет	t o ɐ lʲ ɛ t
<|БЪЛ|>превъзхождам	p r ɛ v ɐ s x ɔ ʒ d ɐ m
<|БЪЛ|>атентат	ɐ t ɛ n t a t
<|БЪЛ|>гълъб	ɡ ɤ ɫ ɐ p
<|БЪЛ|>гостилница	ɡ o s t i ɫ n i t͡s ɐ
<|БЪЛ|>изгубя	i z ɡ u bʲ ɐ
<|БЪЛ|>преперец	p r ɛ p ɛ r ɛ t͡s
<|БЪЛ|>панталон	p ɐ n t ɐ ɫ ɔ n
<|БЪЛ|>серен	s ɛ r ɛ n
<|БЪЛ|>вегав	v ɛ ɡ ɐ f
<|БЪЛ|>бодил	b o d i ɫ
<|БЪЛ|>плащ	p ɫ a ʃ t
<|БЪЛ|>лютив	lʲ u t i f
<|БЪЛ|>определен	o p r ɛ d ɛ lʲ ɛ n
<|БЪЛ|>плащам	p ɫ a ʃ t ɐ m
<|БЪЛ|>саксия	s ɐ k s i j ɐ
<|БЪЛ|>пищен	p i ʃ t ɛ n
<|БЪЛ|>озаглавя	o z ɐ ɡ ɫ ɐ vʲ ɤ
<|БЪЛ|>невъзможно	n ɛ v ɐ z m ɔ ʒ n o
<|БЪЛ|>бастилия	b ɐ s t i lʲ i j ɐ
<|БЪЛ|>узаконяването	u z ɐ k o nʲ a v ɐ n ɛ t o
<|БЪЛ|>щедър	ʃ t ɛ d ɐ r
<|БЪЛ|>огорча	o ɡ o r t͡ʃ a
<|БЪЛ|>много	m n ɔ ɡ o
<|БЪЛ|>бразилия	b r ɐ z i lʲ i j ɐ
<|БЪЛ|>ярък	j a r ɐ k
<|БЪЛ|>клюн	k lʲ u n
<|БЪЛ|>абдикиралата	ɐ b d i kʲ i r ɐ ɫ ɐ t ɐ
<|БЪЛ|>мях	mʲ a x
<|БЪЛ|>извиквам	i z v i k v ɐ m
<|БЪЛ|>апсида	ɐ p s i d ɐ
<|БЪЛ|>напредък	n ɐ p r ɛ d ɐ k
<|БЪЛ|>култура	k u ɫ t u r ɐ
<|БЪЛ|>братски	b r a t s kʲ i
<|БЪЛ|>азе	a z ɛ
<|БЪЛ|>зърна	z ɤ r n ɐ
<|БЪЛ|>годинак	ɡ o d i n a k
<|БЪЛ|>раждам	r a ʒ d ɐ m
<|БЪЛ|>глух	ɡ ɫ u x
<|БЪЛ|>лют	lʲ u t
<|БЪЛ|>очен	ɔ t͡ʃ ɛ n
<|БЪЛ|>фикус	f i k u s
<|БЪЛ|>парк	p a r k
<|БЪЛ|>посетител	p o s ɛ t i t ɛ ɫ
<|БЪЛ|>мегаметър	m ɛ ɡ ɐ m ɛ t ɐ r
<|БЪЛ|>сценарий	s t͡s ɛ n a r i
<|БЪЛ|>камшик	k ɐ m ʃ i k
<|БЪЛ|>вашето	v a ʃ ɛ t o
<|БЪЛ|>смрадливец	s m r ɐ d lʲ i v ɛ t͡s
<|БЪЛ|>университет	u n i v ɛ r s i t ɛ t
<|БЪЛ|>матерен	m a t ɛ r ɛ n
<|БЪЛ|>краен	k r a ɛ n
<|БЪЛ|>нар	n a r
<|БЪЛ|>картал	k ɐ r t a ɫ
<|БЪЛ|>дрозд	d r ɔ s t
<|БЪЛ|>петрол	p ɛ t r ɔ ɫ
<|БЪЛ|>пасене	p ɐ s ɛ n ɛ
<|БЪЛ|>извличам	i z v lʲ i t͡ʃ ɐ m
<|БЪЛ|>ищах	i ʃ t a x
<|БЪЛ|>колибри	k o lʲ i b r i
<|БЪЛ|>русло	r u s ɫ o
<|БЪЛ|>редя	r ɛ dʲ a
<|БЪЛ|>институт	i n s t i t u t
<|БЪЛ|>труден	t r u d ɛ n
<|БЪЛ|>кралски	k r a ɫ s kʲ i
<|БЪЛ|>ексалитър	ɐ t o lʲ i t ɐ r
<|БЪЛ|>гнилоч	ɡ n i ɫ ɔ t͡ʃ
<|БЪЛ|>двуличен	d v u lʲ i t͡ʃ ɛ n
<|БЪЛ|>сърбин	s ɤ r b i n
<|БЪЛ|>трици	t r i t͡s i
<|БЪЛ|>миризма	m i r i z m a
<|БЪЛ|>деепричастие	d ɛ ɛ p r i t͡ʃ a s t i ɛ
<|БЪЛ|>прегиня	p r ɛ ɡʲ i nʲ ɐ
<|БЪЛ|>щяла	ʃ tʲ a ɫ ɐ
<|БЪЛ|>мамут	m ɐ m u t
<|БЪЛ|>узаконят	u z ɐ k o nʲ ɤ t
<|БЪЛ|>леко	lʲ ɛ k o
<|БЪЛ|>пръчица	p r ɤ t͡ʃ i t͡s ɐ
<|БЪЛ|>гигантски	ɡʲ i ɡ a n t s kʲ i
<|БЪЛ|>дума	d u m ɐ
<|БЪЛ|>изток	i s t o k
<|БЪЛ|>усмихвам	u s m i x v ɐ m
<|БЪЛ|>благословия	b ɫ ɐ ɡ o s ɫ o v i j ɐ
<|БЪЛ|>сви	s v i
<|БЪЛ|>германски	ɡʲ ɛ r m a n s kʲ i
<|БЪЛ|>гибел	ɡʲ i b ɛ ɫ
<|БЪЛ|>багър	b a ɡ ɐ r
<|БЪЛ|>безплатен	b ɛ s p ɫ a t ɛ n
<|БЪЛ|>корона	k o r ɔ n ɐ
<|БЪЛ|>аерометър	a ɛ r o m ɛ t ɐ r
<|БЪЛ|>суровина	s u r o v i n a
