bayawak	b a j a w a k
pabor	p a b o ɾ
Cobarrubias	k o b a ɾ u b j a s
luminis	l u m i n i s
Arevalo	ʔ a ɾ e v a l o
malikhain	m a l i k h a ʔ i n
Kuwaresma	k u a ɾ e s m a
propesyonalismo	p ɾ o p e s j o n a l i s m o
ingkorporasyon	ʔ i ŋ k o ɾ p o ɾ a s j o n
Lumibao	l u m i b a w
mahinhin	m a h i n h i n
sapak	s a p a k
lamasin	l a m a s i n
letsugas	l e t͡ʃ u ɡ a s
panwelo	p a n w e l o
milagro	m i l a ɡ ɾ o
Collado	k o l j a d o
kolehiyal	k o l e h i a l
samo	s a m o ʔ
mambabarang	ˌm a m b a b a ɾ a ŋ
bibliyoteka	b i b l i o t e k a
magaan	m a ɡ a ʔ a n
literatura	l i t e ɾ a t u ɾ a
z	z i
Clemente	k l e m e n t e
mamuhay	m a m u h a j
entero	ʔ e n t e ɾ o
teista	t e i s t a
korido	k o ɾ i d o
rehente	ɾ e h e n t e
ibabaan	ʔ i b a b a ʔ a n
patol	p a t o l
pinansiyal	p i ˌn a n s i a l
sigwasan	s i ɡ w a s a n
Gabaldon	ɡ a b a l d o n
pinapagtawanan	p i ˌn a p a ɡ t a w a n a n
bulsa	b u l s a
baligtad	b a l i ɡ t a d
balimbing	b a l i m b i ŋ
asog	ʔ a s o ɡ
matitibay	m a t i t i b a j
Cu	k u
Heminis	h e m i n i s
Cavite	k a v i t e
giwa	ɡ i w a ʔ
Odeste	ʔ o d e s t e
Lascano	l a s k a n o
sumunod	s u m u n o d
konsumido	k o n s u m i d o
bokya	b o k j a ʔ
misis	m i s i s
Montemayor	m o n t e m a j o ɾ
bungaw	b u ŋ a w
halumigmig	h a l u m i ɡ m i ɡ
makuha	m a k u h a
butot	b u t o t
langhap	l a ŋ h a p
ermita	ʔ e ɾ m i t a
bansalagin	b a n s a l a ɡ i n
kakabig	k a k a b i ɡ
bansot	b a n s o t
nabuwisit	n a b u i s i t
pagerper	ˌp a ɡ e ɾ p e ɾ
luwang	l u a ŋ
perspektiba	p e ɾ s p e k t i b a
tsitsa	t͡ʃ i t͡ʃ a
makaramdam	m a k a ɾ a m d a m
eksperimento	ʔ e k s p e ɾ i m e n t o
tako	t a k o
hirol	h i ɾ o l
Indotsina	ʔ i n d o t͡ʃ i n a
alisangsang	ʔ a l i s a ŋ s a ŋ
Libjo	l i b h o ʔ
Gerda	ɡ e ɾ d a
baat	b a ʔ a t
sidlan	s i d l a n
kanal	k a n a l
mamutla	m a m u t l a ʔ
trabahador	t ɾ a b a h a d o ɾ
adiksiyon	ʔ a d i k s j o n
batubalani	b a t u b a l a n i ʔ
abyugin	ʔ a b j u ɡ i n
kompiyuteran	k o m p i u t e ɾ a n
abuhin	ʔ a b u h i n
adisyon	ʔ a d i s j o n
kukis	k u k i s
kandidatura	k a n d i d a t u ɾ a
kawingan	k a w i ŋ a n
duwag	d u a ɡ
palaisipan	p a ˌl a ʔ i s i p a n
himlay	h i m l a j
entremetido	ʔ e n t ɾ e m e t i d o
tupak	t u p a k
parlamentaryo	p a ɾ l a m e n t a ɾ j o
dinagipik	d i n a ɡ i p i k
Anunsiyasyon	ʔ a n u n s i a s j o n
tugi	t u ɡ i ʔ
hukuman	h u k u m a n
Mallare	m a l j a ɾ e
dagasa	d a ɡ a s a ʔ
iresponsable	ʔ i r e s p o n s a b l e
Diamante	d j a m a n t e
megalomanya	m e ɡ a l o m a n j a
sidhi	s i d h i ʔ
Tiongco	t i o ŋ k o
manlait	m a n l a ʔ i t
gabay	ɡ a b a j
singaw	s i ŋ a w
gusilaw	ɡ u s i l a w
kudlong	k u d l o ŋ
Closa	k l o s a
konektado	k o n e k t a d o
GRO	d j i ʔ a ɾ ʔ o
pagkaigkasin	p a ɡ k a ʔ i ɡ k a s i n
Lubiano	l u b j a n o
kumpensasyon	k u m p e n s a s j o n
malakas	m a l a k a s
diyablo	d i a b l o
hangganan	h a ŋ ɡ a n a n
Layco	l a j k o
Aliga	ʔ a l i ɡ a
taglamig	t a ɡ l a m i ɡ
Kaprikorniyo	k a p ɾ i k o ɾ n j o
maski	m a s k i
enagwas	ʔ e n a ɡ w a s
kinyang	k i n j a ŋ
arkitektura	ʔ a ɾ k i t e k t u ɾ a
masikip	m a s i k i p
kilitis	k i l i t i s
habulan	h a b u l a n
sawil	s a w i l
masamid	m a s a m i d
disko	d i s k o
parinlas	p a ɾ i n l a s
labanderiya	l a ˌb a n d e ɾ i a
pasma	p a s m a
hawsyaw	h a w s j a w
orasyon	ʔ o ɾ a s j o n
Maranan	m a ɾ a n a n
Singgapur	s i ŋ ɡ a p u ɾ
eskapularyo	ʔ e s k a p u l a ɾ j o
peryodista	p e ɾ j o d i s t a
gatilyo	ɡ a t i l j o
burak	b u ɾ a k
bini	b i n i ʔ
bulo	b u l o ʔ
tangay	t a ŋ a j
humiram	h u m i ɾ a m
ibinigay	ʔ i b i n i ɡ a j
dupa	d u p a ʔ
pison	p i s o n
kurot	k u ɾ o t
Asistio	ʔ a s i s t j o
kabinet	k a b i n e t
kuros	k u ɾ o s
yumanig	j u m a n i ɡ
Sarenas	s a ɾ e n a s
primo	p ɾ i m o
Barbie	b a ɾ b i
timayok	t i m a j o k
letson	l e t͡ʃ o n
ruwina	ɾ u i n a
Pansol	p a n s o l
sambong	s a m b o ŋ
kakanin	k a k a n i n
apak	ʔ a p a k
sisid	s i s i d
matangkad	m a t a ŋ k a d
Awstralya	ʔ a w s t ɾ a l j a
Tagaytay	t a ɡ a j t a j
Ruedas	ɾ u e d a s
magbasanlot	m a ɡ b a s a n l o t
mahalaga	m a h a l a ɡ a
ipatapon	ʔ i p a t a p o n
sinturon	s i n t u ɾ o n
linggatong	l i ŋ ɡ a t o ŋ
kugita	k u ɡ i t a ʔ
tabi	t a b i
haltak	h a l t a k
polaynas	p o l a j n a s
dale	d a l e
kalamismis	k a l a m i s m i s
Maloles	m a l o l e s
isakay	ʔ i s a k a j
balo	b a l o
tsang	t͡ʃ a ŋ
Katoliko	k a t o l i k o
Pinagkaisahan	p i n a ɡ k a ʔ i s a h a n
Llanera	l j a n e ɾ a
dibdibin	d i b d i b i n
demokrasya	d e m o k ɾ a s j a
sugapa	s u ɡ a p a ʔ
kasero	k a s e ɾ o
kutsukutso	k u ˌt͡ʃ u k u t͡ʃ o
ubo	ʔ u b o
halimbawa	h a l i m b a w a ʔ
mamilis	m a m i l i s
Sin	s i n
Summer	s a m e ɾ
muhala	m u h a l a ʔ
mamaya	m a m a j a ʔ
gumuho	ɡ u m u h o ʔ
taludtod	t a l u d t o d
lalawigan	l a l a w i ɡ a n
onlayn	ʔ o n l a j n
kumbulsiyon	k u m b u l s i o n
taympers	t a j m p e ɾ s
Manilenya	m a n i l e n j a
maghati	m a ɡ h a t i ʔ
kapansanan	k a p a n s a n a n
opresyon	ʔ o p ɾ e s j o n
peram	p e ɾ a m
pamamahagi	p a m a m a h a ɡ i ʔ
suhol	s u h o l
kriket	k ɾ i k e t
ragsak	ɾ a ɡ s a k
alipin	ʔ a l i p i n
bilugan	b i l u ɡ a n
radyo	ɾ a d j o
cato	k a t o
misayl	m i s a j l
mabalasik	m a b a l a s i k
rebelyon	ɾ e b e l j o n
dagison	d a ɡ i s o n
iring	ʔ i ɾ i ŋ
talang	t a l a ŋ
NAPOLCOM	n a p o l k o m
manloloko	m a n l o l o k o
budhi	b u d h i ʔ
mangalandakan	m a ŋ a l a n d a k a n
katha	k a t h a ʔ
Tumacder	t u m a k d e ɾ
botelya	b o t e l j a
muyangit	m u j a ŋ i t
umusbong	ʔ u m u s b o ŋ
Mañalac	m a ɲ a l a k
alahero	ʔ a l a h e ɾ o
kaalit	k a ʔ a l i t
maabo	m a ʔ a b o
sisne	s i s n e
dengge	d e ŋ ɡ e
karelyebo	k a ɾ e l j e b o
kabukiran	k a b u k i ɾ a n
sabi	s a b i
tabatsingtsing	t a b a t͡ʃ i ŋ t͡ʃ i ŋ
tarang	t a ɾ a ŋ
sikolohiya	s i k o l o h i a
ortograpiya	ʔ o ɾ t o ɡ ɾ a p i a
haro	h a ɾ o
Soledad	s o l e d a d
marites	m a ɾ i t e s
heneral	h e n e ɾ a l
Kankanaey	k a n k a n a ʔ e j
baniaga	b a n j a ɡ a ʔ
Cueto	k u e t o
yakyak	j a k j a k
lahi	l a h i ʔ
imoralidad	ʔ i m o ɾ a l i d a d
daungan	ˌd a ʔ u ŋ a n
desente	d e s e n t e
magkaaway	m a ɡ k a ʔ a w a j
magkasakit	m a ɡ k a s a k i t
burol	b u ɾ o l
adres	ʔ a d ɾ e s
traidor	t ɾ a j d o ɾ
palpak	p a l p a k
melokoton	m e l o k o t o n
sentido	s e n t i d o
ayon	ʔ a j o n
pagalingin	p a ɡ a l i ŋ i n
lambanog	l a m b a n o ɡ
santelmo	s a n t e l m o
karangalan	k a ɾ a ŋ a l a n
Vigan	v i ɡ a n
iskul	ʔ i s k u l
tao	t a ʔ o
talibas	t a l i b a s
almirol	ʔ a l m i ɾ o l
balinsasayaw	b a ˌl i n s a s a j a w
Ann	ʔ a n
siwang	s i w a ŋ
Marulas	m a ɾ u l a s
linisan	l i n i s a n
sibika	ˌs i b i k a
Banaag	b a n a ʔ a ɡ
Bajado	b a h a d o
deliryo	d e l i ɾ j o
nagnanakaw	n a ɡ n a n a k a w
bubuweltahan	b u b u ˌe l t a h a n
inggit	ʔ i ŋ ɡ i t
pagkasuplado	p a ɡ k a s u p l a d o
pribilehiyo	p ɾ i b i l e h i o
pintor	p i n t o ɾ
rotonda	ɾ o t o n d a
'di	d i ʔ
tuna	t u n a ʔ
kita	k i t a
panahon	p a n a h o n
pampanitikan	p a m p a n i t i k a n
Nadine	n a d i n
limay	l i m a j
talunton	t a l u n t o n
hapit	h a p i t
balita	b a l i t a ʔ
Soliven	s o l i v e n
kampanaryo	k a m p a n a ɾ j o
seks	s e k s
bigtihin	b i ɡ t i h i n
nakainom	n a k a ʔ i n o m
uway	ʔ u a j
hapay	h a p a j
magkuwenta	m a ɡ k u e n t a
magbababoy	m a ɡ b a b a b o j
Munsayac	m u n s a j a k
bayad	b a j a d
Dionisio	d j o n i s j o
tonelada	t o n e l a d a
Elizaga	ʔ e l i z a ɡ a
madre	m a d ɾ e
disaluyan	d i s a l u j a n
gumimik	ɡ u m i m i k
Tayabense	t a j a b e n s e
tinig	t i n i ɡ
dekorasyon	d e k o ɾ a s j o n
burahin	b u ɾ a h i n
aksiyon	ʔ a k s i o n
tindalo	t i n d a l o ʔ
kaanib	k a ʔ a n i b
bigotilyo	b i ɡ o t i l j o
balandra	b a l a n d ɾ a
ekselensiya	ʔ e k s e l e n s j a
angkan	ʔ a ŋ k a n
ligamento	l i ɡ a m e n t o
telepatiya	t e l e p a t i a
tuma	t u m a
bertebrado	b e ɾ t e b ɾ a d o
Aranda	ʔ a ɾ a n d a
sumpa	s u m p a ʔ
bronse	b ɾ o n s e
desilitro	d e s i l i t ɾ o
pasukan	p a s u k a n
responsable	ɾ e s p o n s a b l e
piyesa	p i e s a
mapanira	m a p a n i ɾ a ʔ
Pagaspas	p a ɡ a s p a s
ugnay	ʔ u ɡ n a j
talupak	t a l u p a k
Agusan	ʔ a ɡ u s a n
magkautang	m a ɡ k a ʔ u t a ŋ
akwaryum	ʔ a k w a ɾ j u m
bumasa	b u m a s a
Tarnate	t a ɾ n a t e
DOLE	d o l e
komplikasyon	k o m p l i k a s j o n
manawagan	m a n a w a ɡ a n
mayuldumo	m a j u l d u m o
ahon	ʔ a h o n
kumapal	k u m a p a l
bagal	b a ɡ a l
elye	ʔ e l j e
lakre	l a k ɾ e
prinsa	p ɾ i n s a
kapas	k a p a s
rehistro	ɾ e h i s t ɾ o
tatagukan	t a t a ɡ u k a n
bungbong	b u ŋ b o ŋ
dagsa	d a ɡ s a ʔ
Montecillo	m o n t e s i l j o
personal	p e ɾ s o n a l
Ragudo	ɾ a ɡ u d o
banyas	b a n j a s
erehiya	ʔ e ɾ e h i a
umawit	ʔ u m a w i t
siyesta	s i e s t a
abla	ʔ a b l a
'ka	k a ʔ
utot	ʔ u t o t
mangailangan	m a ŋ a ʔ i l a ŋ a n
istorbo	ʔ i s t o ɾ b o
pisan	p i s a n
bumabahing	b u m a b a h i ŋ
aplikasyon	ʔ a p l i k a s j o n
rebulto	ɾ e b u l t o
agwamarina	ʔ a ɡ w a m a ɾ i n a
Sariaya	s a ɾ j a j a
lugo	l u ɡ o
Rajah	ɾ a h a
putok	p u t o k
bira	b i ɾ a
asa	ʔ a s a
kabituinan	k a b i t u ʔ i n a n
Buhain	b u h a ʔ i n
Garcia	ɡ a ɾ s i a
g̃	ŋ
Manaois	m a n a w i s
paniniwala	p a n i n i w a l a ʔ
sikologo	s i k o l o ɡ o
tarik	t a ɾ i k
tanggi	t a ŋ ɡ i
katre	k a t ɾ e
Ticzon	t i k s o n
kupal	k u p a l
huwataw	h u a t a w
betis	b e t i s
hagunot	h a ɡ u n o t
maputik	m a p u t i k
dolar	d o l a ɾ
bahid	b a h i d
dalubtala	d a ˌl u b t a l a ʔ
alugin	ʔ a l u ɡ i n
anislag	ʔ a n i s l a ɡ
tiyahin	t i a h i n
oso	ʔ o s o
Hinduismo	h i n d u i s m o
Yasmin	j a s m i n
bigo	b i ɡ o ʔ
obhetibismo	ʔ o b h e t i b i s m o
Pederio	p e d e ɾ j o
labandera	l a b a n d e ɾ a
tabas	t a b a s
Weste	w e s t e
kloropormo	k l o ɾ o p o ɾ m o
gamutin	ɡ a m u t i n
notaryo	n o t a ɾ j o
Villamayor	v i l j a m a j o ɾ
dalubituinan	d a ˌl u b i t u ʔ i n a n
kisay	k i s a j
panuwelo	p a n u e l o
urang	ʔ u ɾ a ŋ
inaabisuhan	ʔ i n a ʔ a b i s u h a n
suplay	s u p l a j
Lucero	l u s e ɾ o
pagnanakaw	p a ɡ n a n a k a w
triduo	t ɾ i d u ʔ o
mabulaklak	m a b u l a k l a k
balde	b a l d e
magmadali	m a ɡ m a d a l i ʔ
inspektor	ʔ i n s p e k t o ɾ
balikan	ˌb a l i k a n
sandaigdigan	s a n d a ʔ i ɡ d i ɡ a n
kubil	k u b i l
sangkatauhan	s a ŋ k a t a ʔ u h a n
Dimailig	d i m a ʔ i l i ɡ
Juana	h u a n a
bangkiling	b a ŋ k i l i ŋ
semantika	s e ˌm a n t i k a
kubtangkas	k u b t a ŋ k a s
karbungkulo	k a ɾ b u ŋ k u l o
empirisismo	ˌʔ e m p i ɾ i s i s m o
lukto	l u k t o ʔ
Estigoy	ʔ e s t i ɡ o j
puwente	p u e n t e
kantot	k a n t o t
yuko	j u k o ʔ
ani	ʔ a n i
iglesya	ʔ i ɡ l e s j a
guya	ɡ u j a ʔ
hinlog	h i n l o ɡ
luoy	l u ʔ o j
okra	ʔ o k ɾ a
palaman	p a l a m a n
ilot	ʔ i l o t
Pekto	p e k t o
kursonada	k u ɾ s o n a d a
tabatsing	t a b a t͡ʃ i ŋ
nanananghalian	n a n a n a ŋ h a l i ʔ a n
lamod	l a m o d
Borlaza	b o ɾ l a z a
yukod	j u k o d
tapos	t a p o s
lumbay	l u m b a j
magsuot	m a ɡ s u ʔ o t
sepelin	s e p e l i n
bakawan	b a k a w a n
pagakpak	p a ɡ a k p a k
kalaswaan	k a l a s w a ʔ a n
kerosin	ˌk e ɾ o s i n
Silayan	s i l a j a n
husto	h u s t o
dobolyu	d o b o l j u
empleado	ʔ e m p l e a d o
bakong	b a k o ŋ
pasigan	p a s i ɡ a n
maanak	m a ʔ a n a k
masilya	m a s i l j a
peste	p e s t e
ibigay	ʔ i b i ɡ a j
oeste	ʔ o e s t e
seradura	s e ɾ a d u ɾ a
Artiaga	ʔ a ɾ t i a ɡ a
lamat	l a m a t
Carunungan	k a ɾ u n u ŋ a n
pupu	p u p u ʔ
gagad	ɡ a ɡ a d
magwahil	m a ɡ w a h i l
ibenta	ʔ i b e n t a
dokumentaryo	d o k u m e n t a ɾ j o
waray	w a ɾ a j
pasilidad	p a s i l i d a d
mambuwisit	m a m b u i s i t
Katipunan	k a t i p u n a n
marungis	m a ɾ u ŋ i s
hapis	h a p i s
sinigwelas	s i n i ɡ w e l a s
salalay	s a l a l a j
kulit	k u l i t
ikalawa	ʔ i k a l a w a
Disyembre	d i s j e m b ɾ e
Tupas	t u p a s
Peñaflor	p e ɲ a f l o ɾ
kidsulid	k i d s u l i d
lantutay	l a n t u t a j
bahagan	b a h a ɡ a n
banyo	b a n j o
maarte	m a ʔ a ɾ t e
Epikureismo	ʔ e p i k u ɾ e i s m o
klabos	k l a b o s
lakbay	l a k b a j
leopardo	l e o p a ɾ d o
Yabut	j a b u t
Kiamzon	k i a m s o n
talas	t a l a s
puna	p u n a
Eloriaga	ʔ e l o ɾ j a ɡ a
pananampalataya	p a n a n a m p a l a t a j a
tumawag	t u m a w a ɡ
punongkahoy	ˌp u n o ŋ k a h o j
labis	l a b i s
gahi	ɡ a h i ʔ
kuro	k u ɾ o ʔ
ulnukalnangin	ʔ u l n u k a l n a ŋ i n
nagbabaon	n a ɡ b a b a ʔ o n
Laylo	l a j l o
relohero	ɾ e l o h e ɾ o
pinirmahan	p i n i ɾ m a h a n
Aragon	ʔ a ɾ a ɡ o n
sapul	s a p u l
uso	ʔ u s o
mas	m a s
ohetes	ʔ o h e t e s
lambing	l a m b i ŋ
Jaro	h a ɾ o
wisik	w i s i k
ladlad	l a d l a d
humatsing	h u m a t͡ʃ i ŋ
bertdey	b e ɾ t d e j
Songco	s o ŋ k o
agos	ʔ a ɡ o s
inam	ʔ i n a m
alog	ʔ a l o ɡ
tsok	t͡ʃ o k
Bolivar	b o l i v a ɾ
buang	b u ʔ a ŋ
taklab	t a k l a b
samain	s a m a ʔ i n
dilikas	d i l i k a s
alimuran	ʔ a l i m u ɾ a n
hiwalay	h i w a l a j
bisa	b i s a ʔ
tuyo	t u j o ʔ
wangis	w a ŋ i s
panday	p a n d a j
bra	b ɾ a
haka	h a k a ʔ
haspe	h a s p e
lampong	l a m p o ŋ
tayamutam	t a j a m u t a m
maimot	m a ʔ i m o t
ligis	l i ɡ i s
nagkukuwento	n a ɡ k u k u e n t o
maggiba	m a ɡ ɡ i b a ʔ
magluto	m a ɡ l u t o ʔ
Chedeng	t͡ʃ e d e ŋ
signo	s i ɡ n o
ekskomunikado	ʔ e k s k o m u n i k a d o
Kapampangan	k a p a m p a ŋ a n
estasyon	ʔ e s t a s j o n
Balmes	b a l m e s
mantala	m a n t a l a
okasyon	ʔ o k a s j o n
Cayabyab	k a j a b j a b
Kristiyano	k ɾ i s t i a n o
sisante	s i s a n t e
Hau	h a w
pulseras	p u l s e ɾ a s
agnas	ʔ a ɡ n a s
bisaklat	b i s a k l a t
tilao	t i l a ʔ o
pintuan	p i n t u ʔ a n
mami	m a m i
abat	ʔ a b a t
nagaganap	n a ɡ a ɡ a n a p
gansal	ɡ a n s a l
plantsa	p l a n t͡ʃ a
kutsada	k u t͡ʃ a d a
daluhaka	d a l u h a k a ʔ
Ty	t i
tumulong	t u m u l o ŋ
Haponesa	h a p o n e s a
kamelyo	k a m e l j o
masiba	m a s i b a ʔ
lubang	l u b a ŋ
Jara	h a ɾ a
nakayukyok	n a k a j u k j o k
paliguan	p a l i ɡ u ʔ a n
abiso	ʔ a b i s o
kuwento	k u e n t o
samakatwid	s a m a k a t w i d
analitika	ʔ a n a ˌl i t i k a
apoy	ʔ a p o j
Jalandoni	h a l a n d o n i
asnan	ʔ a s n a n
magyaya	m a ɡ j a j a ʔ
sabak	s a b a k
sodiyako	s o d i a k o
Haw	h a w
mulkaphay	m u l k a p h a j
agoy	ʔ a ɡ o j
busilak	b u s i l a k
krimen	k ɾ i m e n
sunuran	ˌs u n u ɾ a n
lapastanganin	l a p a s t a ŋ a n i n
talukab	t a l u k a b
ᜊ	b a b a ʔ
tikling	t i k l i ŋ
bulalayak	ˌb u l a l a j a k
pambihira	p a m b i h i ɾ a ʔ
yumurak	j u m u ɾ a k
teleserye	t e l e s e ɾ j e
suweter	s u e t e ɾ
bati	b a t i ʔ
aberya	ʔ a b e ɾ j a
panggang	p a ŋ ɡ a ŋ
gilid	ɡ i l i d
wis	w i s
Basallote	b a s a l j o t e
burara	b u ɾ a ɾ a ʔ
agulo	ʔ a ɡ u l o
Sobrepeña	s o b ɾ e p e ɲ a
pusaw	p u s a w
arok	ʔ a ɾ o k
bakuran	b a k u ɾ a n
tokador	t o k a d o ɾ
dayan	d a j a n
talukbong	t a l u k b o ŋ
sila	s i l a
kubrekama	k u b ɾ e k a m a
sentimo	ˌs e n t i m o
buwagin	b u a ɡ i n
Magdangal	m a ɡ d a ŋ a l
sotanghon	s o t a ŋ h o n
ulol	ʔ u l o l
gaong	ɡ a ʔ o ŋ
patag	p a t a ɡ
samaral	s a m a ɾ a l
saksakin	s a k s a k i n
X	ʔ e k s
hilaga	h i l a ɡ a ʔ
ibangsilyo	ʔ i b a ŋ s i l j o
ngakngak	ŋ a k ŋ a k
idroheno	ʔ i d ɾ o h e n o
linatsay	l i n a t͡ʃ a j
tate	t a t e ʔ
tsarera	t͡ʃ a ɾ e ɾ a
terminal	ˌt e ɾ m i n a l
pagkabigo	p a ɡ k a b i ɡ o ʔ
historikal	h i s t o ɾ i k a l
Franco	f ɾ a ŋ k o
anakroniko	ʔ a n a k ˌɾ o n i k o
Pagdanganan	p a ɡ d a ŋ a n a n
barko	b a ɾ k o
kendo	k e n d o
Kurisma	k u ɾ i s m a
mawala	m a w a l a ʔ
sinaing	s i n a ʔ i ŋ
madamot	m a d a m o t
panadero	p a n a d e ɾ o
ospitalidad	ʔ o s p i t a l i d a d
makita	m a k i t a ʔ
agwahas	ʔ a ɡ w a h a s
entusyasmo	ʔ e n t u s j a s m o
kabaretista	k a b a ɾ e t i s t a
obligasyon	ʔ o b l i ɡ a s j o n
nanamantala	n a n a m a n t a l a
taliba	t a l i b a ʔ
likot	l i k o t
varyant	v a ɾ j a n t
hangad	h a ŋ a d
Montenegro	m o n t e n e ɡ ɾ o
mangaliwa	m a ŋ a l i w a ʔ
Inglesero	ʔ i ŋ ɡ l e s e ɾ o
protina	p ɾ o t i n a
lagislis	l a ɡ i s l i s
giba	ɡ i b a ʔ
miswa	m i s w a
bihilante	b i h i l a n t e
persigido	p e ɾ s i ɡ i d o
tambanggalan	t a m b a ŋ ɡ a l a n
maanggo	m a ʔ a ŋ ɡ o
tapak	t a p a k
puyat	p u j a t
espantaho	ʔ e s p a n t a h o
Nagtalon	n a ɡ t a l o n
bagalan	b a ɡ a l a n
tagulamin	t a ɡ u l a m i n
pekas	p e k a s
dapithapon	ˌd a p i t h a p o n
timpi	t i m p i ʔ
satelayt	s a t e l a j t
nagpapaubaya	n a ɡ p a p a ʔ u b a j a ʔ
takip	t a k i p
Clarence	k l a ɾ e n s
bukana	b u k a n a
tugya	t u ɡ j a ʔ
ebakwasyon	ʔ e b a k w a s j o n
ketongin	k e t o ŋ i n
Geraldine	ˌd j e ɾ a l d i n
senado	s e n a d o
tipaklong	t i p a k l o ŋ
limahi	l i m a h i ʔ
inaanak	ʔ i ˌn a ʔ a n a k
paboritismo	p a b o ɾ i t i s m o
termos	t e ɾ m o s
sawing	s a w i ŋ
tagmangga	t a ɡ m a ŋ ɡ a
tagisuyo	t a ɡ i s u j o ʔ
tekwan	t e k w a n
madagta	m a d a ɡ t a ʔ
Nagcarlan	n a ɡ k a ɾ l a n
pulupito	p u l u p i t o
balatik	b a l a t i k
espongha	ʔ e s p o ŋ h a
kapagka	k a p a ɡ k a ʔ
abangan	ˌʔ a b a ŋ a n
dagundong	d a ɡ u n d o ŋ
kalyos	k a l j o s
sundot	s u n d o t
irebisa	ʔ i ɾ e b i s a
upahan	ʔ u p a h a n
ambubuyog	ʔ a m b u b u j o ɡ
binibini	b i n i b i n i
kuwa	k u a ʔ
kooperasyon	k o ʔ o p e ɾ a s j o n
yaon	j a ʔ o n
alangan	ʔ a l a ŋ a n
letmaku	l e t m a k u
mangobra	m a ŋ o b ɾ a
kulugo	k u l u ɡ o
Fariñas	f a ɾ i ɲ a s
tinapa	t i n a p a
singkamas	s i ŋ k a m a s
heko	h e k o
Majayjay	m a h a j h a j
arsilya	ʔ a ɾ s i l j a
Isko	ʔ i s k o ʔ
barker	b a ɾ k e ɾ
dagitban	d a ɡ i t b a n
peluka	p e l u k a
tsikot	t͡ʃ i k o t
Moralde	m o ɾ a l d e
rito	ɾ i t o
Malibiran	m a l i b i ɾ a n
par	p a ɾ
Bascoguin	b a s k o ɡ i n
Naomi	n a j o w m i
sakramento	s a k ɾ a m e n t o
Naujan	n a ʔ u h a n
tumoma	t u m o m a ʔ
bulilyaso	b u l i l j a s o
datiles	ˌd a t i l e s
umulit	ʔ u m u l i t
isangkot	ʔ i s a ŋ k o t
pastilyas	p a s t i l j a s
gumising	ɡ u m i s i ŋ
kabuwanan	k a b u a n a n
sakal	s a k a l
pulburon	p u l b u ɾ o n
langal	l a ŋ a l
kadugo	k a d u ɡ o ʔ
pananawagan	p a n a n a w a ɡ a n
diyosesis	d i o s e s i s
Nelson	n e l s o n
Chiyoko	t͡ʃ i o k o
lagayan	ˌl a ɡ a j a n
Banayad	b a n a j a d
hupa	h u p a ʔ
Anor	ʔ a n o ɾ
brodkast	b ɾ o d k a s t
tigmata	t i ɡ m a t a
Banal	b a n a l
Ala	ʔ a l a
hanip	h a n i p
malabnaw	m a l a b n a w
retratista	ɾ e t ɾ a t i s t a
ipakita	ʔ i p a k i t a
dating	d a t i ŋ
ulunan	ʔ u l u n a n
kahelada	k a h e l a d a
Setsuko	s e t s u k o
kasulatan	k a s u l a t a n
Vecino	v e s i n o
libid	l i b i d
manlibak	m a n l i b a k
kosta	k o s t a
mutya	m u t j a ʔ
timbanin	t i m b a n i n
labintador	l a b i n t a d o ɾ
paraiso	p a ɾ a ʔ i s o
datung	d a t u ŋ
kasera	k a s e ɾ a
gawangan	ɡ a w a ŋ a n
arsobispo	ʔ a ɾ s o b i s p o
hayop	h a j o p
sebekoy	ˌs e b e k o j
Camarines	k a m a ɾ i n e s
sintomas	s i n t o m a s
mamanhikan	m a m a n h i k a n
lalagyan	l a l a ɡ j a n
babaye	b a b a j e
magpaskil	m a ɡ p a s k i l
alalahanin	ʔ a l a l a h a n i n
Bermudez	b e ɾ m u d e s
olats	ʔ o l a t s
sota	s o t a
tokaya	t o k a j a
Olaguer	ʔ o l a ɡ e ɾ
hagulhol	h a ɡ u l h o l
echosera	ʔ e t͡ʃ o s e ɾ a
subla	s u b l a
Asyano	ʔ a s j a n o
propesora	p ɾ o p e s o ɾ a
maghinala	m a ɡ h i n a l a ʔ
pangadyi	p a ŋ a d j i ʔ
umiintindi	ʔ u m i ʔ i n t i n d i
pagkabata	p a ɡ k a b a t a ʔ
Carreon	k a ɾ e o n
payamanin	p a j a m a n i n
irekomenda	ʔ i ɾ e k o m e n d a
inyo	ʔ i n j o
tagapagmana	t a ɡ a ˌp a ɡ m a n a
lisa	l i s a ʔ
mayaw	m a j a w
kotamaya	k o t a m a j a
koral	k o ɾ a l
palangiti	p a l a ŋ i t i ʔ
oraryo	ʔ o ɾ a ɾ j o
ostiya	ʔ o s t j a
manigo	m a n i ɡ o ʔ
kartesyano	ˌk a ɾ t e s j a n o
akit	ʔ a k i t
akala	ʔ a k a l a ʔ
biyolohiya	b i o l o h i a
akurdiyon	ʔ a k u ɾ d i o n
Domantay	d o m a n t a j
madrama	m a d ɾ a m a
Litwanya	l i t w a n j a
sangandaan	s a ˌŋ a n d a ʔ a n
Romana	ɾ o m a n a
singki	s i ŋ k i ʔ
timos	t i m o s
kamya	k a m j a
Arnaiz	ʔ a ɾ n a ʔ i s
matibay	m a t i b a j
pulubi	p u l u b i
amot	ʔ a m o t
ugaga	ʔ u ɡ a ɡ a ʔ
akbay	ʔ a k b a j
panananim	p a n a n a n i m
makipot	m a k i p o t
ikabilanggo	ʔ i k a b i l a ŋ ɡ o ʔ
pakpak	p a k p a k
Libra	l i b ɾ a
ungkat	ʔ u ŋ k a t
baisi	b a ʔ i s i ʔ
kasalukuyan	k a s a l u k u j a n
matindi	m a t i n d i
nobyo	n o b j o
santa	s a n t a
adelpa	ʔ a d e l p a
manood	m a n o ʔ o d
Saog	s a ʔ o ɡ
tekas	t e k a s
tangke	t a ŋ k e
lagim	l a ɡ i m
alaman	ʔ a l a m a n
masaker	m a s a k e ɾ
kritiko	k ɾ i t i k o
mabagyo	m a b a ɡ j o
imperatibo	ʔ i m p e ɾ a t i b o
kristo	k ɾ i s t o
kontralason	k o n t ɾ a l a s o n
mestiso	m e s t i s o
Irlandesa	ʔ i ɾ l a n d e s a
Jaruda	h a ɾ u d a
Hayag	h a j a ɡ
asawa	ʔ a s a w a
'y	j
balbon	b a l b o n
bigting	b i ɡ t i ŋ
mainsekto	m a ʔ i n s e k t o
dalawit	d a l a w i t
alabwab	ʔ a l a b w a b
iha	ʔ i h a
Ylagan	ʔ i l a ɡ a n
maawain	m a ʔ a w a ʔ i n
bigti	b i ɡ t i
Gatchalian	ɡ a t͡ʃ a l j a n
kaliitan	k a l i ʔ i t a n
alyado	ʔ a l j a d o
tikoy	t i k o j
uyom	ʔ u j o m
kepo	k e p o
putspa	p u t s p a
sapiro	s a p i ɾ o
Binubusan	b i n u b u s a n
magulat	m a ɡ u l a t
senador	s e n a d o ɾ
yatyat	j a t j a t
testamento	t e s t a m e n t o
emosyon	ʔ e m o s j o n
bulakbol	b u l a k b o l
silidkatwan	s i ˌl i d k a t w a n
Michiko	m i t͡ʃ i k o
likaw	l i k a w
Alabat	ʔ a l a b a t
q	k j u
nais	n a ʔ i s
Aquino	ʔ a k i n o
albahaka	ʔ a l b a h a k a
Quimson	k i m s o n
Maranaw	m a ɾ a n a w
Luzviminda	l u z v i m i n d a
bagnet	b a ɡ n e t
tipuno	t i p u n o ʔ
hibang	h i b a ŋ
peseta	p e s e t a
Dijamco	d i h a m k o
soltada	s o l t a d a
detalye	d e t a l j e
lipa	l i p a
awtor	ʔ a w t o ɾ
saro	s a ɾ o
bingwit	b i ŋ w i t
lityo	l i t j o
senyal	s e n j a l
imbudo	ʔ i m b u d o
samaya	s a m a j a ʔ
kibit	k i b i t
siyete	s i e t e
elektrisista	ʔ e l e k t ɾ i s i s t a
batchoy	b a t͡ʃ o j
pikaporte	p i k a p o ɾ t e
balda	b a l d a
gapong	ɡ a p o ŋ
utdo	ʔ u t d o
palaso	p a l a s o ʔ
lansang	l a n s a ŋ
bugaw	b u ɡ a w
tatap	t a t a p
drama	d ɾ a m a
budots	b u d o t s
balse	b a l s e
magkausap	m a ɡ k a ʔ u s a p
lakip	l a k i p
Orendain	ʔ o ɾ e n d a ʔ i n
ebak	ʔ e b a k
Sarcia	s a ɾ s j a
salik	s a l i k
Triviño	t ɾ i v i ɲ o
kalima	k a l i m a
binhi	b i n h i ʔ
masuwerte	m a s u e ɾ t e
Caluya	k a l u j a
petisyon	p e t i s j o n
sadsad	s a d s a d
tilasitha	t i l a s i t h a ʔ
papagtawanan	ˌp a p a ɡ t a w a n a n
Contreras	k o n t ɾ e ɾ a s
magulo	m a ɡ u l o
gawan	ɡ a w a n
Baquiran	b a k i ɾ a n
matiyaga	m a t j a ɡ a ʔ
biskonde	b i s k o n d e
Abulencia	ʔ a b u l e n s j a
turista	t u ɾ i s t a
suwerte	s u e ɾ t e
ikalat	ʔ i k a l a t
talulot	t a l u l o t
tabak	t a b a k
kasal	k a s a l
es	ʔ e s
usod	ʔ u s o d
sanaysay	s a n a j s a j
lamog	l a m o ɡ
bangkito	b a ŋ k i t o ʔ
lubak	l u b a k
numipis	n u m i p i s
salmo	s a l m o
keri	k e ɾ i
mahahapdi	m a h a h a p d i ʔ
yumahod	j u m a h o d
peyneta	p e j n e t a
bumatak	b u m a t a k
matimbang	m a t i m b a ŋ
ambisyon	ʔ a m b i s j o n
inugsukat	ʔ i n u ɡ s u k a t
organisado	ʔ o ɾ ɡ a n i s a d o
Sandoval	s a n d o v a l
arnibal	ʔ a ɾ n i b a l
biyaya	b i a j a ʔ
seleksiyon	s e l e k s i o n
ngatal	ŋ a t a l
yumi	j u m i ʔ
purgatoryo	p u ɾ ɡ a t o ɾ j o
hikayat	h i k a j a t
ardilya	ʔ a ɾ d i l j a
bolera	b o l e ɾ a
Marinduque	m a ɾ i n d u k e
amaranto	ʔ a m a ɾ a n t o
paligsa	p a l i ɡ s a
pangkat	p a ŋ k a t
LL	ʔ e l j e
Turkmenistan	t u ɾ k m e n i s t a n
initsupil	ˌʔ i n i t s u p i l
mapurol	m a p u ɾ o l
balikatin	b a l i k a t i n
ibahin	ʔ i b a h i n
diblinig	d i b l i n i ɡ
hatiin	h a t i ʔ i n
bayag	b a j a ɡ
magiting	m a ɡ i t i ŋ
hati	h a t i ʔ
tinggil	t i ŋ ɡ i l
ligo	l i ɡ o ʔ
burges	b u ɾ ɡ e s
Remulla	ɾ e m u l j a
Islam	ʔ i s l a m
babag	b a b a ɡ
Ricardo	ɾ i k a ɾ d o
lumabo	l u m a b o ʔ
Ablog	ʔ a b l o ɡ
sibsib	s i b s i b
kampyon	k a m p j o n
saysay	s a j s a j
Sagitaryo	s a ɡ i t a ɾ j o
madamo	m a d a m o
mapansin	m a p a n s i n
obaryo	ʔ o b a ɾ j o
tamales	t a m a l e s
mangangaso	m a ŋ a ŋ a s o
inunan	ʔ i n u n a n
alahado	ʔ a l a h a d o
Shohei	s j o h e j
tsitsaron	t͡ʃ i t͡ʃ a ɾ o n
umawat	ʔ u m a w a t
alkatsopas	ʔ a l k a t͡ʃ o p a s
malutong	m a l u t o ŋ
Kurita	k u ɾ i t a
Italyano	ʔ i t a l j a n o
Michelena	m i t͡ʃ e l e n a
salsa	s a l s a
maningil	m a n i ŋ i l
kumbinsido	k u m b i n s i d o
pangkagawaran	p a ŋ k a ɡ a w a ɾ a n
gahasa	ɡ a h a s a ʔ
parol	p a ɾ o l
Hapones	h a p o n e s
Froilan	f ɾ o j l a n
balatong	b a l a t o ŋ
barkada	b a ɾ k a d a
nabubuwisit	n a b u b u i s i t
kapatawaran	k a p a t a w a ɾ a n
asinan	ʔ a s i n a n
taluiryap	t a l u ʔ i ɾ j a p
Indarapatra	ʔ i n d a ɾ a p a t ɾ a
Macalalad	m a k a l a l a d
tokneneng	t o k n e n e ŋ
mikroorganismo	m i k ɾ o ʔ o ɾ ɡ a n i s m o
mabibigat	m a b i b i ɡ a t
rupok	ɾ u p o k
antok	ʔ a n t o k
yangyang	j a ŋ j a ŋ
saniban	s a n i b a n
kalangay	k a l a ŋ a j
Masilungan	m a s i l u ŋ a n
Abelgas	ʔ a b e l ɡ a s
Capili	k a p i l i
kundena	k u n d e n a
ipagmayabang	ʔ i p a ɡ m a j a b a ŋ
Pinas	p i n a s
Oliveros	ʔ o l i v e ɾ o s
ganansiya	ɡ a n a n s j a
bara	b a ɾ a
limusina	l i m u s i n a
alanganin	ʔ a l a ŋ a n i n
pangangailangan	p a ŋ a ŋ a ʔ i l a ŋ a n
peg	p e ɡ
sais	s a ʔ i s
riyesgo	ɾ i e s ɡ o
Libya	l i b j a
laro	l a ɾ o ʔ
sagwan	s a ɡ w a n
Barayuga	b a ɾ a j u ɡ a
Kho	k o
tambakol	t a m b a k o l
balahak	b a l a h a k
umbok	ʔ u m b o k
polo	p o l o
bilasa	b i l a s a ʔ
hagak	h a ɡ a k
polyeto	p o l j e t o
gilib	ɡ i l i b
kaniyugan	k a n i u ɡ a n
hardin	h a ɾ d i n
batia	b a t i a ʔ
magkatay	m a ɡ k a t a j
mandadangkal	m a n d a d a ŋ k a l
antala	ʔ a n t a l a
hila	h i l a
kabaiyuan	k a b a ʔ i u ʔ a n
barberya	b a ɾ b e ɾ j a
julalay	d͡ʒ u l a l a j
maghalili	m a ɡ h a l i l i
gobernador	ɡ o b e ɾ n a d o ɾ
alapaap	ʔ a l a p a ʔ a p
Flora	f l o ɾ a
lupig	l u p i ɡ
masiyasip	m a s i a s i p
kakawati	k a k a w a t i
fotobam	f o t o b a m
birtud	b i ɾ t u d
mabalang	m a b a l a ŋ
Ivy	ʔ a j v i
tulad	t u l a d
reengkarnasyon	ɾ e ʔ e ŋ k a ɾ n a s j o n
pananamantala	p a n a n a m a n t a l a
manahimik	m a n a h i m i k
tagaangkat	t a ɡ a ʔ a ŋ k a t
sinigurado	s i n i ɡ u ɾ a d o
bahagi	b a h a ɡ i ʔ
Catindig	k a t i n d i ɡ
Tauro	t a w ɾ o
Abellano	ʔ a b e l j a n o
lutad	l u t a d
yano	j a n o
medyas	m e d j a s
Lantican	l a n t i k a n
Cenizal	s e n i z a l
tambuli	t a m b u l i ʔ
pirata	p i ɾ a t a
udon	ʔ u d o n
lingkod	l i ŋ k o d
enerhiya	ʔ e n e ɾ h i a
C	s i
tahure	t a h u ɾ e
yama	j a m a
tiyope	t i o p e ʔ
seko	s e k o
liing	l i ʔ i ŋ
gulot	ɡ u l o t
kondo	k o n d o
korni	k o ɾ n i
Lupao	l u p a w
Fung	f u ŋ
mayaman	m a j a m a n
namnam	n a m n a m
liwat	l i w a t
ma	m a
Valmores	v a l m o ɾ e s
dalubwikaan	d a ˌl u b w i k a ʔ a n
ginto	ɡ i n t o ʔ
Cadapan	k a d a p a n
haligutgot	h a l i ɡ u t ɡ o t
estandarte	ʔ e s t a n d a ɾ t e
magparami	m a ɡ p a ɾ a m i
dagasdas	d a ɡ a s d a s
sebo	s e b o
Jasmine	d͡ʒ a s m i n
kadiri	k a d i ɾ i
iwas	ʔ i w a s
basurero	b a s u ɾ e ɾ o
miklawas	m i k l a w a s
bisikleta	b i s i k l e t a
dehado	d e h a d o
Datu	d a t u
inggitero	ʔ i ŋ ɡ i t e ɾ o
Danesa	d a n e s a
uhod	ʔ u h o d
kategorikal	k a t e ɡ o ɾ i k a l
asendero	ʔ a s e n d e ɾ o
singkad	s i ŋ k a d
diskuwento	d i s k u e n t o
elepante	ʔ e l e p a n t e
bolta	b o l t a
tunggak	t u ŋ ɡ a k
diyaryo	d i a ɾ j o
abyog	ʔ a b j o ɡ
sutla	s u t l a ʔ
suki	s u k i ʔ
Sumadsad	s u m a d s a d
maako	m a ʔ a k o
atim	ʔ a t i m
labaw	l a b a w
dukwangin	d u k w a ŋ i n
tolerable	t o l e ɾ a b l e
panlikod	p a n l i k o d
Makaw	m a k a w
kasilyas	k a s i l j a s
asam	ʔ a s a m
halihaw	h a l i h a w
Salandanan	s a l a n d a n a n
Moymoy	m o j m o j
kumporme	k u m p o ɾ m e
humagulhol	h u m a ɡ u l h o l
dalubhayupan	d a ˌl u b h a j u p a n
wiski	w i s k i
ugali	ʔ u ɡ a l i ʔ
oposisyon	ʔ o p o s i s j o n
Jurado	h u ɾ a d o
panuntunan	p a n u n t u n a n
tumangkad	t u m a ŋ k a d
hinguto	h i ŋ u t o
tilos	t i l o s
sapupuhin	s a p u p u h i n
pinabubulaanan	p i n a b u b u l a ʔ a n a n
nitrogliserina	n i t ɾ o ɡ l i s e ɾ i n a
radikal	ɾ a d i k a l
berdugo	b e ɾ d u ɡ o
Kalantiaw	k a l a n t j a w
mahistrado	m a h i s t ɾ a d o
sipol	s i p o l
Biyer.	b i e ɾ
malapot	m a l a p o t
asno	ʔ a s n o
repleksiyon	ɾ e p l e k s i o n
dagusdos	d a ɡ u s d o s
salwak	s a l w a k
kabisera	k a b i s e ɾ a
paninindigan	p a n i n i n d i ɡ a n
higa	h i ɡ a ʔ
kelan	k e l a n
sinehan	s i n e h a n
deskripsiyon	d e s k ɾ i p s i o n
korupsiyon	k o ɾ u p s i o n
mamumuhunan	m a m u m u h u n a n
buryong	b u ɾ j o ŋ
hapag	h a p a ɡ
pudpod	p u d p o d
unawa	ʔ u n a w a ʔ
kawawa	k a w a w a ʔ
kumpisal	k u m p i s a l
diso	d i s o
Lumad	l u m a d
yumamot	j u m a m o t
kuha	k u h a
hasain	h a s a ʔ i n
kadyos	k a d j o s
Manalaysay	m a n a l a j s a j
sapalaran	s a p a l a ɾ a n
labawliknayan	l a b a w l i k n a j a n
bagol	b a ɡ o l
kwenta	k w e n t a
sipot	s i p o t
dote	d o t e
hambaw	h a m b a w
be	b e
sus	s u s
magbili	m a ɡ b i l i
wawa	w a w a ʔ
renta	ɾ e n t a
pumanig	p u m a n i ɡ
senakulo	s e n a k u l o
boto	b o t o
panaguri	p a n a ɡ u ɾ i ʔ
hagkan	h a ɡ k a n
maimbot	m a ʔ i m b o t
Kaye	k e j
mangopya	m a ŋ o p j a
sampid	s a m p i d
isapribado	ʔ i s a p ɾ i b a d o
sekreto	s e k ɾ e t o
Kardo	k a ɾ d o
golp	ɡ o l p
tigis	t i ɡ i s
manukan	m a n u k a n
depresasyon	d e p ɾ e s a s j o n
aninag	ʔ a n i n a ɡ
landa	l a n d a
magtapat	m a ɡ t a p a t
Kamaynilaan	k a m a j n i l a ʔ a n
magugulo	m a ɡ u ɡ u l o
Natanauan	n a t a n a w a n
kubo	k u b o
taimtim	t a ʔ i m t i m
palya	p a l j a
Sabado	s a b a d o
konyak	k o n j a k
hindi	h i n d i ʔ
hinang	h i n a ŋ
ditablo	d i t a b l o
reportahe	ɾ e p o ɾ t a h e
tulos	t u l o s
Soon	s u n
Princess	p ɾ i n s e s
Po	p o
medyebal	m e d j e b a l
dalubguro	d a ˌl u b ɡ u ɾ o ʔ
aborsiyon	ʔ a ˌb o ɾ s j o n
Netoy	n e t o j
manguna	m a ŋ u n a
humba	h u m b a ʔ
pusakal	p u s a k a l
basar	b a s a ɾ
ukab	ʔ u k a b
pano	p a n o
lugar	l u ɡ a ɾ
disiotso	d i s i ʔ o t͡ʃ o
Inocencio	ʔ i n o s e n s j o
bentaha	b e n t a h a
bitak	b i t a k
kauntian	k a ʔ u n t i ʔ a n
panuruan	p a n u ɾ u ʔ a n
rotasyon	ɾ o t a s j o n
sisihan	s i s i h a n
yeso	j e s o
ibabaw	ʔ i b a b a w
malindol	m a l i n d o l
lawaan	l a w a ʔ a n
madiwa	m a d i w a ʔ
sigsa	s i ɡ s a
higante	h i ɡ a n t e
mayayabang	m a j a j a b a ŋ
Manatad	m a n a t a d
Aleman	ʔ a l e m a n
Hamayka	h a m a j k a
Caguiat	k a ɡ j a t
rambol	ɾ a m b o l
galagala	ɡ a l a ɡ a l a
katukayo	k a t u k a j o
aswang	ʔ a s w a ŋ
maggantsilyo	m a ɡ ɡ a n t͡ʃ i l j o
resitasyon	ɾ e s i t a s j o n
ipatong	ʔ i p a t o ŋ
Cajucom	k a h u k o m
boba	b o b a
hampol	h a m p o l
Villablanca	v i l j a b l a n k a
ko	k o
haya	h a j a ʔ
takuri	t a k u ɾ i ʔ
awtorisasyon	ʔ a w t o ɾ i s a s j o n
tiwasay	t i w a s a j
nanghawa	n a ŋ h a w a
birsin	b i ɾ s i n
gahaman	ɡ a h a m a n
sagupa	s a ɡ u p a ʔ
bulyaw	b u l j a w
Cortez	k o ɾ t e s
dinsol	d i n s o l
lilok	l i l o k
hingalo	h i ŋ a l o ʔ
kyu	k j u
radikalismo	ɾ a d i k a l i s m o
labandero	l a b a n d e ɾ o
Caparas	k a p a ɾ a s
Maribel	m a ɾ i b e l
usngal	ʔ u s ŋ a l
ra	ɾ a
lambot	l a m b o t
kodigo	k o d i ɡ o
daloy	d a l o j
Aplasca	ʔ a p l a s k a
magpaalam	m a ɡ p a ʔ a l a m
ayungin	ʔ a j u ŋ i n
hamak	h a m a k
banlaw	b a n l a w
tahong	t a h o ŋ
barkilyos	b a ɾ k i l j o s
tributaryo	t ɾ i b u t a ɾ j o
Malicdem	m a l i k d e m
piyudalismo	p i u d a l i s m o
malasado	m a l a s a d o
kaldero	k a l d e ɾ o
Tseko	t͡ʃ e k o
manghawa	m a ŋ h a w a
siyokoy	s i o k o j
beses	b e s e s
magdemanda	m a ɡ d e m a n d a
korea	k o ɾ e a
magtipid	m a ɡ t i p i d
diyan	d i a n
Pilipinismo	p i l i p i n i s m o
daos	d a ʔ o s
jabol	d͡ʒ a b o l
lawlaw	l a w l a w
inampalan	ʔ i n a m p a l a n
dagdag	d a ɡ d a ɡ
kimona	k i m o n a
halibhib	h a l i b h i b
salagimsim	s a l a ɡ i m s i m
garbo	ɡ a ɾ b o
maleta	m a l e t a
mawsoleo	m a w s o l e o
talentado	t a l e n t a d o
alangilan	ʔ a l a ŋ i l a n
Karunungan	k a ɾ u n u ŋ a n
luwad	l u a d
dagta	d a ɡ t a ʔ
Ortea	ʔ o ɾ t e a
paksa	p a k s a ʔ
Roxas	ɾ o h a s
simetriya	s i m e t ɾ i a
paggatas	p a ɡ ɡ a t a s
rehas	ɾ e h a s
restitusyon	ɾ e s t i t u s j o n
labaha	l a b a h a
balbakwa	b a l b a k w a
tagarito	t a ɡ a ɾ i t o
hibi	h i b i
sasapnan	s a s a p n a n
determinismo	d e t e ɾ m i n i s m o
almuwerso	ʔ a l m u e ɾ s o
Batangueña	b a t a ŋ ɡ e n j a
kabulagsakan	k a b u l a ɡ s a k a n
lintik	l i n t i k
Encarnacion	ʔ e n k a ɾ n a s j o n
panahinga	p a n a h i ŋ a
magsimba	m a ɡ s i m b a
turong	t u ɾ o ŋ
Kaputsino	k a p u t͡ʃ i n o
aguho	ʔ a ɡ u h o ʔ
atrebida	ʔ a t ɾ e b i d a
papagtalunan	ˌp a p a ɡ t a l u n a n
pisikalan	ˌp i s i k a l a n
kaligkig	k a l i ɡ k i ɡ
chaka	t͡ʃ a k a ʔ
tibag	t i b a ɡ
kakosa	k a k o s a
gumaling	ɡ u m a l i ŋ
lang	l a ŋ
abuab	ʔ a b u ʔ a b
kandaro	k a n d a ɾ o
dantaon	d a n t a ʔ o n
etika	ʔ e t i k a
parinig	p a ɾ i n i ɡ
Solano	s o l a n o
akompanya	ʔ a k o m p a n j a
samat	s a m a t
lanting	l a n t i ŋ
empleyado	ʔ e m p l e a d o
tauhan	t a ʔ u h a n
koponan	k o p o n a n
Leyte	l e j t e
destabilisasyon	d e s t a b i l i s a s j o n
reperensiya	ɾ e p e ɾ e n s j a
pakialam	p a k i ʔ a l a m
Pedregal	p e d ɾ e ɡ a l
kuwenta	k u e n t a
Alolod	ʔ a l o l o d
Aldover	ʔ a l d o v e ɾ
SK	ʔ e s k e j
anis	ʔ a n i s
iwang	ʔ i w a ŋ
anino	ʔ a n i n o
sibuyas	s i b u j a s
Magallanes	m a ɡ a l j a n e s
alandahaw	ʔ a l a n d a h a w
warlahin	w a ɾ l a h i n
akrostik	ʔ a k ɾ o s t i k
takatak	t a k a t a k
kahit	k a h i t
sasakyan	s a s a k j a n
kilos	k i l o s
Suan	s w a n
hininga	h i n i ŋ a
pasasalamat	p a s a s a l a m a t
sangkatutak	s a ŋ k a t u t a k
Opeña	ʔ o p e ɲ a
Nobuhisa	n o b u h i s a
tagatuos	t a ɡ a t u ʔ o s
dedikasyon	d e d i k a s j o n
detalyado	d e t a l j a d o
banggerahan	b a ŋ ɡ e ɾ a h a n
lapulapu	ˌl a p u l a p u
iho	ʔ i h o
oryente	ʔ o ɾ j e n t e
Sergio	s e ɾ h i o
Javier	h a v i e ɾ
gariya	ɡ a ɾ i a ʔ
baklad	b a k l a d
sipon	s i p o n
lohiko	l o h i k o
suklay	s u k l a j
lasinggera	l a s i ŋ ɡ e ɾ a
kontestant	k o n t e s t a n t
pilik	p i l i k
Mabato	m a b a t o
balnikapnayan	b a l n i k a p n a j a n
sipat	s i p a t
Corazon	k o ɾ a z o n
agnostiko	ʔ a ɡ n o s t i k o
instituto	ʔ i n s t i t u t o
talangka	t a l a ŋ k a ʔ
Imperial	ʔ i m p e ɾ j a l
Malilay	m a l i l a j
koteho	k o t e h o
suplada	s u p l a d a
metodo	m e t o d o
balino	b a l i n o
walwal	w a l w a l
usisain	ʔ u s i s a ʔ i n
erpats	ʔ e ɾ p a t s
uslak	ʔ u s l a k
shiboli	ʃ i b o l i
pispis	p i s p i s
lapit	l a p i t
lawulta	l a w u l t a
halungkat	h a l u ŋ k a t
dara	d a ɾ a
mahikaw	m a h i k a w
kalapati	k a l a p a t i
mayoldomo	m a j o l d o m o
ineng	ʔ i n e ŋ
lithaw	l i t h a w
pinabulaanan	p i n a b u l a ʔ a n a n
Salvatierra	s a l v a t i e r a
Lanao	l a n a w
ritrato	ɾ i t ɾ a t o
alipunga	ʔ a l i p u ŋ a
omsim	ʔ o m s i m
palakpakan	p a l a k p a k a n
matatauhan	m a t a t a ʔ u h a n
Mabulo	m a b u l o
aborsiyonista	ʔ a b o ɾ s i o n i s t a
kupo	k u p o ʔ
monopolyo	m o n o p o l j o
Tupa	t u p a
hikmat	h i k m a t
katotohanan	k a t o t o h a n a n
tikang	t i k a ŋ
kromosoma	k ɾ o m o s o m a
Pilipino	p i l i p i n o
Elorde	ʔ e l o ɾ d e
binatilyo	b i n a t i l j o
estranghero	ʔ e s t ɾ a ŋ h e ɾ o
marmol	m a ɾ m o l
gulang	ɡ u l a ŋ
tiyobibo	t i o b i b o
lara	l a ɾ a ʔ
simulasyon	s i m u l a s j o n
palabasa	p a l a b a s a
magmukmok	m a ɡ m u k m o k
Untalan	ʔ u n t a l a n
pilyo	p i l j o
almanake	ʔ a l m a n a k e
sutmondilaw	s u t ˌm o n d i l a w
ᜐ	s a s a ʔ
Alfredo	ʔ a l f ɾ e d o
guham	ɡ u h a m
latay	l a t a j
yabangan	j a b a ŋ a n
Ching	t͡ʃ i ŋ
sambalilo	s a m b a l i l o
matipuno	m a t i p u n o ʔ
makipagtalik	m a k i p a ɡ t a l i k
Ebanghelyo	ʔ e b a ŋ h e l j o
santan	s a n t a n
sundin	s u n d i n
bunggabilya	b u ŋ ɡ a b i l j a
bobo	b o b o
Montañez	m o n t a ɲ e s
Escueta	ʔ e s k u e t a
pagkakaisa	p a ɡ k a k a ʔ i s a
taltak	t a l t a k
maambunan	m a ʔ a m b u n a n
heranyo	h e ɾ a n j o
blangko	b l a ŋ k o
bilas	b i l a s
Manalang	m a n a l a ŋ
maglaway	m a ɡ l a w a j
ahas	ʔ a h a s
slang	s l a ŋ
ipakuha	ʔ i p a k u h a
lunsod	l u n s o d
lunday	l u n d a j
panganan	p a ŋ a n a n
sabila	s a b i l a
lansangan	l a n s a ŋ a n
April	ʔ e j p ɾ i l
kongkreto	k o ŋ k ɾ e t o
maghalabos	m a ɡ h a l a b o s
tulod	t u l o d
anib	ʔ a n i b
bangketa	b a ŋ k e t a
tagigapay	t a ɡ i ɡ a p a j
sulid	s u l i d
tawge	t a w ɡ e
engrande	ʔ e ŋ ɡ ɾ a n d e
bubog	b u b o ɡ
sulit	s u l i t
lagkit	l a ɡ k i t
Togo	t o ɡ o
sumalangit	s u m a l a ŋ i t
Cabungcal	k a b u ŋ k a l
adelanto	ʔ a d e l a n t o
lugami	l u ɡ a m i ʔ
sugadagitban	s u ɡ a d a ɡ i t b a n
maano	m a ʔ a n o
Decena	d e s e n a
uyad	ʔ u j a d
pararayos	ˌp a ɾ a ɾ a j o s
tinik	t i n i k
ateismo	ʔ a t e i s m o
Korean	k o ɾ i a n
gora	ɡ o ɾ a
ugaw	ʔ u ɡ a w
umaakyat	ʔ u m a ʔ a k j a t
organista	ʔ o ɾ ɡ a n i s t a
lumutang	l u m u t a ŋ
heologo	h e o l o ɡ o
Miraflores	m i ɾ a f l o ɾ e s
manunula	m a n u n u l a ʔ
manirahan	m a n i ɾ a h a n
adhika	ʔ a d h i k a ʔ
relasyon	ɾ e l a s j o n
pananambang	p a n a n a m b a ŋ
Samar	s a m a ɾ
obserbatoryo	ʔ o b s e ɾ b a t o ɾ j o
magbanda	m a ɡ b a n d a
pakikiramay	p a k i k i ɾ a m a j
Vizconde	v i s k o n d e
abandonado	ʔ a b a n d o n a d o
baway	b a w a j
ingklitik	ʔ i ŋ k l i t i k
himagsik	h i m a ɡ s i k
Orejudos	ʔ o ɾ e h u d o s
taksan	t a k s a n
guwatsinanggo	ɡ u a t͡ʃ i n a ŋ ɡ o
suspensiyon	s u s p e n s i o n
kumbensiyon	k u m b e n s i o n
bisyo	b i s j o
talikakas	t a l i k a k a s
guyabano	ɡ u j a b a n o
punla	p u n l a ʔ
tsek	t͡ʃ e k
Escuadro	ʔ e s k u a d ɾ o
Iloko	ʔ i l o k o
ratratin	ɾ a t ɾ a t i n
David	d e j v i d
ninuno	n i n u n o ʔ
Loo	l u
Biyernes	b i e ɾ n e s
mansanas	m a n s a n a s
gunimbilang	ɡ u n i m b i l a ŋ
tigbuhol	t i ɡ b u h o l
espesyalista	ʔ e s p e s j a l i s t a
lesbiyana	l e s b i a n a
himagas	h i m a ɡ a s
mapuknat	m a p u k n a t
opsiyon	ʔ o p s i o n
dabdab	d a b d a b
Tayao	t a j a w
utas	ʔ u t a s
Medrano	m e d ɾ a n o
semento	s e m e n t o
Laude	l a w d e
lipstik	l i p s t i k
kurakot	k u ɾ a k o t
sangat	s a ŋ a t
sagubang	s a ɡ u b a ŋ
talino	t a l i n o
sakto	s a k t o
aruskaldo	ʔ a ɾ u s k a l d o
kalinggalan	k a l i ŋ ɡ a l a n
aroma	ʔ a ɾ o m a
manghihipo	m a ŋ h i h i p o ʔ
Nebraska	n e b ɾ a s k a
kalungsuran	k a l u ŋ s u ɾ a n
gamol	ɡ a m o l
dinsulan	d i n s u l a n
iso	ʔ i s o
na	n a
tinapay	t i n a p a j
Gascon	ɡ a s k o n
Hupiter	h u p i t e ɾ
katay	k a t a j
denggoy	d e ŋ ɡ o j
orihinal	ʔ o ɾ i h i n a l
malalakas	m a l a l a k a s
iskandalo	ʔ i s k a n d a l o
negosyo	n e ɡ o s j o
reptil	ɾ e p t i l
tinedyer	t i n e d j e ɾ
NAWASA	n a w a s a
balaglawas	b a l a ɡ l a w a s
tulag	t u l a ɡ
halayhay	h a l a j h a j
bandehado	b a n d e h a d o
dibdib	d i b d i b
haj	h a d͡ʒ
Corcuera	k o ɾ k u e ɾ a
mahuli	m a h u l i
dyudo	d j u d o
laguyo	l a ɡ u j o ʔ
medalya	m e d a l j a
kordero	k o ɾ d e ɾ o
kiyeme	k i e m e
Candelaria	k a n d e l a ɾ j a
Londres	l o n d ɾ e s
Samantha	s a m a n t a
latundan	l a t u n d a n
ene	ʔ e n e
donasyon	d o n a s j o n
laping	l a p i ŋ
badap	b a d a p
lagap	l a ɡ a p
ornitolohiya	ʔ o ɾ n i t o l o h i a
maging	m a ɡ i ŋ
Dalangin	d a l a ŋ i n
Bayot	b a j o t
salahilo	s a l a h i l o
Arcillas	ʔ a ɾ s i l j a s
Sanson	s a n s o n
silidkulay	s i ˌl i d k u l a j
publiko	p u b l i k o
sapantaha	s a p a n t a h a ʔ
Casiguran	k a s i ɡ u ɾ a n
Isabang	ʔ i s a b a ŋ
baitang	b a ʔ i t a ŋ
malambot	m a l a m b o t
tiple	t i p l e
melodiya	m e l o d i a
bako	b a k o ʔ
Inglatera	ʔ i ŋ ɡ l a t e ɾ a
abnormalidad	ʔ a b n o ɾ m a l i d a d
muwi	m u i ʔ
alat	ʔ a l a t
Eden	ʔ e d e n
f	ʔ e f
abain	ʔ a b a ʔ i n
soberaniya	s o b e ɾ a n i a
Negros	n e ɡ ɾ o s
sapsuy	s a p s u j
kantutin	k a n t u t i n
destornilyador	d e s t o ɾ n i l j a d o ɾ
magigi	m a ɡ i ɡ i ʔ
Corro	k o r o
Rosete	ɾ o s e t e
kabalyo	k a b a l j o
pagsasaka	p a ɡ s a s a k a
sikreto	s i k ɾ e t o
maliw	m a l i w
katol	k a t o l
mahumaling	m a h u m a l i ŋ
Budista	b u d i s t a
kusinero	k u s i n e ɾ o
apostol	ʔ a p o s t o l
residente	ɾ e s i d e n t e
halabos	h a l a b o s
maglustay	m a ɡ l u s t a j
inupas	ʔ i n u p a s
andaderas	ʔ a n d a d e ɾ a s
yaya	j a j a
bagaso	b a ɡ a s o
Mangalindan	m a ŋ a l i n d a n
maburol	ˌm a b u ɾ o l
pumanghaw	p u m a ŋ h a w
harapan	h a ɾ a p a n
dinuduguan	d i n u d u ɡ u ʔ a n
permiso	p e ɾ m i s o
Mamburao	m a m b u ɾ a w
lumamig	l u m a m i ɡ
astinggal	ʔ a s t i ŋ ɡ a l
timbulog	t i m b u l o ɡ
Cabasag	k a b a s a ɡ
tilandoy	t i l a n d o j
manulat	m a n u l a t
kaliko	k a l i k o
artipisyal	ʔ a ɾ t i p i s j a l
magbabasa	m a ɡ b a b a s a
tanghal	t a ŋ h a l
luwag	l u a ɡ
J	d j e j
umisod	ʔ u m i s o d
ermat	ʔ e ɾ m a t
palaba	p a l a b a
Godiñez	ɡ o d i ɲ e s
kabaktan	k a b a k t a n
inidoro	ʔ i n i d o ɾ o
Abad	ʔ a b a d
hunyango	h u n j a ŋ o ʔ
okey	ʔ o k e j
ahiya	ʔ a h i a
impluwensiya	ʔ i m p l u e n s j a
simana	s i m a n a
bisyon	b i s j o n
pipirmahan	p i p i ɾ m a h a n
panloob	p a n l o ʔ o b
naganap	n a ɡ a n a p
palapatik	p a l a p a t i k
pagong	p a ɡ o ŋ
kali	k a l i
tanghali	t a ŋ h a l i ʔ
mesa	m e s a
sumingaw	s u m i ŋ a w
duwende	d u e n d e
administrasyon	ʔ a d m i n i s t ɾ a s j o n
buwitre	b u i t ɾ e
Eukaristiya	j u k a ɾ i s t i a
Cariño	k a ɾ i ɲ o
kingke	k i ŋ k e
tanawan	t a n a w a n
Wong	w o ŋ
bakli	b a k l i ʔ
dulas	d u l a s
ikalabingwalo	ʔ i k a l a ˌb i ŋ w a l o
pukyutan	p u k j u t a n
importante	ʔ i m p o ɾ t a n t e
alguwasil	ʔ a l ɡ u a s i l
paminta	p a m i n t a
hagap	h a ɡ a p
nguso	ŋ u s o ʔ
Paligsahan	p a l i ɡ s a h a n
ya	j a
N	ʔ e n
Igorot	ʔ i ɡ o ɾ o t
konsentidora	k o n s e n t i d o ɾ a
palitada	p a l i t a d a
Grace	ɡ ɾ e j s
uom	ʔ u ʔ o m
Ubalde	ʔ u b a l d e
mabunutan	m a b u n u t a n
magjakol	m a ɡ d͡ʒ a k o l
Malihan	m a l i h a n
palasimba	p a l a s i m b a
Kuniko	k u n i k o
Marife	m a ɾ i f e
repriherador	ɾ e p ɾ i h e ɾ a d o ɾ
sinsay	s i n s a j
tsibog	t͡ʃ i b o ɡ
lalaki	l a l a k i
dalubsining	d a l u b s i n i ŋ
katulong	k a t u l o ŋ
senadora	s e n a d o ɾ a
Nacpil	n a k p i l
lako	l a k o ʔ
tagiktik	t a ɡ i k t i k
balnisukat	b a l n i s u k a t
bayabasan	ˌb a j a b a s a n
katarungan	k a t a ɾ u ŋ a n
tsispa	t͡ʃ i s p a
Suansing	s u a n s i ŋ
retirada	ɾ e t i ɾ a d a
ramdam	ɾ a m d a m
lingming	l i ŋ m i ŋ
Manaoag	m a n a w a ɡ
Castañeda	k a s t a ɲ e d a
soli	s o l i ʔ
uranyo	ʔ u ɾ a n j o
lingguwista	l i ŋ ɡ u i s t a
Tindoc	t i n d o k
nakakabwisit	n a k a k a b w i s i t
iringan	ʔ i ɾ i ŋ a n
endyi	ʔ e n d j i
hane	h a n e
Maniquiz	m a n i k i s
eksaherado	ʔ e k s a h e ɾ a d o
banggit	b a ŋ ɡ i t
mawasak	m a w a s a k
iskolarsyip	ʔ i s k o l a ɾ s j i p
kutya	k u t j a ʔ
Epipanya	ʔ e p i p a n j a
saks	s a k s
hinga	h i ŋ a
akap	ʔ a k a p
ow	ʔ o w
seksi	s e k s i
gunaw	ɡ u n a w
Melchor	m e l t͡ʃ o ɾ
hawig	h a w i ɡ
salimao	s a l i m a ʔ o
adhikain	ʔ a d h i k a ʔ i n
yukyok	j u k j o k
pasayahin	p a s a j a h i n
matraka	m a t ɾ a k a
tonsura	t o n s u ɾ a
Ting	t i ŋ
kainin	k a ʔ i n i n
depinisyon	d e p i n i s j o n
labimpito	l a b i m p i t o
proyekto	p ɾ o j e k t o
halari	h a l a ɾ i ʔ
ipagsanggalang	ʔ i p a ɡ s a ŋ ɡ a l a ŋ
tuldik	t u l d i k
eskaparate	ʔ e s k a p a ɾ a t e
saklob	s a k l o b
kusing	k u s i ŋ
lagong	l a ɡ o ŋ
pasipismo	p a s i p i s m o
suminga	s u m i ŋ a
alimpuyo	ʔ a l i m p u j o
Hehoba	h e h o b a
dismayado	d i s m a j a d o
saya	s a j a
tapon	t a p o n
Aprika	ʔ a p ɾ i k a
panghalip	p a ŋ h a l i p
silinyador	s i l i n j a d o ɾ
babaero	b a b a ʔ e ɾ o
alusitha	ʔ a l u s i t h a ʔ
amin	ʔ a m i n
kanino	k a n i n o
laspag	l a s p a ɡ
bagsakan	b a ɡ s a k a n
tagapamagitan	t a ɡ a p a m a ɡ i t a n
lilipad	l i l i p a d
lungkag	l u ŋ k a ɡ
palanggana	p a l a ŋ ɡ a n a
Keiko	k e j k o
tolerante	t o l e ɾ a n t e
misteryoso	m i s t e ɾ j o s o
estrikto	ʔ e s t ɾ i k t o
reto	ɾ e t o
Pasamba	p a s a m b a
Marquez	m a ɾ k e s
Coquia	k o k j a
gamot	ɡ a m o t
panrelihiyon	p a n ɾ e l i h i o n
Dulay	d u l a j
tanggap	t a ŋ ɡ a p
rosaryo	ɾ o s a ɾ j o
Sesus	s e s u s
heodesya	h e o d e s j a
rin	ɾ i n
boksing	b o k s i ŋ
iset	ʔ i s e t
Cabiao	k a b j a w
balas	b a l a s
humigit	h u m i ɡ i t
ordenansa	ʔ o ɾ d e n a n s a
langlang	l a ŋ l a ŋ
sorbetes	s o ɾ b e t e s
tingting	t i ŋ t i ŋ
sakate	s a k a t e
Acuña	ʔ a k u ɲ a
Alcaide	ʔ a l k a j d e
Camantigue	k a m a n t i ɡ e
mangomisyon	m a ŋ o m i s j o n
kartamoneda	k a ɾ t a m o n e d a
hanger	h a ŋ e ɾ
takong	t a k o ŋ
ka	k a
dapo	d a p o ʔ
butanding	b u t a n d i ŋ
kontrasenyas	k o n t ɾ a s e n j a s
ikit	ʔ i k i t
sumbong	s u m b o ŋ
diyesmo	d i e s m o
sanib	s a n i b
eskala	ʔ e s k a l a
hupot	h u p o t
lukong	l u k o ŋ
sanggumay	s a ŋ ɡ u m a j
bino	b i n o
obserba	ʔ o b s e ɾ b a
tumpa	t u m p a
sibasib	s i b a s i b
jontis	d͡ʒ o n t i s
kabit	k a b i t
itapat	ʔ i t a p a t
tabon	t a b o n
maghasik	m a ɡ h a s i k
balana	b a l a n a
pagatasan	p a ɡ a t a s a n
yagong	j a ɡ o ŋ
sarsaparilya	s a ɾ s a p a ɾ i l j a
kasapuwego	k a s a p u e ɡ o
tambolero	t a m b o l e ɾ o
usong	ʔ u s o ŋ
direktora	d i ɾ e k t o ɾ a
pulpol	p u l p o l
gawin	ɡ a w i n
panggatong	p a ŋ ɡ a t o ŋ
habonero	h a b o n e ɾ o
ostrasismo	ʔ o s t ɾ a s i s m o
magnate	m a ɡ n a t e
Montaño	m o n t a ɲ o
maagap	m a ʔ a ɡ a p
perspektibo	p e ɾ s p e k t i b o
bituka	b i t u k a
balakyot	b a l a k j o t
bulig	b u l i ɡ
sumite	s u m i t e
dekwatin	d e k w a t i n
pandangal	p a n d a ŋ a l
tagahanga	t a ɡ a h a ŋ a ʔ
hilaw	h i l a w
Ayako	ʔ a j a k o
Samonte	s a m o n t e
Fukien	f u k j e n
Kapitan	k a p i t a n
gulat	ɡ u l a t
Garces	ɡ a ɾ s e s
sagot	s a ɡ o t
karta	k a ɾ t a
tunggali	t u ŋ ɡ a l i ʔ
oranggutan	ʔ o ɾ a ŋ ɡ u t a n
kuwarenta	k u a ɾ e n t a
lugaw	l u ɡ a w
Kulas	k u l a s
singa	s i ŋ a
bilyon	b i l j o n
pantalon	p a n t a l o n
paskuwa	p a s k u a
aaaban	ʔ a ʔ a ʔ a b a n
aduwana	ʔ a d u a n a
dado	d a d o
Amelia	ʔ a m i l j a
kuwadrilyon	k u a d ɾ i l j o n
pasintabi	p a s i n t a b i ʔ
tsireta	t͡ʃ i ɾ e t a
bigla	b i ɡ l a ʔ
Satanas	s a t a n a s
lugal	l u ɡ a l
grumadweyt	ɡ ɾ u m a d w e j t
taniman	t a n i m a n
kalsiyo	k a l s j o
Leyson	l e j s o n
pamahaw	p a m a h a w
sundan	s u n d a n
magyasyas	m a ɡ j a s j a s
oslo	ʔ o s l o
baliwag	b a l i w a ɡ
pinapagtalunan	p i ˌn a p a ɡ t a l u n a n
dunong	d u n o ŋ
mahalin	m a h a l i n
mangmang	m a ŋ m a ŋ
deretso	d e ɾ e t͡ʃ o
minsanan	m i n s a n a n
Yoshiko	j o ʃ i k o
pamilyaridad	p a m i l j a ɾ i d a d
Elcano	ʔ e l k a n o
lakwatsera	l a k w a t͡ʃ e ɾ a
kamakalawa	k a m a k a l a w a
bilo	b i l o
pagkasuplada	p a ɡ k a s u p l a d a
pasa	p a s a
empleyada	ʔ e m p l e a d a
kutong	k u t o ŋ
yumabong	j u m a b o ŋ
patola	p a t o l a
bunggo	b u ŋ ɡ o ʔ
Leung	l j u ŋ
kalyo	k a l j o
gumban	ɡ u m b a n
buwa	b u a ʔ
madrasta	m a d ɾ a s t a
basbasan	b a s b a s a n
nipis	n i p i s
nagdedeliryo	n a ɡ d e d e l i ɾ j o
nagagandahan	n a ɡ a ɡ a n d a h a n
sereno	s e ɾ e n o
Bolbok	b o l b o k
lumot	l u m o t
biyudo	b i u d o
oktaba	ʔ o k t a b a
Ormoc	ʔ o ɾ m o k
panaderya	p a n a d e ɾ j a
pamilyado	p a m i l j a d o
Bogota	b o ɡ o t a
amnestiya	ʔ a m n e s t i a
Allison	ʔ a l i s o n
alinman	ʔ a l i n m a n
dagos	d a ɡ o s
galang	ɡ a l a ŋ
walo	w a l o
lunaw	l u n a w
Manalastas	m a n a l a s t a s
makatarungan	m a k a t a ɾ u ŋ a n
balipik	b a l i p i k
Mandaluyong	m a n d a l u j o ŋ
panenteismo	p a n e n t e i s m o
pumasok	p u m a s o k
probinsiyana	p ɾ o b i n s i a n a
Megumi	m e ɡ u m i
setro	s e t ɾ o
kakampink	k a k a m p i n k
ngani	ŋ a n i ʔ
Esperanto	ʔ e s p e ɾ a n t o
Abarca	ʔ a b a ɾ k a
hitik	h i t i k
banas	b a n a s
pasiya	p a s i a
deskumpiyado	d e s k u m p i a d o
alikabok	ʔ a l i k a b o k
saing	s a ʔ i ŋ
noon	n o ʔ o n
maghimagsik	m a ɡ h i m a ɡ s i k
adisyonal	ʔ a d i s j o n a l
walumpu	w a l u m p u ʔ
pilit	p i l i t
kuwitis	k u i t i s
kapre	k a p ɾ e
teleolohiya	t e l e o l o h i a
pakikiapid	p a k i k i ʔ a p i d
Punzalan	p u n z a l a n
apresyasyon	ʔ a p ɾ e s j a s j o n
pating	p a t i ŋ
endoso	ʔ e n d o s o
tsarter	t͡ʃ a ɾ t e ɾ
dutaan	d u t a ʔ a n
libang	l i b a ŋ
paepek	p a ʔ e p e k
mangjumbag	m a ŋ d͡ʒ u m b a ɡ
pamahalaan	ˌp a m a h a l a ʔ a n
laklak	l a k l a k
buyo	b u j o
polbo	p o l b o
balbal	b a l b a l
kuripot	k u ɾ i p o t
silog	s i l o ɡ
daspanin	d a s p a n i n
payak	p a j a k
matinis	m a t i n i s
talimang	t a l i m a ŋ
estilo	ʔ e s t i l o
beho	b e h o
kupad	k u p a d
Zosimo	z o s i m o
palasyo	p a l a s j o
pasiglahin	p a s i ɡ l a h i n
Saavedra	s a ʔ a v e d ɾ a
agam	ʔ a ɡ a m
baranggay	b a ɾ a ŋ ɡ a j
anubing	ʔ a n u b i ŋ
eskarlata	ʔ e s k a ɾ l a t a
damuho	d a m u h o ʔ
lalamunan	l a l a m u n a n
maselan	m a s e l a n
bulyos	b u l j o s
propagandista	p ɾ o p a ɡ a n d i s t a
Sanchez	s a n t͡ʃ e s
ngipin	ŋ i p i n
Barangka	b a ɾ a ŋ k a ʔ
apdo	ʔ a p d o
gulumihan	ɡ u l u m i h a n
bilang	b i l a ŋ
kontento	k o n t e n t o
bilauo	b i l a w o
kausap	k a ʔ u s a p
mabunganga	m a b u ŋ a ŋ a ʔ
kurus	k u ɾ u s
banayad	b a n a j a d
apula	ʔ a p u l a ʔ
Esguerra	ʔ e s ɡ e r a
inhenyeriya	ʔ i n h e n j e ɾ i a
Z	z i
Corpus	k o ɾ p u s
golpe	ɡ o l p e
Alvaro	ʔ a l v a ɾ o
bukadkad	b u k a d k a d
pangyari	p a ŋ j a ɾ i
diko	d i k o
waley	w a l e j
bumigay	b u m i ɡ a j
Alabang	ʔ a l a b a ŋ
Canoy	k a n o j
durog	d u ɾ o ɡ
gahol	ɡ a h o l
trabahadora	t ɾ a b a h a d o ɾ a
kahero	k a h e ɾ o
kulungan	ˌk u l u ŋ a n
Siason	s j a s o n
kabata	k a b a t a ʔ
uwak	ʔ u a k
apatita	ʔ a p a t i t a
klinik	k l i n i k
bilangguan	b i l a ŋ ɡ u ʔ a n
ariangaw	ʔ a ɾ i ʔ a ŋ a w
aguha	ʔ a ɡ u h a
magusot	m a ɡ u s o t
depensibo	d e p e n s i b o
dalubtao	d a ˌl u b t a ʔ o
dipterya	d i p t e ɾ j a
ilap	ʔ i l a p
kahoy	k a h o j
Dagupan	d a ɡ u p a n
Pesigan	p e s i ɡ a n
optimista	ʔ o p t i m i s t a
lona	l o n a
paraluman	p a ɾ a l u m a n
asul	ʔ a s u l
alibutran	ʔ a l i b u t ɾ a n
dalya	d a l j a
biskuwit	b i s k u i t
tula	t u l a ʔ
hain	h a ʔ i n
ewan	ʔ e w a n
albakora	ʔ a l b a k o ɾ a
lentehas	l e n t e h a s
gagi	ɡ a ɡ i ʔ
Maristela	m a ɾ i s t e l a
seminaryo	s e m i n a ɾ j o
garya	ɡ a ɾ j a ʔ
kamuning	k a m u n i ŋ
mambiktima	m a m b i k t i m a
ganda	ɡ a n d a
okultismo	ʔ o k u l t i s m o
raan	ɾ a ʔ a n
singsing	s i ŋ s i ŋ
kolado	k o l a d o
gasera	ɡ a s e ɾ a
Kamatayan	k a m a t a j a n
sapagkat	s a p a ɡ k a t
yamo	j a m o ʔ
asupre	ʔ a s u p ɾ e
Salgado	s a l ɡ a d o
integral	ʔ i n t e ɡ ɾ a l
bilao	b i l a ʔ o
padyak	p a d j a k
disposisyon	d i s p o s i s j o n
bamos	b a m o s
kayumanis	k a j u m a n i s
hayahay	h a j a h a j
kalihim	k a l i h i m
maglalaway	m a ɡ l a l a w a j
anyaya	ʔ a n j a j a
eskalera	ʔ e s k a l e ɾ a
lingguhan	l i ŋ ɡ u h a n
asapran	ʔ a s a p ɾ a n
also	ʔ a l s o
deskaril	d e s k a ɾ i l
kariton	k a ɾ i t o n
Lakan	l a k a n
ligwan	l i ɡ w a n
tayabutab	t a j a b u t a b
helikopter	h e l i k o p t e ɾ
tampay	t a m p a j
Hizon	h i z o n
tabernakulo	t a b e ɾ ˌn a k u l o
pagkabuhay	p a ɡ k a b u h a j
palintong	p a l i n t o ŋ
sukdulan	s u k d u l a n
Biring	b i ɾ i ŋ
inskripsiyon	ʔ i n s k ɾ i p s i o n
redaksiyon	ɾ e d a k s i o n
tikim	t i k i m
Siam	s i a m
reyalista	ɾ e a l i s t a
makalima	m a k a l i m a
pilak	p i l a k
Manalo	m a n a l o
Zafra	z a f ɾ a
eto	ʔ e t o
saloy	s a l o j
iyelo	ʔ i e l o
ulbo	ʔ u l b o ʔ
pagandahin	p a ɡ a n d a h i n
lusog	l u s o ɡ
Huwebes	h u e b e s
oras	ʔ o ɾ a s
Damulag	d a m u l a ɡ
Ochoa	ʔ o t͡ʃ o a
karisma	k a ɾ i s m a
tinga	t i ŋ a
balabal	b a l a b a l
alternatibo	ʔ a l t e ɾ n a t i b o
Zamora	z a m o ɾ a
arwa	ʔ a ɾ w a ʔ
anghang	ʔ a ŋ h a ŋ
Bulakan	b u l a k a n
estapa	ʔ e s t a p a
kamyas	k a m j a s
sukol	s u k o l
takoyaki	t a k o j a k i
tiwali	t i w a l i ʔ
kana	k a n a ʔ
esmeralda	ʔ e s m e ɾ a l d a
alilis	ʔ a l i l i s
pangmatanda	p a ŋ m a t a n d a ʔ
bango	b a ŋ o
toniko	t o n i k o
tingni	t i ŋ n i
ponema	p o n e m a
balansang	b a l a n s a ŋ
danumsigwasan	d a n u m s i ɡ w a s a n
penitensiya	p e n i t e n s j a
batad	b a t a d
biyopisika	b i o p i s i k a
Maunahan	m a ʔ u n a h a n
daplis	d a p l i s
talos	t a l o s
anek	ʔ a n e k
bumagal	b u m a ɡ a l
kanila	k a n i l a
kuhol	k u h o l
patnugot	p a t n u ɡ o t
mulinilyo	m u l i n i l j o
salang	s a l a ŋ
Dayang	d a j a ŋ
Guillermo	ɡ i l j e ɾ m o
Malaruhatan	m a l a ɾ u h a t a n
pagsusunog	p a ɡ s u s u n o ɡ
Koji	k o d͡ʒ i
sulatan	s u l a t a n
siyantung	s i a n t u ŋ
kampanya	k a m p a n j a
taling	t a l i ŋ
pambansa	p a m b a n s a ʔ
letrina	l e t ɾ i n a
lumakas	l u m a k a s
kamandag	k a m a n d a ɡ
aikido	ʔ a j k i d o
Bugtong	b u ɡ t o ŋ
pitundaan	p i t u n d a ʔ a n
nino	n i n o
distansiya	d i s t a n s j a
mabalakid	m a b a l a k i d
kulaysukat	k u l a j s u k a t
anemya	ʔ a n e m j a
emyenda	ʔ e m j e n d a
tsokolate	t͡ʃ o k o l a t e
maalamat	m a ʔ a l a m a t
uraw	ʔ u ɾ a w
salaula	s a l a ʔ u l a ʔ
talaba	t a l a b a
tagiliran	t a ɡ i l i ɾ a n
kunsumisyon	k u n s u m i s j o n
pambata	p a m b a t a
awtonomiya	ʔ a w t o n o m i a
Tamiko	t a m i k o
gatid	ɡ a t i d
patidyugto	p a t i d j u ɡ t o ʔ
sakong	s a k o ŋ
bukambibig	b u k a m b i b i ɡ
Jocson	h o k s o n
lagundi	l a ɡ u n d i ʔ
nananamantala	n a n a n a m a n t a l a
Lupa	l u p a ʔ
bungangera	b u ŋ a ŋ e ɾ a
kalo	k a l o ʔ
magdaos	p a ɡ d a ʔ o s
impormal	ʔ i m p o ɾ m a l
Salcedo	s a l s e d o
katastrope	k a t a s t ɾ o p e
padyama	p a d j a m a
duweto	d u e t o
Dee	d i
bumalikwas	b u m a l i k w a s
dagim	d a ɡ i m
lumboy	l u m b o j
tol	t o l
paglilitis	p a ɡ l i l i t i s
halip	h a l i p
kalumbahin	k a l u m b a h i n
soberano	s o b e ɾ a n o
Albano	ʔ a l b a n o
lumuklok	l u m u k l o k
pitsel	p i t͡ʃ e l
olat	ʔ o l a t
Enero	ʔ e n e ɾ o
solusyon	s o l u s j o n
masalimuot	m a s a l i m u ʔ o t
Tien	t j e n
tanghalian	t a ŋ h a l i ʔ a n
nang	n a ŋ
maulanan	m a ʔ u l a n a n
tilarok	t i l a ɾ o k
rumupok	ɾ u m u p o k
iti	ʔ i t i
Gumaca	ɡ u m a k a
inspeksiyon	ʔ i n s p e k s i o n
balon	b a l o n
Piñon	p i ɲ o n
dumaigdig	d u m a ʔ i ɡ d i ɡ
maaari	m a ʔ a ʔ a ɾ i ʔ
alamang	ʔ a l a m a ŋ
lambayog	l a m b a j o ɡ
tsumaka	t͡ʃ u m a k a
silbiro	s i l b i ɾ o
gagapang	ɡ a ɡ a p a ŋ
bilingguwal	b i l i ŋ ɡ u a l
praning	p ɾ a n i ŋ
landi	l a n d i ʔ
palarindingan	p a l a ɾ i n d i ŋ a n
tungki	t u ŋ k i ʔ
pangko	p a ŋ k o
bisitahin	b i s i t a h i n
Manaog	m a n a ʔ o ɡ
yate	j a t e
Valera	v a l e ɾ a
bahagdan	b a h a ɡ d a n
sepilyo	s e p i l j o
pakyaw	p a k j a w
Gonzales	ɡ o n z a l e s
panlinis	p a n l i n i s
higliknayan	h i ɡ l i k n a j a n
dulis	d u l i s
wilik	w i l i k
eksorsismo	ʔ e k s o ɾ s i s m o
