ablakból	ɒ b l ɒ ɡ b oː l
acéllemez	ɒ t͡s eː lː ɛ m ɛ z
adatainak	ɒ d ɒ t ɒ j i n ɒ k
adni	ɒ d n i
ajánlattevő	ɒ j aː n l ɒ tː ɛ v øː
akad	ɒ k ɒ d
akció	ɒ k t͡s i j oː
akihez	ɒ k i ɦ ɛ z
akiknek	ɒ k i k n ɛ k
alkalmasnak	ɒ l k ɒ l m ɒ ʃ n ɒ k
alkalmazni	ɒ l k ɒ l m ɒ z n i
alkalmazása	ɒ l k ɒ l m ɒ z aː ʃ ɒ
alkalmazásának	ɒ l k ɒ l m ɒ z aː ʃ aː n ɒ k
alkotó	ɒ l k o t oː
allen	ɛ l ɛ n
amelyen	ɒ m ɛ j ɛ n
amelynél	ɒ m ɛ j n eː l
amikkel	ɒ m i kː ɛ l
amit	ɒ m i t
analfabéták	ɒ n ɒ l f ɒ b eː t aː k
andrás	ɒ n d r aː ʃ
anesztézia	ɒ n ɛ s t eː z i j ɒ
annyi	ɒ ɲː i
annál	ɒ nː aː l
antal	ɒ n t ɒ l
anyagokat	ɒ ɲ ɒ ɡ o k ɒ t
anyuka	ɒ ɲ u k ɒ
apa	ɒ p ɒ
arca	ɒ r t͡s ɒ
arcán	ɒ r t͡s aː n
attribútum	ɒ t r i b uː t u m
ausztriában	ɒ u s t r i j aː b ɒ n
autók	ɒ u t oː k
azokat	ɒ z o k ɒ t
azért	ɒ z eː r t
balatoni	b ɒ l ɒ t o n i
be	b ɛ
befejezetlen	b ɛ f ɛ j ɛ z ɛ t l ɛ n
befejezés	b ɛ f ɛ j ɛ z eː ʃ
befektetők	b ɛ f ɛ k t ɛ t øː k
bejelenteni	b ɛ j ɛ l ɛ n t ɛ n i
belüli	b ɛ l y l i
bemutatásra	b ɛ m u t ɒ t aː ʃ r ɒ
benyomni	b ɛ ɲ o m n i
benzin	b ɛ n z i n
beszerzés	b ɛ s ɛ r z eː ʃ
beszédét	b ɛ s eː d eː t
beszéljen	b ɛ s eː jː ɛ n
betegségek	b ɛ t ɛ k ʃ eː ɡ ɛ k
betyárok	b ɛ c aː r o k
betöltött	b ɛ t ø l t ø tː
birtoka	b i r t o k ɒ
bizonytalanságok	b i z o ɲ t ɒ l ɒ n ʃ aː ɡ o k
biztató	b i s t ɒ t oː
biztonságosabb	b i s t o n ʃ aː ɡ o ʃ ɒ bː
borító	b o r iː t oː
buda	b u d ɒ
budapestre	b u d ɒ p ɛ ʃ t r ɛ
burkolat	b u r k o l ɒ t
buszok	b u s o k
bécsben	b eː d͡ʒ b ɛ n
bérelt	b eː r ɛ l t
bír	b iː r
büntetés	b y n t ɛ t eː ʃ
bűn	b yː n
ceremónia	t͡s ɛ r ɛ m oː n i j ɒ
cikket	t͡s i kː ɛ t
cipzár	t͡s i b z aː r
citromsav	t͡s i t r o m ʃ ɒ v
csaknem	t͡ʃ ɒ k n ɛ m
családja	t͡ʃ ɒ l aː ɟː ɒ
csap	t͡ʃ ɒ p
csapadék	t͡ʃ ɒ p ɒ d eː k
csapatok	t͡ʃ ɒ p ɒ t o k
csapatoknak	t͡ʃ ɒ p ɒ t o k n ɒ k
csatlakozik	t͡ʃ ɒ t l ɒ k o z i k
csehek	t͡ʃ ɛ h ɛ k
cseppet	t͡ʃ ɛ pː ɛ t
csillagok	t͡ʃ i lː ɒ ɡ o k
csodálatos	t͡ʃ o d aː l ɒ t o ʃ
csoki	t͡ʃ o k i
csoportját	t͡ʃ o p o r c aː t
csökkentése	t͡ʃ ø kː ɛ n t eː ʃ ɛ
csütörtök	t͡ʃ y t ø r t ø k
csütörtökön	t͡ʃ y t ø r t ø k ø n
cukor	t͡s u k o r
cégek	t͡s eː ɡ ɛ k
célkitűzés	t͡s eː l k i t yː z eː ʃ
célpontok	t͡s eː l p o n t o k
címe	t͡s iː m ɛ
debreceni	d ɛ b r ɛ t͡s ɛ n i
demokraták	d ɛ m o k r ɒ t aː k
dimenziók	d i m ɛ n z i j oː k
dobogó	d o b o ɡ oː
dolgát	d o l ɡ aː t
dönt	d ø n t
döntéshozó	d ø n t eː ʃ h o z oː
döntő	d ø n t øː
ebből	ɛ bː øː l
egerek	ɛ ɡ ɛ r ɛ k
egyenesen	ɛ ɟ ɛ n ɛ ʃ ɛ n
egyház	ɛ c h aː z
egykor	ɛ c k o r
egyre	ɛ ɟ r ɛ
egyének	ɛ ɟ eː n ɛ k
egyénileg	ɛ ɟ eː n i l ɛ ɡ
egészségbiztosítási	ɛ ɡ eː ʃː eː ɡ b i s t o ʃ iː t aː ʃ i
el	ɛ l
elektromos	ɛ l ɛ k t r o m o ʃ
elektronikus	ɛ l ɛ k t r o n i k u ʃ
elem	ɛ l ɛ m
elemző	ɛ l ɛ m z øː
elismerés	ɛ l i ʃ m ɛ r eː ʃ
eljáró	ɛ jː aː r oː
elkészítése	ɛ l k eː s iː t eː ʃ ɛ
elkövetkező	ɛ l k ø v ɛ t k ɛ z øː
ellentétes	ɛ lː ɛ n t eː t ɛ ʃ
elnézést	ɛ l n eː z eː ʃ t
elnöke	ɛ l n ø k ɛ
elnöki	ɛ l n ø k i
elnökének	ɛ l n ø k eː n ɛ k
elnökét	ɛ l n ø k eː t
elnököt	ɛ l n ø k ø t
elsődleges	ɛ l ʃ øː d l ɛ ɡ ɛ ʃ
eltérő	ɛ l t eː r øː
elvétve	ɛ l v eː t v ɛ
eléréséhez	ɛ l eː r eː ʃ eː ɦ ɛ z
előkészítése	ɛ l øː k eː s iː t eː ʃ ɛ
előleg	ɛ l øː l ɛ ɡ
előnye	ɛ l øː ɲ ɛ
előtti	ɛ l øː tː i
előítélet	ɛ l øː j iː t eː l ɛ t
emelkedő	ɛ m ɛ l k ɛ d øː
emlékszik	ɛ m l eː k s i k
emlő	ɛ m l øː
energiát	ɛ n ɛ r ɡ i j aː t
ennek	ɛ nː ɛ k
ennél	ɛ nː eː l
erdőkben	ɛ r d øː ɡ b ɛ n
eredmények	ɛ r ɛ d m eː ɲ ɛ k
eredményre	ɛ r ɛ d m eː ɲ r ɛ
eredményt	ɛ r ɛ d m eː ɲ t
erősítése	ɛ r øː ʃ iː t eː ʃ ɛ
esemény	ɛ ʃ ɛ m eː ɲ
esküvői	ɛ ʃ k y v øː j i
esti	ɛ ʃ t i
estig	ɛ ʃ t i ɡ
eszerint	ɛ s ɛ r i n t
eszközzel	ɛ s k ø zː ɛ l
eszközök	ɛ s k ø z ø k
esztek	ɛ s t ɛ k
esély	ɛ ʃ eː j
esélyekkel	ɛ ʃ eː j ɛ kː ɛ l
esős	ɛ ʃ øː ʃ
evezős	ɛ v ɛ z øː ʃ
expedíció	ɛ k s p ɛ d iː t͡s i j oː
export	ɛ k s p o r t
ezernyi	ɛ z ɛ r ɲ i
falat	f ɒ l ɒ t
fegyverek	f ɛ ɟ v ɛ r ɛ k
fejleszteni	f ɛ j l ɛ s t ɛ n i
fejlesztésének	f ɛ j l ɛ s t eː ʃ eː n ɛ k
fejlődése	f ɛ j l øː d eː ʃ ɛ
fejlődő	f ɛ j l øː d øː
feladatai	f ɛ l ɒ d ɒ t ɒ j i
felelősségtudat	f ɛ l ɛ l øː ʃː eː k t u d ɒ t
felelősségét	f ɛ l ɛ l øː ʃː eː ɡ eː t
felszínes	f ɛ l s iː n ɛ ʃ
felsőbb	f ɛ l ʃ øː bː
feltételek	f ɛ l t eː t ɛ l ɛ k
feltételez	f ɛ l t eː t ɛ l ɛ z
feltétlenül	f ɛ l t eː t l ɛ n y l
felvételek	f ɛ l v eː t ɛ l ɛ k
felére	f ɛ l eː r ɛ
felület	f ɛ l y l ɛ t
felülvizsgálat	f ɛ l y l v i ʒ ɡ aː l ɒ t
fesztivált	f ɛ s t i v aː l t
figurát	f i ɡ u r aː t
figyelembe	f i ɟ ɛ l ɛ m b ɛ
figyelmeztet	f i ɟ ɛ l m ɛ s t ɛ t
filozófiai	f i l o z oː f i j ɒ j i
fizikailag	f i z i k ɒ j i l ɒ ɡ
foci	f o t͡s i
foglalás	f o ɡ l ɒ l aː ʃ
fogni	f o ɡ n i
fogom	f o ɡ o m
folytat	f o j t ɒ t
folytatás	f o j t ɒ t aː ʃ
folytatódik	f o j t ɒ t oː d i k
fordulóban	f o r d u l oː b ɒ n
fordított	f o r d iː t o tː
forint	f o r i n t
formai	f o r m ɒ j i
forradalmi	f o rː ɒ d ɒ l m i
fotót	f o t oː t
francia	f r ɒ n t͡s i j ɒ
fronton	f r o n t o n
futás	f u t aː ʃ
fájdalmas	f aː j d ɒ l m ɒ ʃ
föld	f ø l d
földek	f ø l d ɛ k
földterület	f ø l t ɛ r y l ɛ t
függőlegesen	f y ɡː øː l ɛ ɡ ɛ ʃ ɛ n
füves	f y v ɛ ʃ
főbb	f øː bː
főnél	f øː n eː l
főpolgármester	f øː p o l ɡ aː r m ɛ ʃ t ɛ r
főszerkesztője	f øː s ɛ r k ɛ s t øː j ɛ
gazdaságot	ɡ ɒ z d ɒ ʃ aː ɡ o t
generációs	ɡ ɛ n ɛ r aː t͡s i j oː ʃ
gondoltam	ɡ o n d o l t ɒ m
grúz	ɡ r uː z
gusztustalan	ɡ u s t u ʃ t ɒ l ɒ n
gyakorol	ɟ ɒ k o r o l
gyakrabban	ɟ ɒ k r ɒ bː ɒ n
gyanúja	ɟ ɒ n uː j ɒ
gyanúsított	ɟ ɒ n uː ʃ iː t o tː
gyermekét	ɟ ɛ r m ɛ k eː t
gágog	ɡ aː ɡ o ɡ
géza	ɡ eː z ɒ
görög	ɡ ø r ø ɡ
ha	h ɒ
hagyma	h ɒ ɟ m ɒ
hagyománya	h ɒ ɟ o m aː ɲ ɒ
hagyományai	h ɒ ɟ o m aː ɲ ɒ j i
hajóra	h ɒ j oː r ɒ
hajótörést	h ɒ j oː t ø r eː ʃ t
hallgat	h ɒ l ɡ ɒ t
hallom	h ɒ lː o m
hallottam	h ɒ lː o tː ɒ m
halott	h ɒ l o tː
halálát	h ɒ l aː l aː t
hangszerek	h ɒ ŋ k s ɛ r ɛ k
harang	h ɒ r ɒ ŋ ɡ
harcot	h ɒ r t͡s o t
hasonlít	h ɒ ʃ o n l iː t
használni	h ɒ s n aː l n i
határidők	h ɒ t aː r i d øː k
határozni	h ɒ t aː r o z n i
határt	h ɒ t aː r t
hatással	h ɒ t aː ʃː ɒ l
helyek	h ɛ j ɛ k
helyeken	h ɛ j ɛ k ɛ n
helyen	h ɛ j ɛ n
helyett	h ɛ j ɛ tː
helyezett	h ɛ j ɛ z ɛ tː
hercegnőnek	h ɛ r t͡s ɛ ɡ n øː n ɛ k
heti	h ɛ t i
hiányos	h i j aː ɲ o ʃ
hiányosságok	h i j aː ɲ o ʃː aː ɡ o k
hordozó	h o r d o z oː
hormonok	h o r m o n o k
horthy	h o r t i
hozták	h o s t aː k
hozzátok	h o zː aː t o k
huszonnégy	h u s o nː eː ɟ
hálózat	h aː l oː z ɒ t
három	h aː r o m
háttér	h aː tː eː r
hétben	h eː d b ɛ n
hétvégén	h eː t v eː ɡ eː n
híd	h iː d
híreket	h iː r ɛ k ɛ t
hó	h oː
hócipője	h oː t͡s i p øː j ɛ
hő	h øː
hűvösebb	h yː v ø ʃ ɛ bː
időbeli	i d øː b ɛ l i
időktől	i d øː k t øː l
időközben	i d øː k ø z b ɛ n
időnkénti	i d øː ŋ k eː n t i
időpontban	i d øː p o n d b ɒ n
időre	i d øː r ɛ
idős	i d øː ʃ
időt	i d øː t
ifjúsági	i f j uː ʃ aː ɡ i
igazolvány	i ɡ ɒ z o l v aː ɲ
igazán	i ɡ ɒ z aː n
illik	i lː i k
illékony	i lː eː k o ɲ
immár	i mː aː r
ingatag	i ŋ ɡ ɒ t ɒ ɡ
ingatlant	i ŋ ɡ ɒ t l ɒ n t
inget	i ŋ ɡ ɛ t
ingyen	i ɲ ɟ ɛ n
ipar	i p ɒ r
irigykedik	i r i c k ɛ d i k
irányuló	i r aː ɲ u l oː
irányzat	i r aː ɲ z ɒ t
ismertebb	i ʃ m ɛ r t ɛ bː
isteni	i ʃ t ɛ n i
izraeli	i z r ɒ ɛ l i
izzok	i zː o k
jaj	j ɒ j
jegyzet	j ɛ ɟ z ɛ t
jelentősebb	j ɛ l ɛ n t øː ʃ ɛ bː
jellemzően	j ɛ lː ɛ m z øː ɛ n
jelöltek	j ɛ l ø l t ɛ k
jobb	j o bː
jogszabályok	j o k s ɒ b aː j o k
jogát	j o ɡ aː t
junior	j u n i j o r
jutott	j u t o tː
jutunk	j u t u ŋ k
jártak	j aː r t ɒ k
járunk	j aː r u ŋ k
járványok	j aː r v aː ɲ o k
játékban	j aː t eː ɡ b ɒ n
játékok	j aː t eː k o k
jönnek	j ø nː ɛ k
kalandor	k ɒ l ɒ n d o r
kankalin	k ɒ ŋ k ɒ l i n
kapcsolattartás	k ɒ p t͡ʃ o l ɒ tː ɒ r t aː ʃ
kapjanak	k ɒ p j ɒ n ɒ k
kapjuk	k ɒ p j u k
kapott	k ɒ p o tː
kaptak	k ɒ p t ɒ k
kar	k ɒ r
karbantartások	k ɒ r b ɒ n t ɒ r t aː ʃ o k
kategóriát	k ɒ t ɛ ɡ oː r i j aː t
katona	k ɒ t o n ɒ
kelenföld	k ɛ l ɛ ɱ f ø l d
kelljen	k ɛ jː ɛ n
kellő	k ɛ lː øː
kemény	k ɛ m eː ɲ
keresztcsont	k ɛ r ɛ s t t͡ʃ o n t
keresztül	k ɛ r ɛ s t y l
keresők	k ɛ r ɛ ʃ øː k
keretet	k ɛ r ɛ t ɛ t
kerékpáros	k ɛ r eː k p aː r o ʃ
kerület	k ɛ r y l ɛ t
kezdik	k ɛ z d i k
kezel	k ɛ z ɛ l
kezelhető	k ɛ z ɛ l ɦ ɛ t øː
kezét	k ɛ z eː t
kiabálnak	k i j ɒ b aː l n ɒ k
kiadás	k i j ɒ d aː ʃ
kiadó	k i j ɒ d oː
kialakítani	k i j ɒ l ɒ k iː t ɒ n i
kialakítására	k i j ɒ l ɒ k iː t aː ʃ aː r ɒ
kicsivel	k i t͡ʃ i v ɛ l
kicsoda	k i t͡ʃ o d ɒ
kikre	k i k r ɛ
kilót	k i l oː t
királyság	k i r aː j ʃ aː ɡ
kisbaba	k i ʒ b ɒ b ɒ
kiss	k i ʃ
kiváltság	k i v aː l t͡ʃ aː ɡ
kivételes	k i v eː t ɛ l ɛ ʃ
koalíciós	k o ɒ l iː t͡s i j oː ʃ
kockázatot	k o t͡s k aː z ɒ t o t
kolozsvári	k o l o ʒ v aː r i
komolyan	k o m o j ɒ n
konferenciát	k o ɱ f ɛ r ɛ n t͡s i j aː t
konstrukció	k o n ʃ t r u k t͡s i j oː
kormányfő	k o r m aː ɲ f øː
kozma	k o z m ɒ
kritikus	k r i t i k u ʃ
krém	k r eː m
kára	k aː r ɒ
képességei	k eː p ɛ ʃː eː ɡ ɛ j i
képviseleti	k eː p v i ʃ ɛ l ɛ t i
kérdéseit	k eː r d eː ʃ ɛ j i t
kéri	k eː r i
kérni	k eː r n i
készítettek	k eː s iː t ɛ tː ɛ k
késő	k eː ʃ øː
kétségbe	k eː t͡ʃː eː ɡ b ɛ
kézzel	k eː zː ɛ l
kívánjuk	k iː v aː ɲː u k
kölcsön	k ø l t͡ʃ ø n
kölcsönök	k ø l t͡ʃ ø n ø k
könyvbe	k ø ɲ v b ɛ
könyve	k ø ɲ v ɛ
könyvek	k ø ɲ v ɛ k
könyvtári	k ø ɲ f t aː r i
környékén	k ø r ɲ eː k eː n
köröcske	k ø r ø t͡ʃ k ɛ
köszönhetően	k ø s ø n ɦ ɛ t øː ɛ n
kötelezettség	k ø t ɛ l ɛ z ɛ t͡ʃː eː ɡ
kötelezettségek	k ø t ɛ l ɛ z ɛ t͡ʃː eː ɡ ɛ k
kötet	k ø t ɛ t
közepes	k ø z ɛ p ɛ ʃ
közlekedés	k ø z l ɛ k ɛ d eː ʃ
középiskolai	k ø z eː p i ʃ k o l ɒ j i
közönség	k ø z ø n ʃ eː ɡ
között	k ø z ø tː
küldje	k y l ɟ ɛ
külön	k y l ø n
küszöbe	k y s ø b ɛ
legdrágább	l ɛ ɡ d r aː ɡ aː bː
legesélyesebb	l ɛ ɡ ɛ ʃ eː j ɛ ʃ ɛ bː
leggyakrabban	l ɛ ɡ ɟ ɒ k r ɒ bː ɒ n
leginkább	l ɛ ɡ i ŋ k aː bː
legjobb	l ɛ ɡ j o bː
legkevesebb	l ɛ kː ɛ v ɛ ʃ ɛ bː
legkiemeltebb	l ɛ kː i j ɛ m ɛ l t ɛ bː
legkönnyebb	l ɛ kː ø ɲː ɛ bː
legragyogóbb	l ɛ ɡ r ɒ ɟ o ɡ oː bː
legyenek	l ɛ ɟ ɛ n ɛ k
lehetnék	l ɛ h ɛ t n eː k
lehető	l ɛ h ɛ t øː
lehetősége	l ɛ h ɛ t øː ʃ eː ɡ ɛ
lehetőségét	l ɛ h ɛ t øː ʃ eː ɡ eː t
lenne	l ɛ nː ɛ
levegőben	l ɛ v ɛ ɡ øː b ɛ n
leveleket	l ɛ v ɛ l ɛ k ɛ t
levélben	l ɛ v eː l b ɛ n
linkek	l i ŋ k ɛ k
logika	l o ɡ i k ɒ
logisztikai	l o ɡ i s t i k ɒ j i
lábán	l aː b aː n
lágy	l aː ɟ
lányt	l aː ɲ t
lássam	l aː ʃː ɒ m
látják	l aː cː aː k
légy	l eː ɟ
lét	l eː t
magamért	m ɒ ɡ ɒ m eː r t
magasak	m ɒ ɡ ɒ ʃ ɒ k
magyarországra	m ɒ ɟ ɒ r o r s aː ɡ r ɒ
magán	m ɒ ɡ aː n
megalapozott	m ɛ ɡ ɒ l ɒ p o z o tː
megbeszélések	m ɛ ɡ b ɛ s eː l eː ʃ ɛ k
megfelelően	m ɛ k f ɛ l ɛ l øː ɛ n
meghaltak	m ɛ k h ɒ l t ɒ k
meghatározott	m ɛ k h ɒ t aː r o z o tː
megkezdte	m ɛ kː ɛ s t ɛ
megoldásokat	m ɛ ɡ o l d aː ʃ o k ɒ t
megszüntetése	m ɛ k s y n t ɛ t eː ʃ ɛ
megtudni	m ɛ k t u d n i
megvizsgál	m ɛ ɡ v i ʒ ɡ aː l
megválasztott	m ɛ ɡ v aː l ɒ s t o tː
mellékes	m ɛ lː eː k ɛ ʃ
mennyből	m ɛ ɲ b øː l
mentes	m ɛ n t ɛ ʃ
menti	m ɛ n t i
mentünk	m ɛ n t y ŋ k
mezőn	m ɛ z øː n
mik	m i k
millenniumi	m i lː ɛ nː i j u m i
mindeddig	m i n d ɛ dː i ɡ
mindenben	m i n d ɛ m b ɛ n
mindenféle	m i n d ɛ ɱ f eː l ɛ
mindennek	m i n d ɛ nː ɛ k
mindkettő	m i n t k ɛ tː øː
minősítés	m i n øː ʃ iː t eː ʃ
miskolcon	m i ʃ k o l t͡s o n
miért	m i j eː r t
mocskos	m o t͡ʃ k o ʃ
modul	m o d u l
mondják	m o ɲ ɟ aː k
mondták	m o n t aː k
mosópor	m o ʃ oː p o r
motorcsónak	m o t o r t͡ʃ oː n ɒ k
munkásokat	m u ŋ k aː ʃ o k ɒ t
mutatják	m u t ɒ cː aː k
muzsikál	m u ʒ i k aː l
májusában	m aː j u ʃ aː b ɒ n
március	m aː r t͡s i j u ʃ
más	m aː ʃ
másban	m aː ʒ b ɒ n
másiknak	m aː ʃ i k n ɒ k
másnap	m aː ʃ n ɒ p
második	m aː ʃ o d i k
másoké	m aː ʃ o k eː
méltóságteljes	m eː l t oː ʃ aː k t ɛ jː ɛ ʃ
mélybe	m eː j b ɛ
mélyen	m eː j ɛ n
mérd	m eː r d
méretben	m eː r ɛ d b ɛ n
mérgező	m eː r ɡ ɛ z øː
mérni	m eː r n i
mérők	m eː r øː k
módosításáról	m oː d o ʃ iː t aː ʃ aː r oː l
múltán	m uː l t aː n
művészi	m yː v eː s i
nadrág	n ɒ d r aː ɡ
nagymama	n ɒ ɟ m ɒ m ɒ
nagyot	n ɒ ɟ o t
napból	n ɒ bː oː l
napi	n ɒ p i
napja	n ɒ p j ɒ
napján	n ɒ p j aː n
napon	n ɒ p o n
nappal	n ɒ pː ɒ l
navigáció	n ɒ v i ɡ aː t͡s i j oː
negyedszer	n ɛ ɟ ɛ t͡sː ɛ r
nemigen	n ɛ m i ɡ ɛ n
nemzeti	n ɛ m z ɛ t i
nevet	n ɛ v ɛ t
nevében	n ɛ v eː b ɛ n
novemberben	n o v ɛ m b ɛ r b ɛ n
nyilvánosság	ɲ i l v aː n o ʃː aː ɡ
nyilvánvalóvá	ɲ i l v aː ɱ v ɒ l oː v aː
nyitva	ɲ i t v ɒ
nyomai	ɲ o m ɒ j i
nyomozóiroda	ɲ o m o z oː j i r o d ɒ
nyugdíjak	ɲ u ɡ d iː j ɒ k
nádor	n aː d o r
néha	n eː ɦ ɒ
néhányan	n eː ɦ aː ɲ ɒ n
néven	n eː v ɛ n
növekedés	n ø v ɛ k ɛ d eː ʃ
növekedése	n ø v ɛ k ɛ d eː ʃ ɛ
növekedését	n ø v ɛ k ɛ d eː ʃ eː t
ok	o k
okok	o k o k
okozott	o k o z o tː
októberben	o k t oː b ɛ r b ɛ n
oldalát	o l d ɒ l aː t
olyasmi	o j ɒ ʃ m i
országút	o r s aː ɡ uː t
otthoni	o t h o n i
padon	p ɒ d o n
pelikán	p ɛ l i k aː n
percen	p ɛ r t͡s ɛ n
piacra	p i j ɒ t͡s r ɒ
pillanatig	p i lː ɒ n ɒ t i ɡ
pillanatok	p i lː ɒ n ɒ t o k
pillant	p i lː ɒ n t
polgárháború	p o l ɡ aː r ɦ aː b o r uː
politika	p o l i t i k ɒ
portás	p o r t aː ʃ
pozíciója	p o z iː t͡s i j oː j ɒ
probléma	p r o b l eː m ɒ
professzora	p r o f ɛ sː o r ɒ
profi	p r o f i
programra	p r o ɡ r ɒ m r ɒ
pszichológia	p s i ɦ o l oː ɡ i j ɒ
pupilla	p u p i lː ɒ
párduc	p aː r d u t͡s
páva	p aː v ɒ
pénzem	p eː n z ɛ m
rasszizmus	r ɒ sː i z m u ʃ
református	r ɛ f o r m aː t u ʃ
rejtély	r ɛ j t eː j
reklám	r ɛ k l aː m
reklámszoftver	r ɛ k l aː m s o f t v ɛ r
rendet	r ɛ n d ɛ t
rendszerek	r ɛ n t s ɛ r ɛ k
rendszernek	r ɛ n t s ɛ r n ɛ k
reád	r ɛ aː d
részekre	r eː s ɛ k r ɛ
részleteit	r eː s l ɛ t ɛ j i t
részletek	r eː s l ɛ t ɛ k
róna	r oː n ɒ
rögtön	r ø k t ø n
rúd	r uː d
sajtótájékoztatón	ʃ ɒ j t oː t aː j eː k o s t ɒ t oː n
sebaj	ʃ ɛ b ɒ j
segítettem	ʃ ɛ ɡ iː t ɛ tː ɛ m
segítséget	ʃ ɛ ɡ iː t͡ʃː eː ɡ ɛ t
segítése	ʃ ɛ ɡ iː t eː ʃ ɛ
segítő	ʃ ɛ ɡ iː t øː
semmiképp	ʃ ɛ mː i k eː pː
semmit	ʃ ɛ mː i t
sikerül	ʃ i k ɛ r y l
soron	ʃ o r o n
sorozatban	ʃ o r o z ɒ d b ɒ n
sorozatokat	ʃ o r o z ɒ t o k ɒ t
spirituális	ʃ p i r i t u aː l i ʃ
sport	ʃ p o r t
spárga	ʃ p aː r ɡ ɒ
statisztikai	ʃ t ɒ t i s t i k ɒ j i
strand	ʃ t r ɒ n d
szabadnak	s ɒ b ɒ d n ɒ k
szabadok	s ɒ b ɒ d o k
szabadság	s ɒ b ɒ t͡ʃː aː ɡ
szabályozás	s ɒ b aː j o z aː ʃ
szakember	s ɒ k ɛ m b ɛ r
szakrális	s ɒ k r aː l i ʃ
szakszervezeti	s ɒ k s ɛ r v ɛ z ɛ t i
szavát	s ɒ v aː t
szelleme	s ɛ lː ɛ m ɛ
szellős	s ɛ lː øː ʃ
személy	s ɛ m eː j
szentelt	s ɛ n t ɛ l t
szerda	s ɛ r d ɒ
szeretem	s ɛ r ɛ t ɛ m
szerkesztett	s ɛ r k ɛ s t ɛ tː
szervesen	s ɛ r v ɛ ʃ ɛ n
szerzetes	s ɛ r z ɛ t ɛ ʃ
szinte	s i n t ɛ
szobra	s o b r ɒ
szobát	s o b aː t
szociális	s o t͡s i j aː l i ʃ
szolgálatot	s o l ɡ aː l ɒ t o t
szolgálhat	s o l ɡ aː l ɦ ɒ t
szolgálnak	s o l ɡ aː l n ɒ k
szolnok	s o l n o k
szponzorok	s p o n z o r o k
szállítás	s aː lː iː t aː ʃ
számolja	s aː m o jː ɒ
számítástechnikai	s aː m iː t aː ʃ t ɛ x n i k ɒ j i
századi	s aː z ɒ d i
százszorszépek	s aː sː o r s eː p ɛ k
székel	s eː k ɛ l
színekben	s iː n ɛ ɡ b ɛ n
színvonalon	s iː ɱ v o n ɒ l o n
szót	s oː t
szőlő	s øː l øː
szűz	s yː z
sávos	ʃ aː v o ʃ
sávszélesség	ʃ aː f s eː l ɛ ʃː eː ɡ
sírva	ʃ iː r v ɒ
talpraesett	t ɒ l p r ɒ ɛ ʃ ɛ tː
tanfolyam	t ɒ ɱ f o j ɒ m
tantárgyak	t ɒ n t aː r ɟ ɒ k
tanácsi	t ɒ n aː t͡ʃ i
tanácskozás	t ɒ n aː t͡ʃ k o z aː ʃ
tanárok	t ɒ n aː r o k
tartalom	t ɒ r t ɒ l o m
tartana	t ɒ r t ɒ n ɒ
tavak	t ɒ v ɒ k
technikát	t ɛ x n i k aː t
technológia	t ɛ x n o l oː ɡ i j ɒ
technológiai	t ɛ x n o l oː ɡ i j ɒ j i
technológiát	t ɛ x n o l oː ɡ i j aː t
teendők	t ɛ ɛ n d øː k
tegyenek	t ɛ ɟ ɛ n ɛ k
tehetséges	t ɛ h ɛ t͡ʃː eː ɡ ɛ ʃ
tehették	t ɛ h ɛ tː eː k
tehát	t ɛ ɦ aː t
teli	t ɛ l i
teljesítenek	t ɛ jː ɛ ʃ iː t ɛ n ɛ k
teljesül	t ɛ jː ɛ ʃ y l
templom	t ɛ m p l o m
terem	t ɛ r ɛ m
természetes	t ɛ r m eː s ɛ t ɛ ʃ
természetvédelem	t ɛ r m eː s ɛ t v eː d ɛ l ɛ m
terve	t ɛ r v ɛ
területe	t ɛ r y l ɛ t ɛ
területei	t ɛ r y l ɛ t ɛ j i
testet	t ɛ ʃ t ɛ t
tetszik	t ɛ t͡sː i k
tette	t ɛ tː ɛ
tevékenységét	t ɛ v eː k ɛ ɲ ʃ eː ɡ eː t
tipikus	t i p i k u ʃ
tiszt	t i s t
titka	t i t k ɒ
titkot	t i t k o t
tojást	t o j aː ʃ t
tré	t r eː
trójai	t r oː j ɒ j i
tudatos	t u d ɒ t o ʃ
tudja	t u ɟː ɒ
tudniuk	t u d n i j u k
tudod	t u d o d
tudom	t u d o m
tudomány	t u d o m aː ɲ
tudományos	t u d o m aː ɲ o ʃ
tudsz	t u t͡sː
tudás	t u d aː ʃ
tudásukat	t u d aː ʃ u k ɒ t
táblázat	t aː b l aː z ɒ t
tájékoztató	t aː j eː k o s t ɒ t oː
támogatásokat	t aː m o ɡ ɒ t aː ʃ o k ɒ t
tárca	t aː r t͡s ɒ
tárgyaló	t aː r ɟ ɒ l oː
társulás	t aː r ʃ u l aː ʃ
távolsági	t aː v o l ʃ aː ɡ i
tél	t eː l
témája	t eː m aː j ɒ
tények	t eː ɲ ɛ k
tényező	t eː ɲ ɛ z øː
tényleges	t eː ɲ l ɛ ɡ ɛ ʃ
térséggel	t eː r ʃ eː ɡː ɛ l
tét	t eː t
többféle	t ø p f eː l ɛ
többször	t ø p s ø r
tölteni	t ø l t ɛ n i
tömegben	t ø m ɛ ɡ b ɛ n
tör	t ø r
történelmi	t ø r t eː n ɛ l m i
törvények	t ø r v eː ɲ ɛ k
túlnyomó	t uː l ɲ o m oː
túr	t uː r
tükrözi	t y k r ø z i
tükörreflexes	t y k ø rː ɛ f l ɛ k s ɛ ʃ
tőke	t øː k ɛ
ugranak	u ɡ r ɒ n ɒ k
ugyanezt	u ɟ ɒ n ɛ s t
ukrajna	u k r ɒ j n ɒ
utak	u t ɒ k
utas	u t ɒ ʃ
utat	u t ɒ t
utca	u t͡sː ɒ
utcára	u t͡sː aː r ɒ
utánoz	u t aː n o z
utólagos	u t oː l ɒ ɡ o ʃ
valamennyien	v ɒ l ɒ m ɛ ɲː i j ɛ n
valamennyiünk	v ɒ l ɒ m ɛ ɲː i j y ŋ k
valamilyen	v ɒ l ɒ m i j ɛ n
vallások	v ɒ lː aː ʃ o k
vannak	v ɒ nː ɒ k
varga	v ɒ r ɡ ɒ
vasárnap	v ɒ ʃ aː r n ɒ p
veleszületett	v ɛ l ɛ s y l ɛ t ɛ tː
vendégek	v ɛ n d eː ɡ ɛ k
vernek	v ɛ r n ɛ k
veszem	v ɛ s ɛ m
vettünk	v ɛ tː y ŋ k
vezetnek	v ɛ z ɛ t n ɛ k
vezérigazgató	v ɛ z eː r i ɡ ɒ z ɡ ɒ t oː
videót	v i d ɛ oː t
vidéki	v i d eː k i
viktor	v i k t o r
világ	v i l aː ɡ
világossá	v i l aː ɡ o ʃː aː
viszonthallásra	v i s o n t h ɒ lː aː ʃ r ɒ
vizet	v i z ɛ t
vonat	v o n ɒ t
vonták	v o n t aː k
vonzza	v o n z ɒ
vágya	v aː ɟ ɒ
választhat	v aː l ɒ s t h ɒ t
választható	v aː l ɒ s t h ɒ t oː
választások	v aː l ɒ s t aː ʃ o k
választók	v aː l ɒ s t oː k
vállalkozások	v aː lː ɒ l k o z aː ʃ o k
vállalkozó	v aː lː ɒ l k o z oː
válni	v aː l n i
válogatott	v aː l o ɡ ɒ t o tː
változat	v aː l t o z ɒ t
változást	v aː l t o z aː ʃ t
várják	v aː r j aː k
várjátok	v aː r j aː t o k
végbe	v eː ɡ b ɛ
végrehajtani	v eː ɡ r ɛ ɦ ɒ j t ɒ n i
végzetes	v eː ɡ z ɛ t ɛ ʃ
vélemény	v eː l ɛ m eː ɲ
vér	v eː r
víz	v iː z
who	v eː ɦ aː oː
zenészek	z ɛ n eː s ɛ k
zichy	z i t͡ʃ i
zárták	z aː r t aː k
állampolgári	aː lː ɒ m p o l ɡ aː r i
állnak	aː l n ɒ k
állott	aː lː o tː
álláspontját	aː lː aː ʃ p o ɲ c aː t
állítása	aː lː iː t aː ʃ ɒ
álmát	aː l m aː t
álom	aː l o m
ártatlanok	aː r t ɒ t l ɒ n o k
áru	aː r u
árut	aː r u t
áshat	aː ʃ h ɒ t
ásnak	aː ʃ n ɒ k
átkelőhely	aː t k ɛ l øː ɦ ɛ j
édesanyja	eː d ɛ ʃ ɒ ɲː ɒ
édesapja	eː d ɛ ʃ ɒ p j ɒ
élelme	eː l ɛ l m ɛ
életem	eː l ɛ t ɛ m
életmódot	eː l ɛ t m oː d o t
életveszélyes	eː l ɛ t v ɛ s eː j ɛ ʃ
életút	eː l ɛ t uː t
én	eː n
érik	eː r i k
érmünk	eː r m y ŋ k
ért	eː r t
értenek	eː r t ɛ n ɛ k
értékelés	eː r t eː k ɛ l eː ʃ
érzelmi	eː r z ɛ l m i
érzik	eː r z i k
érzékenység	eː r z eː k ɛ ɲ ʃ eː ɡ
érzés	eː r z eː ʃ
északra	eː s ɒ k r ɒ
évtized	eː f t i z ɛ d
évtizede	eː f t i z ɛ d ɛ
évvel	eː vː ɛ l
ígéretet	iː ɡ eː r ɛ t ɛ t
ígéri	iː ɡ eː r i
íjászok	iː j aː s o k
írj	iː r ʝ
írást	iː r aː ʃ t
írónő	iː r oː n øː
összes	ø sː ɛ ʃ
összesen	ø sː ɛ ʃ ɛ n
övék	ø v eː k
újból	uː j b oː l
újjászületett	uː jː aː s y l ɛ t ɛ tː
újjáépítés	uː jː aː j eː p iː t eː ʃ
újnak	uː j n ɒ k
újra	uː j r ɒ
újságban	uː j ʃ aː ɡ b ɒ n
útján	uː cː aː n
útvonal	uː t v o n ɒ l
ügyekben	y ɟ ɛ ɡ b ɛ n
ügyes	y ɟ ɛ ʃ
ügyfeleink	y c f ɛ l ɛ j i ŋ k
ügyészség	y ɟ eː ʃː eː ɡ
ült	y l t
ünnepélyes	y nː ɛ p eː j ɛ ʃ
ütközet	y t k ø z ɛ t
üzleti	y z l ɛ t i
ők	øː k
őrizetbe	øː r i z ɛ d b ɛ
őt	øː t
