<|ARM|>աբորտ	ɑ b ɔ ɾ t
<|ARM|>աբրամ	ɑ b ɾ ɑ m
<|ARM|>ագնոստիկ	ɑ ɡ n ɔ s t i k
<|ARM|>ագուցել	ɑ ɡ u t͡sʰ ɛ l
<|ARM|>ադրբեջանցի	ɑ d ə ɾ b ɛ d͡ʒ ɑ n t͡sʰ i
<|ARM|>ազդվել	ɑ z d v ɛ l
<|ARM|>ալանի	ɑ l ɑ n i
<|ARM|>ալբոմ	ɑ l b ɔ m
<|ARM|>ալեմաներեն	ɑ l ɛ m ɑ n ɛ ɾ ɛ n
<|ARM|>ալյուր	ɑ l j u ɾ
<|ARM|>ալուցք	ɑ l u t͡sʰ kʰ
<|ARM|>ախտ	ɑ χ t
<|ARM|>ակադեմիա	ɑ k ɑ d ɛ m j ɑ
<|ARM|>ակնախնձոր	ɑ k n ɑ χ ə n d͡z ɔ ɾ
<|ARM|>ակնածալից	ɑ k n ɑ t͡s ɑ l i t͡sʰ
<|ARM|>ակնաղբյուր	ɑ k n ɑ χ p j u ɾ
<|ARM|>ակնթարթ	ɑ k ə n tʰ ɑ ɾ tʰ
<|ARM|>ահ	ɑ h
<|ARM|>աղբ	ɑ χ p
<|ARM|>աղեղ	ɑ ʁ ɛ ʁ
<|ARM|>աղիողորմ	ɑ ʁ i ɔ ʁ ɔ ɾ m
<|ARM|>աղունիկ	ɑ ʁ u n i k
<|ARM|>աղջամուղջ	ɑ ʁ d͡ʒ ɑ m u ʁ d͡ʒ
<|ARM|>ամենալավ	ɑ m ɛ n ɑ l ɑ v
<|ARM|>ամերիկացի	ɑ m ɛ ɾ i k ɑ t͡sʰ i
<|ARM|>ամնիստիա	ɑ m n i s t j ɑ
<|ARM|>այծենի	ɑ j t͡s ɛ n i
<|ARM|>այնուհետեւ	ɑ j n u h ɛ t ɛ v
<|ARM|>այնտեղ	ɑ j n t ɛ ʁ
<|ARM|>անալի	ɑ n ɑ l i
<|ARM|>անակ	ɑ n ɑ k
<|ARM|>անատոլիա	ɑ n ɑ t ɔ l j ɑ
<|ARM|>անատոլիական	ɑ n ɑ t ɔ l j ɑ k ɑ n
<|ARM|>անարատ	ɑ n ɑ ɾ ɑ t
<|ARM|>անգնահատելի	ɑ ŋ ɡ ə n ɑ h ɑ t ɛ l i
<|ARM|>անդեր	ɑ n d ɛ ɾ
<|ARM|>անդրկովկասյան	ɑ n d ə ɾ k ɔ f k ɑ s j ɑ n
<|ARM|>աներձագ	ɑ n ɛ ɾ d͡z ɑ kʰ
<|ARM|>անիրավ	ɑ n i ɾ ɑ v
<|ARM|>անկարելի	ɑ ŋ k ɑ ɾ ɛ l i
<|ARM|>անհամեստություն	ɑ n h ɑ m ɛ s t u tʰ j u n
<|ARM|>անհավանական	ɑ n h ɑ v ɑ n ɑ k ɑ n
<|ARM|>անհեթեթություն	ɑ n h ɛ tʰ ɛ tʰ u tʰ j u n
<|ARM|>անմահություն	ɑ n m ɑ h u tʰ j u n
<|ARM|>անսպառ	ɑ n s p ɑ r
<|ARM|>անտոնի	ɑ n t ɔ n i
<|ARM|>աշխեն	ɑ ʃ χ ɛ n
<|ARM|>ապահովել	ɑ p ɑ h ɔ v ɛ l
<|ARM|>ապուշ	ɑ p u ʃ
<|ARM|>ապստամբել	ɑ p ə s t ɑ m b ɛ l
<|ARM|>ապօրինի	ɑ p ɔ ɾ i n i
<|ARM|>առանձին	ɑ r ɑ n d͡z i n
<|ARM|>առաջադիմական	ɑ r ɑ t͡ʃʰ ɑ d i m ɑ k ɑ n
<|ARM|>առաջացում	ɑ r ɑ t͡ʃʰ ɑ t͡sʰ u m
<|ARM|>առաջնորդել	ɑ r ɑ t͡ʃʰ n ɔ ɾ tʰ ɛ l
<|ARM|>առավելագույն	ɑ r ɑ v ɛ l ɑ ɡ u j n
<|ARM|>առաքելյան	ɑ r ɑ kʰ ɛ l j ɑ n
<|ARM|>առերես	ɑ r ɛ ɾ ɛ s
<|ARM|>առեւանգում	ɑ r ɛ v ɑ ŋ ɡ u m
<|ARM|>առկայծում	ɑ r k ɑ j t͡s u m
<|ARM|>առհավատչյա	ɑ r h ɑ v ɑ t t͡ʃʰ j ɑ
<|ARM|>առողջարան	ɑ r ɔ χ t͡ʃʰ ɑ ɾ ɑ n
<|ARM|>ասացվածք	ɑ s ɑ t͡sʰ v ɑ t͡s kʰ
<|ARM|>ասել	ɑ s ɛ l
<|ARM|>ասեղ	ɑ s ɛ ʁ
<|ARM|>ասկետիզմ	ɑ s k ɛ t i z m
<|ARM|>ասոցացնել	ɑ s ɔ t͡sʰ ɑ t͡sʰ n ɛ l
<|ARM|>աստվածաբանական	ɑ s t v ɑ t͡s ɑ b ɑ n ɑ k ɑ n
<|ARM|>աստվածաշունչ	ɑ s t v ɑ t͡s ɑ ʃ u n t͡ʃʰ
<|ARM|>ասք	ɑ s kʰ
<|ARM|>ավան	ɑ v ɑ n
<|ARM|>ավանդական	ɑ v ɑ n d ɑ k ɑ n
<|ARM|>ավարտել	ɑ v ɑ ɾ t ɛ l
<|ARM|>ավել	ɑ v ɛ l
<|ARM|>ատամնային	ɑ t ɑ m n ɑ j i n
<|ARM|>արագիլ	ɑ ɾ ɑ ɡ i l
<|ARM|>արգելել	ɑ ɾ kʰ ɛ l ɛ l
<|ARM|>արգիշտի	ɑ ɾ ɡ i ʃ t i
<|ARM|>արդարադատություն	ɑ ɾ tʰ ɑ ɾ ɑ d ɑ t u tʰ j u n
<|ARM|>արդյունաբերություն	ɑ ɾ tʰ j u n ɑ b ɛ ɾ u tʰ j u n
<|ARM|>արիստակես	ɑ ɾ i s t ɑ k ɛ s
<|ARM|>արծրուն	ɑ ɾ t͡s ɾ u n
<|ARM|>արկղ	ɑ ɾ k ə ʁ
<|ARM|>արձագանք	ɑ ɾ d͡z ɑ ɡ ɑ ŋ kʰ
<|ARM|>արմավ	ɑ ɾ m ɑ v
<|ARM|>արշիպելագ	ɑ ɾ ʃ i p ɛ l ɑ ɡ
<|ARM|>արու	ɑ ɾ u
<|ARM|>արույր	ɑ ɾ u j ɾ
<|ARM|>արսեն	ɑ ɾ s ɛ n
<|ARM|>արվեստագետ	ɑ ɾ v ɛ s t ɑ ɡ ɛ t
<|ARM|>արտահանում	ɑ ɾ t ɑ h ɑ n u m
<|ARM|>արտորայք	ɑ ɾ t ɔ ɾ ɑ j kʰ
<|ARM|>արցախ	ɑ ɾ t͡sʰ ɑ χ
<|ARM|>ափ	ɑ pʰ
<|ARM|>ափի	ɑ pʰ i
<|ARM|>աքսորել	ɑ kʰ s ɔ ɾ ɛ l
<|ARM|>բաբայան	b ɑ b ɑ j ɑ n
<|ARM|>բազմամարդ	b ɑ z m ɑ m ɑ ɾ tʰ
<|ARM|>բազմանալ	b ɑ z m ɑ n ɑ l
<|ARM|>բաժակ	b ɑ ʒ ɑ k
<|ARM|>բալ	b ɑ l
<|ARM|>բալալայկա	b ɑ l ɑ l ɑ j k ɑ
<|ARM|>բախում	b ɑ χ u m
<|ARM|>բահ	b ɑ h
<|ARM|>բաղադրիչ	b ɑ ʁ ɑ d ɾ i t͡ʃʰ
<|ARM|>բամբասանք	b ɑ m b ɑ s ɑ ŋ kʰ
<|ARM|>բայդեն	b ɑ j d ɛ n
<|ARM|>բանաստեղծուհի	b ɑ n ɑ s t ɛ χ t͡s u h i
<|ARM|>բանջար	b ɑ n d͡ʒ ɑ ɾ
<|ARM|>բարբառային	b ɑ ɾ b ɑ r ɑ j i n
<|ARM|>բարեկամություն	b ɑ ɾ ɛ k ɑ m u tʰ j u n
<|ARM|>բարձր	b ɑ ɾ t͡sʰ ə ɾ
<|ARM|>բարձրացնել	b ɑ ɾ t͡sʰ ɾ ɑ t͡sʰ n ɛ l
<|ARM|>բարձրություն	b ɑ ɾ t͡sʰ ɾ u tʰ j u n
<|ARM|>բարսեղ	b ɑ ɾ s ɛ ʁ
<|ARM|>բացորոշակի	b ɑ t͡sʰ ɔ ɾ ɔ ʃ ɑ k i
<|ARM|>բացում	b ɑ t͡sʰ u m
<|ARM|>բեթղեհեմ	b ɛ tʰ χ ɛ h ɛ m
<|ARM|>բելիսարիոս	b ɛ l i s ɑ ɾ i ɔ s
<|ARM|>բեռն	b ɛ r n
<|ARM|>բերման	b ɛ ɾ m ɑ n
<|ARM|>բիզնեսմեն	b i z n ɛ s m ɛ n
<|ARM|>բիլակ	b i l ɑ k
<|ARM|>բիֆշտեքս	b i f ʃ t ɛ kʰ s
<|ARM|>բնորոշ	b ə n ɔ ɾ ɔ ʃ
<|ARM|>բողոքարկում	b ɔ ʁ ɔ kʰ ɑ ɾ k u m
<|ARM|>բոյաջյան	b ɔ j ɑ d͡ʒ j ɑ n
<|ARM|>բու	b u
<|ARM|>բութ	b u tʰ
<|ARM|>բույլ	b u j l
<|ARM|>բուսակերություն	b u s ɑ k ɛ ɾ u tʰ j u n
<|ARM|>բռնազավթում	b ə r n ɑ z ɑ f tʰ u m
<|ARM|>բռնություն	b ə r n u tʰ j u n
<|ARM|>բրյուսել	b ɾ j u s ɛ l
<|ARM|>բրոնզ	b ə ɾ ɔ n z
<|ARM|>գազանանոց	ɡ ɑ z ɑ n ɑ n ɔ t͡sʰ
<|ARM|>գաղափար	ɡ ɑ ʁ ɑ pʰ ɑ ɾ
<|ARM|>գամիրք	ɡ ɑ m i ɾ kʰ
<|ARM|>գաջ	ɡ ɑ d͡ʒ
<|ARM|>գավիթ	ɡ ɑ v i tʰ
<|ARM|>գավոտ	ɡ ɑ v ɔ t
<|ARM|>գարնանային	ɡ ɑ ɾ n ɑ n ɑ j i n
<|ARM|>գարշել	ɡ ɑ ɾ ʃ ɛ l
<|ARM|>գեղամ	ɡ ɛ ʁ ɑ m
<|ARM|>գեղանի	ɡ ɛ ʁ ɑ n i
<|ARM|>գեղոն	ɡ ɛ ʁ ɔ n
<|ARM|>գեներալ	ɡ ɛ n ɛ ɾ ɑ l
<|ARM|>գերազանցություն	ɡ ɛ ɾ ɑ z ɑ n t͡sʰ u tʰ j u n
<|ARM|>գերմաներեն	ɡ ɛ ɾ m ɑ n ɛ ɾ ɛ n
<|ARM|>գթություն	ɡ ə tʰ u tʰ j u n
<|ARM|>գինդ	ɡ i n d
<|ARM|>գիշերօթիկ	ɡ i ʃ ɛ ɾ ɔ tʰ i k
<|ARM|>գիտակից	ɡ i t ɑ k i t͡sʰ
<|ARM|>գիտենալ	ɡ i t ɛ n ɑ l
<|ARM|>գիր	ɡ i ɾ
<|ARM|>գողունի	ɡ ɔ ʁ u n i
<|ARM|>գոմաղբ	ɡ ɔ m ɑ χ p
<|ARM|>գոռալ	ɡ ɔ r ɑ l
<|ARM|>գոռոզություն	ɡ ɔ r ɔ z u tʰ j u n
<|ARM|>գորիս	ɡ ɔ ɾ i s
<|ARM|>գործելաոճ	ɡ ɔ ɾ t͡s ɛ l ɑ v ɔ t͡ʃ
<|ARM|>գործիչ	ɡ ɔ ɾ t͡s i t͡ʃʰ
<|ARM|>գունդ	ɡ u n d
<|ARM|>գտածո	ɡ ə t ɑ t͡s ɔ
<|ARM|>գրական	ɡ ə ɾ ɑ k ɑ n
<|ARM|>գրանցում	ɡ ə ɾ ɑ n t͡sʰ u m
<|ARM|>գրատախտակ	ɡ ə ɾ ɑ t ɑ χ t ɑ k
<|ARM|>գրգռված	ɡ ə ɾ ɡ ə r v ɑ t͡s
<|ARM|>գրիչ	ɡ ə ɾ i t͡ʃʰ
<|ARM|>գրիպ	ɡ ə ɾ i p
<|ARM|>դադար	d ɑ tʰ ɑ ɾ
<|ARM|>դահլիճ	d ɑ h l i t͡ʃ
<|ARM|>դաշնակցական	d ɑ ʃ n ɑ k t͡sʰ ɑ k ɑ n
<|ARM|>դատարկաձեռն	d ɑ t ɑ ɾ k ɑ d͡z ɛ r ə n
<|ARM|>դատարկել	d ɑ t ɑ ɾ k ɛ l
<|ARM|>դեղին	d ɛ ʁ i n
<|ARM|>դեպի	d ɛ p i
<|ARM|>դիմորդ	d i m ɔ ɾ tʰ
<|ARM|>դիպլոմ	d i p l ɔ m
<|ARM|>դիպուկ	d i p u k
<|ARM|>դիսերտացիա	d i s ɛ ɾ t ɑ t͡sʰ j ɑ
<|ARM|>դիսկոտեկ	d i s k ɔ t ɛ k
<|ARM|>դիվանագետ	d i v ɑ n ɑ ɡ ɛ t
<|ARM|>դհոլ	d ə h ɔ l
<|ARM|>դոլար	d ɔ l ɑ ɾ
<|ARM|>դոհա	d ɔ h ɑ
<|ARM|>դուխ	d u χ
<|ARM|>դուշանբե	d u ʃ ɑ n b ɛ
<|ARM|>դրություն	d ə ɾ u tʰ j u n
<|ARM|>եահկ	j ɛ ɑ h ə k ə
<|ARM|>ելակ	j ɛ l ɑ k
<|ARM|>ելիզավետա	j ɛ l i z ɑ v ɛ t ɑ
<|ARM|>եկբատան	j ɛ k b ɑ t ɑ n
<|ARM|>եղիշե	j ɛ ʁ i ʃ ɛ
<|ARM|>են	ɛ n
<|ARM|>ենթադրյալ	j ɛ n tʰ ɑ d ə ɾ j ɑ l
<|ARM|>ենթակայան	j ɛ n tʰ ɑ k ɑ j ɑ n
<|ARM|>ենիսեյ	j ɛ n i s ɛ j
<|ARM|>եռալ	j ɛ r ɑ l
<|ARM|>եռանդագին	j ɛ r ɑ n d ɑ ɡ i n
<|ARM|>եռացում	j ɛ r ɑ t͡sʰ u m
<|ARM|>եվրահանձնաժողով	j ɛ v ɾ ɑ h ɑ n d͡z n ɑ ʒ ɔ ʁ ɔ v
<|ARM|>երանի	j ɛ ɾ ɑ n i
<|ARM|>երբեմնի	j ɛ ɾ pʰ ɛ m n i
<|ARM|>երգ	j ɛ ɾ kʰ
<|ARM|>երգահան	j ɛ ɾ kʰ ɑ h ɑ n
<|ARM|>երգեցիկ	j ɛ ɾ kʰ ɛ t͡sʰ i k
<|ARM|>երգի	j ɛ ɾ kʰ i
<|ARM|>երդվյալ	j ɛ ɾ tʰ v j ɑ l
<|ARM|>երեւակայել	j ɛ ɾ ɛ v ɑ k ɑ j ɛ l
<|ARM|>երեւան	j ɛ ɾ ɛ v ɑ n
<|ARM|>երիվար	j ɛ ɾ i v ɑ ɾ
<|ARM|>երկաթուղային	j ɛ ɾ k ɑ tʰ u ʁ ɑ j i n
<|ARM|>երկնագույն	j ɛ ɾ k n ɑ ɡ u j n
<|ARM|>երկչոտ	j ɛ ɾ k t͡ʃʰ ɔ t
<|ARM|>զանազան	z ɑ n ɑ z ɑ n
<|ARM|>զավակ	z ɑ v ɑ k
<|ARM|>զավտրիկ	z ɑ f t ɾ i k
<|ARM|>զաքարյան	z ɑ kʰ ɑ ɾ j ɑ n
<|ARM|>զեռուն	z ɛ r u n
<|ARM|>զիբիլանոց	z i b i l ɑ n ɔ t͡sʰ
<|ARM|>զինվել	z i n v ɛ l
<|ARM|>զինվոր	z i n v ɔ ɾ
<|ARM|>զոդել	z ɔ d ɛ l
<|ARM|>զոհ	z ɔ h
<|ARM|>զոռով	z ɔ r ɔ v
<|ARM|>զվարճանալ	z ə v ɑ ɾ t͡ʃ ɑ n ɑ l
<|ARM|>էթիկա	ɛ tʰ i k ɑ
<|ARM|>էլեկտրոլիզ	ɛ l ɛ k t ɾ ɔ l i z
<|ARM|>էրե	ɛ ɾ ɛ
<|ARM|>էրիկ	ɛ ɾ i k
<|ARM|>ընդերք	ə n d ɛ ɾ kʰ
<|ARM|>ընդհանրական	ə n tʰ h ɑ n ɾ ɑ k ɑ n
<|ARM|>ընդունակություն	ə n tʰ u n ɑ k u tʰ j u n
<|ARM|>ընդունված	ə n tʰ u n v ɑ t͡s
<|ARM|>ընկերուհի	ə ŋ k ɛ ɾ u h i
<|ARM|>ընկճվել	ə ŋ k ə t͡ʃ v ɛ l
<|ARM|>ընկնել	ə ŋ k n ɛ l
<|ARM|>ընտրություն	ə n t ɾ u tʰ j u n
<|ARM|>ընտրվել	ə n t ə ɾ v ɛ l
<|ARM|>թագ	tʰ ɑ ɡ
<|ARM|>թաղ	tʰ ɑ ʁ
<|ARM|>թառել	tʰ ɑ r ɛ l
<|ARM|>թարգման	tʰ ɑ ɾ kʰ m ɑ n
<|ARM|>թարմ	tʰ ɑ ɾ m
<|ARM|>թեկնածու	tʰ ɛ k n ɑ t͡s u
<|ARM|>թեհրան	tʰ ɛ h ɾ ɑ n
<|ARM|>թեղի	tʰ ɛ ʁ i
<|ARM|>թեյնիկ	tʰ ɛ j n i k
<|ARM|>թենիս	tʰ ɛ n i s
<|ARM|>թերթոն	tʰ ɛ ɾ tʰ ɔ n
<|ARM|>թեքել	tʰ ɛ kʰ ɛ l
<|ARM|>թթի	tʰ ə tʰ i
<|ARM|>թթխմոր	tʰ ə tʰ χ ə m ɔ ɾ
<|ARM|>թխկի	tʰ ə χ k i
<|ARM|>թորգոմ	tʰ ɔ ɾ ɡ ɔ m
<|ARM|>թորիծ	tʰ ɔ ɾ i t͡s
<|ARM|>թորոս	tʰ ɔ ɾ ɔ s
<|ARM|>թուխ	tʰ u χ
<|ARM|>թուրք	tʰ u ɾ kʰ
<|ARM|>թոք	tʰ ɔ kʰ
<|ARM|>թվարկել	tʰ ə v ɑ ɾ k ɛ l
<|ARM|>թրեւ	tʰ ə ɾ ɛ v
<|ARM|>թրթնջուկ	tʰ ə ɾ tʰ ə n d͡ʒ u k
<|ARM|>ժապավեն	ʒ ɑ p ɑ v ɛ n
<|ARM|>ժառանգ	ʒ ɑ r ɑ ŋ ɡ
<|ARM|>ժխտական	ʒ ə χ t ɑ k ɑ n
<|ARM|>ինձանով	i n d͡z ɑ n ɔ v
<|ARM|>ինքնաթափ	i ŋ kʰ n ɑ tʰ ɑ pʰ
<|ARM|>ինքնաշարժ	i ŋ kʰ n ɑ ʃ ɑ ɾ ʒ
<|ARM|>իրողություն	i ɾ ɔ ʁ u tʰ j u n
<|ARM|>լավա	l ɑ v ɑ
<|ARM|>լեհաստան	l ɛ h ɑ s t ɑ n
<|ARM|>լեռնային	l ɛ r n ɑ j i n
<|ARM|>լի	l i
<|ARM|>լիմուզին	l i m u z i n
<|ARM|>լիտր	l i t ə ɾ
<|ARM|>լիքը	l i kʰ ə
<|ARM|>լոգանք	l ɔ ɡ ɑ ŋ kʰ
<|ARM|>լոգարան	l ɔ ɡ ɑ ɾ ɑ n
<|ARM|>լոթարինգացի	l ɔ tʰ ɑ ɾ i ŋ ɡ ɑ t͡sʰ i
<|ARM|>լուռ	l u r
<|ARM|>լուսամուտ	l u s ɑ m u t
<|ARM|>լուսան	l u s ɑ n
<|ARM|>լուսավոր	l u s ɑ v ɔ ɾ
<|ARM|>լուսինե	l u s i n ɛ
<|ARM|>լռություն	l ə r u tʰ j u n
<|ARM|>լրագրող	l ə ɾ ɑ ɡ ə ɾ ɔ ʁ
<|ARM|>խաթաբալա	χ ɑ tʰ ɑ b ɑ l ɑ
<|ARM|>խածանել	χ ɑ t͡s ɑ n ɛ l
<|ARM|>խանդել	χ ɑ n d ɛ l
<|ARM|>խարիսխ	χ ɑ ɾ i s χ
<|ARM|>խարտոց	χ ɑ ɾ t ɔ t͡sʰ
<|ARM|>խեթել	χ ɛ tʰ ɛ l
<|ARM|>խզել	χ ə z ɛ l
<|ARM|>խլություն	χ ə l u tʰ j u n
<|ARM|>խոթել	χ ɔ tʰ ɛ l
<|ARM|>խոհանոց	χ ɔ h ɑ n ɔ t͡sʰ
<|ARM|>խոշորացույց	χ ɔ ʃ ɔ ɾ ɑ t͡sʰ u j t͡sʰ
<|ARM|>խոսք	χ ɔ s kʰ
<|ARM|>խորենացի	χ ɔ ɾ ɛ n ɑ t͡sʰ i
<|ARM|>խորհրդական	χ ɔ ɾ ə ɾ tʰ ɑ k ɑ n
<|ARM|>խորհրդատու	χ ɔ ɾ ə ɾ tʰ ɑ t u
<|ARM|>խորշ	χ ɔ ɾ ʃ
<|ARM|>խորվաթ	χ ɔ ɾ v ɑ tʰ
<|ARM|>խունտա	χ u n t ɑ
<|ARM|>խուփ	χ u pʰ
<|ARM|>խրամ	χ ə ɾ ɑ m
<|ARM|>ծագում	t͡s ɑ kʰ u m
<|ARM|>ծախ	t͡s ɑ χ
<|ARM|>ծախված	t͡s ɑ χ v ɑ t͡s
<|ARM|>ծայրաքաղաք	t͡s ɑ j ɾ ɑ kʰ ɑ ʁ ɑ kʰ
<|ARM|>ծանրաձող	t͡s ɑ n ɾ ɑ d͡z ɔ ʁ
<|ARM|>ծառայող	t͡s ɑ r ɑ j ɔ ʁ
<|ARM|>ծեծել	t͡s ɛ t͡s ɛ l
<|ARM|>ծես	t͡s ɛ s
<|ARM|>ծիտ	t͡s i t
<|ARM|>ծոռ	t͡s ɔ r
<|ARM|>ծով	t͡s ɔ v
<|ARM|>ծուղակ	t͡s u ʁ ɑ k
<|ARM|>ծրագրել	t͡s ə ɾ ɑ ɡ ɾ ɛ l
<|ARM|>կադմիում	k ɑ d m i j u m
<|ARM|>կազակ	k ɑ z ɑ k
<|ARM|>կաթնով	k ɑ tʰ n ɔ v
<|ARM|>կակաչ	k ɑ k ɑ t͡ʃʰ
<|ARM|>կաղկանձ	k ɑ χ k ɑ n d͡z
<|ARM|>կամակոր	k ɑ m ɑ k ɔ ɾ
<|ARM|>կամավոր	k ɑ m ɑ v ɔ ɾ
<|ARM|>կամաց	k ɑ m ɑ t͡sʰ
<|ARM|>կամերուն	k ɑ m ɛ ɾ u n
<|ARM|>կամուրջ	k ɑ m u ɾ d͡ʒ
<|ARM|>կայանալ	k ɑ j ɑ n ɑ l
<|ARM|>կայծառ	k ɑ j t͡s ɑ r
<|ARM|>կանադական	k ɑ n ɑ d ɑ k ɑ n
<|ARM|>կանոնավոր	k ɑ n ɔ n ɑ v ɔ ɾ
<|ARM|>կաշկանդ	k ɑ ʃ k ɑ n d
<|ARM|>կապարճ	k ɑ p ɑ ɾ t͡ʃ
<|ARM|>կապուտակ	k ɑ p u t ɑ k
<|ARM|>կապտուկ	k ɑ p t u k
<|ARM|>կառավարում	k ɑ r ɑ v ɑ ɾ u m
<|ARM|>կառուցում	k ɑ r u t͡sʰ u m
<|ARM|>կասկարա	k ɑ s k ɑ ɾ ɑ
<|ARM|>կավիճ	k ɑ v i t͡ʃ
<|ARM|>կատաստրոֆա	k ɑ t ɑ s t ɾ ɔ f ɑ
<|ARM|>կատմանդու	k ɑ t m ɑ n d u
<|ARM|>կարայան	k ɑ ɾ ɑ j ɑ n
<|ARM|>կարգ	k ɑ ɾ kʰ
<|ARM|>կարելիա	k ɑ ɾ ɛ l j ɑ
<|ARM|>կարեկցաշարժ	k ɑ ɾ ɛ k t͡sʰ ɑ ʃ ɑ ɾ ʒ
<|ARM|>կարեկցում	k ɑ ɾ ɛ k t͡sʰ u m
<|ARM|>կարծր	k ɑ ɾ t͡s ə ɾ
<|ARM|>կարճառոտաբար	k ɑ ɾ t͡ʃ ɑ r ɔ t ɑ b ɑ ɾ
<|ARM|>կարմրուկ	k ɑ ɾ m ɾ u k
<|ARM|>կաֆե	k ɑ f ɛ
<|ARM|>կելտական	k ɛ l t ɑ k ɑ n
<|ARM|>կետադրություն	k ɛ t ɑ d ɾ u tʰ j u n
<|ARM|>կերակուր	k ɛ ɾ ɑ k u ɾ
<|ARM|>կթել	k ə tʰ ɛ l
<|ARM|>կիզել	k i z ɛ l
<|ARM|>կինո	k i n ɔ
<|ARM|>կիպրոս	k i p ɾ ɔ s
<|ARM|>կիսաֆաբրիկատ	k i s ɑ f ɑ b ɾ i k ɑ t
<|ARM|>կիտել	k i t ɛ l
<|ARM|>կիրով	k i ɾ ɔ v
<|ARM|>կյուրոս	k j u ɾ ɔ s
<|ARM|>կնճիռ	k ə n t͡ʃ i r
<|ARM|>կոկորդ	k ɔ k ɔ ɾ tʰ
<|ARM|>կոկտեյլ	k ɔ k t ɛ j l
<|ARM|>կոմունիզմ	k ɔ m u n i z m
<|ARM|>կոմպոնենտ	k ɔ m p ɔ n ɛ n t
<|ARM|>կոնսոլիդացիա	k ɔ n s ɔ l i d ɑ t͡sʰ j ɑ
<|ARM|>կոնստրուկտիվ	k ɔ n s t ɾ u k t i v
<|ARM|>կոշիկ	k ɔ ʃ i k
<|ARM|>կովլակ	k ɔ v l ɑ k
<|ARM|>կոտրել	k ɔ t ɾ ɛ l
<|ARM|>կորեա	k ɔ ɾ ɛ ɑ
<|ARM|>կործել	k ɔ ɾ t͡s ɛ l
<|ARM|>կորցնել	k ɔ ɾ t͡sʰ n ɛ l
<|ARM|>կուլտուրա	k u l t u ɾ ɑ
<|ARM|>կուխնի	k u χ n i
<|ARM|>կույր	k u j ɾ
<|ARM|>կռնակ	k ə r n ɑ k
<|ARM|>կտոր	k ə t ɔ ɾ
<|ARM|>կտրական	k ə t ɾ ɑ k ɑ n
<|ARM|>կրել	k ə ɾ ɛ l
<|ARM|>կրիկետ	k ɾ i k ɛ t
<|ARM|>կրծող	k ə ɾ t͡s ɔ ʁ
<|ARM|>կրճատում	k ə ɾ t͡ʃ ɑ t u m
<|ARM|>հագել	h ɑ ɡ ɛ l
<|ARM|>հազարամյակ	h ɑ z ɑ ɾ ɑ m j ɑ k
<|ARM|>հաղթական	h ɑ χ tʰ ɑ k ɑ n
<|ARM|>հաղթանակ	h ɑ χ tʰ ɑ n ɑ k
<|ARM|>հաճել	h ɑ t͡ʃ ɛ l
<|ARM|>համակարգչային	h ɑ m ɑ k ɑ ɾ kʰ t͡ʃʰ ɑ j i n
<|ARM|>համամարդկային	h ɑ m ɑ m ɑ ɾ tʰ k ɑ j i n
<|ARM|>համաշխարհային	h ɑ m ɑ ʃ χ ɑ ɾ ɑ j i n
<|ARM|>համապատասխան	h ɑ m ɑ p ɑ t ɑ s χ ɑ n
<|ARM|>համատարած	h ɑ m ɑ t ɑ ɾ ɑ t͡s
<|ARM|>համաքաղաքացի	h ɑ m ɑ kʰ ɑ ʁ ɑ kʰ ɑ t͡sʰ i
<|ARM|>համբալ	h ɑ m b ɑ l
<|ARM|>համբուրգ	h ɑ m b u ɾ ɡ
<|ARM|>համեստաբար	h ɑ m ɛ s t ɑ b ɑ ɾ
<|ARM|>համերաշխ	h ɑ m ɛ ɾ ɑ ʃ χ
<|ARM|>համերգասրահ	h ɑ m ɛ ɾ ɡ ɑ s ə ɾ ɑ h
<|ARM|>համոզմունք	h ɑ m ɔ z m u ŋ kʰ
<|ARM|>հայեցակարգ	h ɑ j ɛ t͡sʰ ɑ k ɑ ɾ kʰ
<|ARM|>հայկյան	h ɑ j k j ɑ n
<|ARM|>հայտարարություն	h ɑ j t ɑ ɾ ɑ ɾ u tʰ j u n
<|ARM|>հանգստանալ	h ɑ ŋ ɡ ə s t ɑ n ɑ l
<|ARM|>հանդ	h ɑ n d
<|ARM|>հանդիպել	h ɑ n d i p ɛ l
<|ARM|>հանձինս	h ɑ n d͡z i n ə s
<|ARM|>հաշմանդամություն	h ɑ ʃ m ɑ n d ɑ m u tʰ j u n
<|ARM|>հապավում	h ɑ p ɑ v u m
<|ARM|>հասարակություն	h ɑ s ɑ ɾ ɑ k u tʰ j u n
<|ARM|>հասու	h ɑ s u
<|ARM|>հավատարմագրել	h ɑ v ɑ t ɑ ɾ m ɑ ɡ ɾ ɛ l
<|ARM|>հավաքածու	h ɑ v ɑ kʰ ɑ t͡s u
<|ARM|>հարկահավաք	h ɑ ɾ k ɑ h ɑ v ɑ kʰ
<|ARM|>հարուստ	h ɑ ɾ u s t
<|ARM|>հարցազրույց	h ɑ ɾ t͡sʰ ɑ z ɾ u j t͡sʰ
<|ARM|>հարցում	h ɑ ɾ t͡sʰ u m
<|ARM|>հացահատիկ	h ɑ t͡sʰ ɑ h ɑ t i k
<|ARM|>հացի	h ɑ t͡sʰ i
<|ARM|>հեթում	h ɛ tʰ u m
<|ARM|>հեշտոցային	h ɛ ʃ t ɔ t͡sʰ ɑ j i n
<|ARM|>հետեւ	h ɛ t ɛ v
<|ARM|>հետմահու	h ɛ t m ɑ h u
<|ARM|>հետք	h ɛ t kʰ
<|ARM|>հիման	h i m ɑ n
<|ARM|>հյուրերին	h j u ɾ ɛ ɾ i n
<|ARM|>հնագետ	h ə n ɑ ɡ ɛ t
<|ARM|>հնազանդվել	h ə n ɑ z ɑ n d v ɛ l
<|ARM|>հոգ	h ɔ kʰ
<|ARM|>հոգս	h ɔ kʰ s
<|ARM|>հոն	h ɔ n
<|ARM|>հով	h ɔ v
<|ARM|>հորթ	h ɔ ɾ tʰ
<|ARM|>հուդզոն	h u d z ɔ n
<|ARM|>հույզ	h u j z
<|ARM|>հուսալքված	h u s ɑ l ə kʰ v ɑ t͡s
<|ARM|>հուսահատ	h u s ɑ h ɑ t
<|ARM|>հրապարակավ	h ɾ ɑ p ɑ ɾ ɑ k ɑ v
<|ARM|>հրել	h ə ɾ ɛ l
<|ARM|>հրեշտակ	h ə ɾ ɛ ʃ t ɑ k
<|ARM|>հրճվել	h ə ɾ t͡ʃ v ɛ l
<|ARM|>հրուշակագործ	h ə ɾ u ʃ ɑ k ɑ ɡ ɔ ɾ t͡s
<|ARM|>ձախլիկ	d͡z ɑ χ l i k
<|ARM|>ձաղկել	d͡z ɑ χ k ɛ l
<|ARM|>ձայն	d͡z ɑ j n
<|ARM|>ձիրք	d͡z i ɾ kʰ
<|ARM|>ղարավաշ	ʁ ɑ ɾ ɑ v ɑ ʃ
<|ARM|>ղարս	ʁ ɑ ɾ s
<|ARM|>ճախրել	t͡ʃ ɑ χ ɾ ɛ l
<|ARM|>ճահիճ	t͡ʃ ɑ h i t͡ʃ
<|ARM|>ճայ	t͡ʃ ɑ j
<|ARM|>ճանապարհորդել	t͡ʃ ɑ n ɑ p ɑ ɾ ɔ ɾ tʰ ɛ l
<|ARM|>ճանդան	t͡ʃ ɑ n d ɑ n
<|ARM|>ճանճ	t͡ʃ ɑ n t͡ʃ
<|ARM|>ճարահատ	t͡ʃ ɑ ɾ ɑ h ɑ t
<|ARM|>ճիզվիտ	t͡ʃ i z v i t
<|ARM|>ճյուղ	t͡ʃ j u ʁ
<|ARM|>մա	m ɑ
<|ARM|>մազ	m ɑ z
<|ARM|>մաթեմատիկա	m ɑ tʰ ɛ m ɑ t i k ɑ
<|ARM|>մահակ	m ɑ h ɑ k
<|ARM|>մահիճ	m ɑ h i t͡ʃ
<|ARM|>մամլյուք	m ɑ m l j u kʰ
<|ARM|>մամուլի	m ɑ m u l i
<|ARM|>մայիս	m ɑ j i s
<|ARM|>մայիսյան	m ɑ j i s j ɑ n
<|ARM|>մայրասպան	m ɑ j ɾ ɑ s p ɑ n
<|ARM|>մայրի	m ɑ j ɾ i
<|ARM|>մայրուղի	m ɑ j ɾ u ʁ i
<|ARM|>մանագուա	m ɑ n ɑ ɡ u ɑ
<|ARM|>մանթապուր	m ɑ n tʰ ɑ p u ɾ
<|ARM|>մանկասար	m ɑ ŋ k ɑ s ɑ ɾ
<|ARM|>մանր	m ɑ n ə ɾ
<|ARM|>մաշիկ	m ɑ ʃ i k
<|ARM|>մարգարեություն	m ɑ ɾ kʰ ɑ ɾ ɛ j u tʰ j u n
<|ARM|>մարդահամար	m ɑ ɾ tʰ ɑ h ɑ m ɑ ɾ
<|ARM|>մարզ	m ɑ ɾ z
<|ARM|>մարտին	m ɑ ɾ t i n
<|ARM|>մաքառում	m ɑ kʰ ɑ r u m
<|ARM|>մաքուր	m ɑ kʰ u ɾ
<|ARM|>մաքսատուրք	m ɑ kʰ s ɑ t u ɾ kʰ
<|ARM|>մելիտենե	m ɛ l i t ɛ n ɛ
<|ARM|>մեծարգո	m ɛ t͡s ɑ ɾ ɡ ɔ
<|ARM|>մեղմ	m ɛ ʁ m
<|ARM|>մեջ	m ɛ t͡ʃʰ
<|ARM|>մեռնել	m ɛ r n ɛ l
<|ARM|>մերկանալ	m ɛ ɾ k ɑ n ɑ l
<|ARM|>մերսի	m ɛ ɾ s i
<|ARM|>մեքսիկա	m ɛ kʰ s i k ɑ
<|ARM|>մեքքա	m ɛ kʰː ɑ
<|ARM|>մը	m ə
<|ARM|>մթոմ	m ə tʰ ɔ m
<|ARM|>միմներմոս	m i m n ɛ ɾ m ɔ s
<|ARM|>միջինասիական	m i t͡ʃʰ i n ɑ s j ɑ k ɑ n
<|ARM|>միրուք	m i ɾ u kʰ
<|ARM|>մխիթարել	m ə χ i tʰ ɑ ɾ ɛ l
<|ARM|>մխիթարյան	m ə χ i tʰ ɑ ɾ j ɑ n
<|ARM|>մյունխեն	m j u n χ ɛ n
<|ARM|>մնաք	m ə n ɑ kʰ
<|ARM|>մշտապես	m ə ʃ t ɑ p ɛ s
<|ARM|>մոլեկուլ	m ɔ l ɛ k u l
<|ARM|>մոլեկուլային	m ɔ l ɛ k u l ɑ j i n
<|ARM|>մոլորել	m ɔ l ɔ ɾ ɛ l
<|ARM|>մոնղոլիա	m ɔ n ʁ ɔ l j ɑ
<|ARM|>մոշի	m ɔ ʃ i
<|ARM|>մովսես	m ɔ f s ɛ s
<|ARM|>մուշտակ	m u ʃ t ɑ k
<|ARM|>մսագործ	m ə s ɑ ɡ ɔ ɾ t͡s
<|ARM|>մսեղեն	m ə s ɛ ʁ ɛ n
<|ARM|>մտահոգ	m ə t ɑ h ɔ ɡ
<|ARM|>մտահոգություն	m ə t ɑ h ɔ kʰ u tʰ j u n
<|ARM|>մտահոգվել	m ə t ɑ h ɔ kʰ v ɛ l
<|ARM|>մրջյուն	m ə ɾ t͡ʃʰ j u n
<|ARM|>յալթա	j ɑ l tʰ ɑ
<|ARM|>յոգ	j ɔ ɡ
<|ARM|>յոթներյակ	j ɔ tʰ n ɛ ɾ j ɑ k
<|ARM|>յուրահատուկ	j u ɾ ɑ h ɑ t u k
<|ARM|>նաեւ	n ɑ j ɛ v
<|ARM|>նախագծել	n ɑ χ ɑ ɡ ə t͡s ɛ l
<|ARM|>նայած	n ɑ j ɑ t͡s
<|ARM|>նանի	n ɑ n i
<|ARM|>նաջարյան	n ɑ d͡ʒ ɑ ɾ j ɑ n
<|ARM|>նավակատիք	n ɑ v ɑ k ɑ t i kʰ
<|ARM|>նավահանգիստ	n ɑ v ɑ h ɑ ŋ ɡ i s t
<|ARM|>նեգատիվ	n ɛ ɡ ɑ t i v
<|ARM|>նեգրի	n ɛ ɡ ɾ i
<|ARM|>նեխած	n ɛ χ ɑ t͡s
<|ARM|>նեպտուն	n ɛ p t u n
<|ARM|>ներգաղթ	n ɛ ɾ ɡ ɑ χ tʰ
<|ARM|>ներդաշնակ	n ɛ ɾ d ɑ ʃ n ɑ k
<|ARM|>ներդնել	n ɛ ɾ d ə n ɛ l
<|ARM|>նզովք	n ə z ɔ f kʰ
<|ARM|>նիկել	n i k ɛ l
<|ARM|>նիստուկաց	n i s t u k ɑ t͡sʰ
<|ARM|>նկուն	n ə k u n
<|ARM|>նշան	n ə ʃ ɑ n
<|ARM|>նշանագետ	n ə ʃ ɑ n ɑ ɡ ɛ t
<|ARM|>նշանյան	n ə ʃ ɑ n j ɑ n
<|ARM|>նշմարել	n ə ʃ m ɑ ɾ ɛ l
<|ARM|>նոյեմբեր	n ɔ j ɛ m b ɛ ɾ
<|ARM|>նոր	n ɔ ɾ
<|ARM|>նպաստավոր	n ə p ɑ s t ɑ v ɔ ɾ
<|ARM|>նռնակ	n ə r n ɑ k
<|ARM|>նռնականետ	n ə r n ɑ k ɑ n ɛ t
<|ARM|>նվիրում	n ə v i ɾ u m
<|ARM|>շագանակ	ʃ ɑ ɡ ɑ n ɑ k
<|ARM|>շաղգամ	ʃ ɑ χ k ɑ m
<|ARM|>շայբա	ʃ ɑ j b ɑ
<|ARM|>շարժում	ʃ ɑ ɾ ʒ u m
<|ARM|>շեկ	ʃ ɛ k
<|ARM|>շեն	ʃ ɛ n
<|ARM|>շեփոր	ʃ ɛ pʰ ɔ ɾ
<|ARM|>շիշ	ʃ i ʃ
<|ARM|>շնորհավորել	ʃ n ɔ ɾ ɑ v ɔ ɾ ɛ l
<|ARM|>շողոտ	ʃ ɔ ʁ ɔ t
<|ARM|>շուտափույթ	ʃ u t ɑ pʰ u j tʰ
<|ARM|>շոֆեր	ʃ ɔ f ɛ ɾ
<|ARM|>շվեդ	ʃ ə v ɛ d
<|ARM|>շտաբ	ə ʃ t ɑ b
<|ARM|>շրթներկ	ʃ ə ɾ tʰ n ɛ ɾ k
<|ARM|>շքերթ	ʃ ə kʰ ɛ ɾ tʰ
<|ARM|>ոգեշնչում	v ɔ kʰ ɛ ʃ ə n t͡ʃʰ u m
<|ARM|>ոգեւորություն	v ɔ kʰ ɛ v ɔ ɾ u tʰ j u n
<|ARM|>ոգեւորվել	v ɔ kʰ ɛ v ɔ ɾ v ɛ l
<|ARM|>ողնաշար	v ɔ ʁ n ɑ ʃ ɑ ɾ
<|ARM|>ոճ	v ɔ t͡ʃ
<|ARM|>ոսկեդրամ	v ɔ s k ɛ d ɾ ɑ m
<|ARM|>ոսպ	v ɔ s p
<|ARM|>ոստիկանապետ	v ɔ s t i k ɑ n ɑ p ɛ t
<|ARM|>որպեսզի	v ɔ ɾ p ɛ s z i
<|ARM|>որջ	v ɔ ɾ t͡ʃʰ
<|ARM|>ութ	u tʰ
<|ARM|>ուկրաինական	u k ɾ ɑ i n ɑ k ɑ n
<|ARM|>ունաբ	u n ɑ b
<|ARM|>ուռհա	u r h ɑ
<|ARM|>ուրախակից	u ɾ ɑ χ ɑ k i t͡sʰ
<|ARM|>ուրախացնել	u ɾ ɑ χ ɑ t͡sʰ n ɛ l
<|ARM|>ուրբաթ	u ɾ pʰ ɑ tʰ
<|ARM|>ուրու	u ɾ u
<|ARM|>ուրց	u ɾ t͡sʰ
<|ARM|>չայ	t͡ʃʰ ɑ j
<|ARM|>չան	t͡ʃʰ ɑ n
<|ARM|>չարախոս	t͡ʃʰ ɑ ɾ ɑ χ ɔ s
<|ARM|>չարաչք	t͡ʃʰ ɑ ɾ ɑ t͡ʃʰ kʰ
<|ARM|>չափել	t͡ʃʰ ɑ pʰ ɛ l
<|ARM|>չեխ	t͡ʃʰ ɛ χ
<|ARM|>չեչեն	t͡ʃʰ ɛ t͡ʃʰ ɛ n
<|ARM|>չորավուն	t͡ʃʰ ɔ ɾ ɑ v u n
<|ARM|>չորթան	t͡ʃʰ ɔ ɾ tʰ ɑ n
<|ARM|>չորքոտանի	t͡ʃʰ ɔ ɾ kʰ ɔ t ɑ n i
<|ARM|>պակաս	p ɑ k ɑ s
<|ARM|>պահածո	p ɑ h ɑ t͡s ɔ
<|ARM|>պահեստ	p ɑ h ɛ s t
<|ARM|>պաղեստին	p ɑ ʁ ɛ s t i n
<|ARM|>պաղպաղակ	p ɑ χ p ɑ ʁ ɑ k
<|ARM|>պանդոկ	p ɑ n d ɔ k
<|ARM|>պառկել	p ɑ r k ɛ l
<|ARM|>պատկերացնել	p ɑ t k ɛ ɾ ɑ t͡sʰ n ɛ l
<|ARM|>պատկերացում	p ɑ t k ɛ ɾ ɑ t͡sʰ u m
<|ARM|>պատմել	p ɑ t m ɛ l
<|ARM|>պարարտ	p ɑ ɾ ɑ ɾ t
<|ARM|>պարգեւել	p ɑ ɾ kʰ ɛ v ɛ l
<|ARM|>պարթեւ	p ɑ ɾ tʰ ɛ v
<|ARM|>պարկ	p ɑ ɾ k
<|ARM|>պարտք	p ɑ ɾ t kʰ
<|ARM|>պացիենտ	p ɑ t͡sʰ j ɛ n t
<|ARM|>պետ	p ɛ t
<|ARM|>պետք	p ɛ t kʰ
<|ARM|>պերճանք	p ɛ ɾ t͡ʃ ɑ ŋ kʰ
<|ARM|>պիստակ	p i s t ɑ k
<|ARM|>պլուտարքոս	p l u t ɑ ɾ kʰ ɔ s
<|ARM|>պոլկա	p ɔ l k ɑ
<|ARM|>պող	p ɔ ʁ
<|ARM|>պոպոք	p ɔ p ɔ kʰ
<|ARM|>պրծնել	p ə ɾ t͡s n ɛ l
<|ARM|>ջարքանդ	d͡ʒ ɑ ɾ kʰ ɑ n d
<|ARM|>ջո	d͡ʒ ɔ
<|ARM|>ջրատար	d͡ʒ ə ɾ ɑ t ɑ ɾ
<|ARM|>ռահվիրա	r ɑ h v i ɾ ɑ
<|ARM|>ռասիստ	r ɑ s i s t
<|ARM|>ռեակցիա	r ɛ ɑ k t͡sʰ j ɑ
<|ARM|>ռետին	r ɛ t i n
<|ARM|>ռոբերտ	r ɔ b ɛ ɾ t
<|ARM|>ռոճիկ	r ɔ t͡ʃ i k
<|ARM|>սակարկվել	s ɑ k ɑ ɾ k v ɛ l
<|ARM|>սահմանական	s ɑ h m ɑ n ɑ k ɑ n
<|ARM|>սահմանապահ	s ɑ h m ɑ n ɑ p ɑ h
<|ARM|>սահմանափակում	s ɑ h m ɑ n ɑ pʰ ɑ k u m
<|ARM|>սաղավարտ	s ɑ ʁ ɑ v ɑ ɾ t
<|ARM|>սանդղակ	s ɑ n d ʁ ɑ k
<|ARM|>սանձել	s ɑ n d͡z ɛ l
<|ARM|>սառ	s ɑ r
<|ARM|>սարաֆյան	s ɑ ɾ ɑ f j ɑ n
<|ARM|>սարում	s ɑ ɾ u m
<|ARM|>սարսափալից	s ɑ ɾ s ɑ pʰ ɑ l i t͡sʰ
<|ARM|>սարսափելի	s ɑ ɾ s ɑ pʰ ɛ l i
<|ARM|>սափրել	s ɑ pʰ ɾ ɛ l
<|ARM|>սեղանատուն	s ɛ ʁ ɑ n ɑ t u n
<|ARM|>սեմ	s ɛ m
<|ARM|>սեպ	s ɛ p
<|ARM|>սերբիա	s ɛ ɾ b j ɑ
<|ARM|>սերոժ	s ɛ ɾ ɔ ʒ
<|ARM|>սեւ	s ɛ v
<|ARM|>սեւան	s ɛ v ɑ n
<|ARM|>սիստեմ	s i s t ɛ m
<|ARM|>սկոտչ	ə s k ɔ t t͡ʃʰ
<|ARM|>սյուն	s j u n
<|ARM|>սնդուկ	s ə n d u k
<|ARM|>սննդակարգ	s ə n ə n d ɑ k ɑ ɾ kʰ
<|ARM|>սնուցում	s ə n u t͡sʰ u m
<|ARM|>սողոմոնյան	s ɔ ʁ ɔ m ɔ n j ɑ n
<|ARM|>սոնա	s ɔ n ɑ
<|ARM|>սորգո	s ɔ ɾ ɡ ɔ
<|ARM|>սոցցանց	s ɔ t͡sʰː ɑ n t͡sʰ
<|ARM|>սուչավա	s u t͡ʃʰ ɑ v ɑ
<|ARM|>սուսեր	s u s ɛ ɾ
<|ARM|>սուսուփուս	s u s u pʰ u s
<|ARM|>սպա	ə s p ɑ
<|ARM|>սպանախ	ə s p ɑ n ɑ χ
<|ARM|>սպասավոր	ə s p ɑ s ɑ v ɔ ɾ
<|ARM|>սպասարկիչ	ə s p ɑ s ɑ ɾ k i t͡ʃʰ
<|ARM|>սպորտ	ə s p ɔ ɾ t
<|ARM|>ստալին	ə s t ɑ l i n
<|ARM|>ստամբակ	ə s t ɑ m b ɑ k
<|ARM|>ստամոքս	ə s t ɑ m ɔ kʰ s
<|ARM|>ստեպղին	ə s t ɛ p ʁ i n
<|ARM|>ստվարաթիվ	ə s t ə v ɑ ɾ ɑ tʰ i v
<|ARM|>սրբազան	s ə ɾ pʰ ɑ z ɑ n
<|ARM|>սրբել	s ə ɾ pʰ ɛ l
<|ARM|>սրճաստան	s ə ɾ t͡ʃ ɑ s t ɑ n
<|ARM|>սրճենի	s ə ɾ t͡ʃ ɛ n i
<|ARM|>սրնքամիս	s ə ɾ ə ŋ kʰ ɑ m i s
<|ARM|>վալիզ	v ɑ l i z
<|ARM|>վահան	v ɑ h ɑ n
<|ARM|>վաղարշակ	v ɑ ʁ ɑ ɾ ʃ ɑ k
<|ARM|>վայ	v ɑ j
<|ARM|>վառելափայտ	v ɑ r ɛ l ɑ pʰ ɑ j t
<|ARM|>վասալ	v ɑ s ɑ l
<|ARM|>վավերացում	v ɑ v ɛ ɾ ɑ t͡sʰ u m
<|ARM|>վարպետության	v ɑ ɾ p ɛ t u tʰ j ɑ n
<|ARM|>վեզուվ	v ɛ z u v
<|ARM|>վեմ	v ɛ m
<|ARM|>վերադառնալ	v ɛ ɾ ɑ d ɑ r n ɑ l
<|ARM|>վերականգնում	v ɛ ɾ ɑ k ɑ ŋ ɡ n u m
<|ARM|>վերամբարձ	v ɛ ɾ ɑ m b ɑ ɾ t͡sʰ
<|ARM|>վերնաշապիկ	v ɛ ɾ n ɑ ʃ ɑ p i k
<|ARM|>վերջավոր	v ɛ ɾ t͡ʃʰ ɑ v ɔ ɾ
<|ARM|>վերջին	v ɛ ɾ t͡ʃʰ i n
<|ARM|>վթար	v ə tʰ ɑ ɾ
<|ARM|>վիզա	v i z ɑ
<|ARM|>վիկտոր	v i k t ɔ ɾ
<|ARM|>վիճաբանել	v i t͡ʃ ɑ b ɑ n ɛ l
<|ARM|>վիճակ	v i t͡ʃ ɑ k
<|ARM|>վիրակապ	v i ɾ ɑ k ɑ p
<|ARM|>վիքիպեդիա	v i kʰ i p ɛ d j ɑ
<|ARM|>վճռել	v ə t͡ʃ r ɛ l
<|ARM|>վնասաբեր	v ə n ɑ s ɑ b ɛ ɾ
<|ARM|>վռամշապուհ	v ə r ɑ m ʃ ɑ p u h
<|ARM|>տաբու	t ɑ b u
<|ARM|>տագնապ	t ɑ ɡ n ɑ p
<|ARM|>տագր	t ɑ kʰ ə ɾ
<|ARM|>տակնուվրա	t ɑ k n u v ə ɾ ɑ
<|ARM|>տանիք	t ɑ n i kʰ
<|ARM|>տարա	t ɑ ɾ ɑ
<|ARM|>տարածաշրջան	t ɑ ɾ ɑ t͡s ɑ ʃ ə ɾ d͡ʒ ɑ n
<|ARM|>տարամիտել	t ɑ ɾ ɑ m i t ɛ l
<|ARM|>տարբերակ	t ɑ ɾ b ɛ ɾ ɑ k
<|ARM|>տարտամ	t ɑ ɾ t ɑ m
<|ARM|>տեղանք	t ɛ ʁ ɑ ŋ kʰ
<|ARM|>տեղեկացնել	t ɛ ʁ ɛ k ɑ t͡sʰ n ɛ l
<|ARM|>տեսակետ	t ɛ s ɑ k ɛ t
<|ARM|>տեսանյութ	t ɛ s ɑ n j u tʰ
<|ARM|>տիբեթ	t i b ɛ tʰ
<|ARM|>տիկնիկային	t i k n i k ɑ j i n
<|ARM|>տոլմա	t ɔ l m ɑ
<|ARM|>տոնավաճառ	t ɔ n ɑ v ɑ t͡ʃ ɑ r
<|ARM|>տոպրակ	t ɔ p ɾ ɑ k
<|ARM|>տոտեմ	t ɔ t ɛ m
<|ARM|>տորոն	t ɔ ɾ ɔ n
<|ARM|>տուգանք	t u ɡ ɑ ŋ kʰ
<|ARM|>տուրիզմ	t u ɾ i z m
<|ARM|>տրական	t ə ɾ ɑ k ɑ n
<|ARM|>տրակտոր	t ɾ ɑ k t ɔ ɾ
<|ARM|>տրամաբանություն	t ɾ ɑ m ɑ b ɑ n u tʰ j u n
<|ARM|>տրամագիծ	t ɾ ɑ m ɑ ɡ i t͡s
<|ARM|>տրոմբոն	t ɾ ɔ m b ɔ n
<|ARM|>ցանել	t͡sʰ ɑ n ɛ l
<|ARM|>ցուցանել	t͡sʰ u t͡sʰ ɑ n ɛ l
<|ARM|>փակել	pʰ ɑ k ɛ l
<|ARM|>փահլեւան	pʰ ɑ h l ɛ v ɑ n
<|ARM|>փայլ	pʰ ɑ j l
<|ARM|>փայլատակել	pʰ ɑ j l ɑ t ɑ k ɛ l
<|ARM|>փայլունակություն	pʰ ɑ j l u n ɑ k u tʰ j u n
<|ARM|>փառամոլ	pʰ ɑ r ɑ m ɔ l
<|ARM|>փասթաթուղթ	pʰ ɑ s tʰ ɑ tʰ u χ tʰ
<|ARM|>փաստորեն	pʰ ɑ s t ɔ ɾ ɛ n
<|ARM|>փարիսեցիություն	pʰ ɑ ɾ i s ɛ t͡sʰ i u tʰ j u n
<|ARM|>փարպեցի	pʰ ɑ ɾ p ɛ t͡sʰ i
<|ARM|>փխենյան	pʰ ə χ ɛ n j ɑ n
<|ARM|>փղոսկր	pʰ ə ʁ ɔ s k ɾ
<|ARM|>փյունիկ	pʰ j u n i k
<|ARM|>փշատ	pʰ ə ʃ ɑ t
<|ARM|>փշրել	pʰ ə ʃ ɾ ɛ l
<|ARM|>փոխառել	pʰ ɔ χ ɑ r ɛ l
<|ARM|>փոխնախարար	pʰ ɔ χ n ɑ χ ɑ ɾ ɑ ɾ
<|ARM|>փոշի	pʰ ɔ ʃ i
<|ARM|>փոստային	pʰ ɔ s t ɑ j i n
<|ARM|>փորթուգալիա	pʰ ɔ ɾ tʰ u ɡ ɑ l j ɑ
<|ARM|>փորձարկող	pʰ ɔ ɾ t͡sʰ ɑ ɾ k ɔ ʁ
<|ARM|>փունջ	pʰ u n d͡ʒ
<|ARM|>փրփուր	pʰ ə ɾ pʰ u ɾ
<|ARM|>քաբաբ	kʰ ɑ b ɑ b
<|ARM|>քաղաքագետ	kʰ ɑ ʁ ɑ kʰ ɑ ɡ ɛ t
<|ARM|>քայլ	kʰ ɑ j l
<|ARM|>քայլել	kʰ ɑ j l ɛ l
<|ARM|>քանզի	kʰ ɑ n z i
<|ARM|>քանոն	kʰ ɑ n ɔ n
<|ARM|>քավության	kʰ ɑ v u tʰ j ɑ n
<|ARM|>քարոզիչ	kʰ ɑ ɾ ɔ z i t͡ʃʰ
<|ARM|>քելե	kʰ ɛ l ɛ
<|ARM|>քեռու	kʰ ɛ r u
<|ARM|>քերականություն	kʰ ɛ ɾ ɑ k ɑ n u tʰ j u n
<|ARM|>քթնել	kʰ ə tʰ n ɛ l
<|ARM|>քիմիկոս	kʰ i m i k ɔ s
<|ARM|>քծնանք	kʰ ə t͡s n ɑ ŋ kʰ
<|ARM|>քյամանչա	kʰ j ɑ m ɑ n t͡ʃʰ ɑ
<|ARM|>քնամուկ	kʰ ə n ɑ m u k
<|ARM|>քնար	kʰ ə n ɑ ɾ
<|ARM|>քննադատաբար	kʰ ə nː ɑ d ɑ t ɑ b ɑ ɾ
<|ARM|>քուչա	kʰ u t͡ʃʰ ɑ
<|ARM|>քուրձ	kʰ u ɾ d͡z
<|ARM|>քուրմ	kʰ u ɾ m
<|ARM|>քրմուհի	kʰ ə ɾ m u h i
<|ARM|>քրքրել	kʰ ə ɾ kʰ ə ɾ ɛ l
<|ARM|>օբ	ɔ b
<|ARM|>օդեսա	ɔ d ɛ s ɑ
<|ARM|>օղ	ɔ ʁ
<|ARM|>օղակ	ɔ ʁ ɑ k
<|ARM|>օմսկ	ɔ m s k
<|ARM|>օսեթ	ɔ s ɛ tʰ
<|ARM|>օսմանական	ɔ s m ɑ n ɑ k ɑ n
<|ARM|>օր	ɔ ɾ
<|ARM|>օրագիր	ɔ ɾ ɑ ɡ i ɾ
<|ARM|>օրան	ɔ ɾ ɑ n
<|ARM|>օրդուբադ	ɔ ɾ d u b ɑ d
<|ARM|>օրոք	ɔ ɾ ɔ kʰ
<|ARM|>օֆիս	ɔ f i s
<|ARM|>ֆագոտ	f ɑ ɡ ɔ t
<|ARM|>ֆաշիստ	f ɑ ʃ i s t
<|ARM|>ֆերմա	f ɛ ɾ m ɑ
<|ARM|>ֆինանսներ	f i n ɑ n s n ɛ ɾ
<|ARM|>ֆիննական	f i nː ɑ k ɑ n
<|ARM|>ֆլամանդացի	f l ɑ m ɑ n d ɑ t͡sʰ i
<|ARM|>ֆլամինգո	f l ɑ m i ŋ ɡ ɔ
<|ARM|>ֆրիզ	f ə ɾ i z
<|GRE|>άδικη	a ð i c i
<|GRE|>άκησ	a c i s
<|GRE|>άκουγα	a k u ɣ a
<|GRE|>άκουσα	a k u s a
<|GRE|>άνδρου	a n ð ɾ u
<|GRE|>άνθρωποσ	a n θ ɾ o p o s
<|GRE|>άντε	a d e
<|GRE|>άρον	a r o n
<|GRE|>έβαλα	e v a l a
<|GRE|>έβαλε	e v a l e
<|GRE|>έγγραφο	e ŋ ɣ r a f o
<|GRE|>έζησαν	e z i s a n
<|GRE|>έθνοσ	e θ n o s
<|GRE|>έκθεση	e k θ e s i
<|GRE|>έκπληξη	e k p l i k s i
<|GRE|>έλληνα	e l i n a
<|GRE|>έλληνεσ	e l i n e s
<|GRE|>έναντι	e n a n d i
<|GRE|>έντερο	e n d e ɾ o
<|GRE|>έντρομη	e n d ɾ o m i
<|GRE|>έπρεπε	e p ɾ e p e
<|GRE|>έτοιμοσ	e t i m o s
<|GRE|>έτοσ	e t o s
<|GRE|>έφτιαξα	e f t ç a k s a
<|GRE|>έχασα	e x a s a
<|GRE|>έχομε	e x o m e
<|GRE|>έχοντασ	e x o n d a s
<|GRE|>έχουν	e x u n
<|GRE|>ήδη	i ð i
<|GRE|>ήμασταν	i m a s t a n
<|GRE|>ήμαστε	i m a s t e
<|GRE|>ήμουν	i m u n
<|GRE|>ήσαν	i s a n
<|GRE|>ήταν	i t a n
<|GRE|>ήτανε	i t a n e
<|GRE|>ήττα	i t a
<|GRE|>ίδιοσ	i ð ʝ o s
<|GRE|>ίσωσ	i s o s
<|GRE|>αίγυπτοσ	e ʝ i p t o s
<|GRE|>αίθουσα	e θ u s a
<|GRE|>αίσθημα	e s θ i m a
<|GRE|>αίτηση	e t i s i
<|GRE|>αβανγκάρντ	a v a ŋ ɡ a ɾ d
<|GRE|>αγίασ	a ʝ i a s
<|GRE|>αγίου	a ʝ i u
<|GRE|>αγίουσ	a ʝ i u s
<|GRE|>αγανακτώ	a ɣ a n a k t o
<|GRE|>αγαπάω	a ɣ a p a o
<|GRE|>αγαπημένα	a ɣ a p i m e n a
<|GRE|>αγαπημένο	a ɣ a p i m e n o
<|GRE|>αγαπημένουσ	a ɣ a p i m e n u s
<|GRE|>αγαπώ	a ɣ a p o
<|GRE|>αγγελούδια	a ŋ ɟ e l u ð ʝ a
<|GRE|>αγορά	a ɣ o r a
<|GRE|>αγοράσ	a ɣ o r a s
<|GRE|>αγορών	a ɣ o r o n
<|GRE|>αγωνία	a ɣ o n i a
<|GRE|>αγωνιστών	a ɣ o n i s t o n
<|GRE|>αδελφή	a ð e l f i
<|GRE|>αδελφόσ	a ð e l f o s
<|GRE|>αδρεναλίνη	a ð ɾ e n a l i n i
<|GRE|>αεροδρόμιο	a e ɾ o ð ɾ o m i o
<|GRE|>αθηναίοσ	a θ i n e o s
<|GRE|>αισθάνομαι	e s θ a n o m e
<|GRE|>αιτία	e t i a
<|GRE|>ακούστηκε	a k u s t i k e
<|GRE|>ακρίβεια	a k r i v i a
<|GRE|>ακύρωσησ	a c i ɾ o s i s
<|GRE|>αλήθεια	a l i θ ç a
<|GRE|>αλεξανδρούπολη	a l e k s a n ð ɾ u p o l i
<|GRE|>αλευρωμένο	a l e v r o m e n o
<|GRE|>αλλαγή	a l a ʝ i
<|GRE|>αλλού	a l u
<|GRE|>αλυσίδα	a l i s i ð a
<|GRE|>αμάθεια	a m a θ i a
<|GRE|>αμερική	a m e r i c i
<|GRE|>αμοιβή	a m i v i
<|GRE|>αμφιβάλλω	a ɱ f i v a l o
<|GRE|>αμφιθέατρο	a m f i θ e a t ɾ o
<|GRE|>ανάγκεσ	a n a ŋ ɟ e s
<|GRE|>ανάγκη	a n a ŋ ɟ i
<|GRE|>ανάδοχοσ	a n a ð o x o s
<|GRE|>ανάλυση	a n a l i s i
<|GRE|>αναγκών	a n a ŋ ɡ o n
<|GRE|>αναισθησία	a n e s θ i s i a
<|GRE|>ανακάλυψα	a n a k a l i p s a
<|GRE|>ανακάλυψη	a n a k a l i p s i
<|GRE|>ανακαλύψεισ	a n a k a l i p s i s
<|GRE|>αναλυτικά	a n a l i t i k a
<|GRE|>ανανά	a n a n a
<|GRE|>αναπνοή	a n a p n o i
<|GRE|>ανατράπηκε	a n a t ɾ a p i c e
<|GRE|>αναφέρομαι	a n a f e ɾ o m e
<|GRE|>αναφέρω	a n a f e ɾ o
<|GRE|>αναφορά	a n a f o ɾ a
<|GRE|>ανελκυστήρασ	a n e l c i s t i ɾ a s
<|GRE|>ανησυχώ	a n i s i x o
<|GRE|>αντίδραση	a n d i ð ɾ a s i
<|GRE|>αντίνοοσ	a n d i n o o s
<|GRE|>αντιδράσεισ	a n d i ð ɾ a s i s
<|GRE|>αντικείμενο	a n d i c i m e n o
<|GRE|>αξίζει	a k s i z i
<|GRE|>αξιολόγηση	a k s i o l o ʝ i s i
<|GRE|>απ	a p
<|GRE|>απάντηση	a p a n d i s i
<|GRE|>απέδειξε	a p e ð i k s e
<|GRE|>απαιτούμε	a p e t u m e
<|GRE|>απαλλαγή	a p a l a ʝ i
<|GRE|>απαράδεκτοσ	a p a ɾ a ð e k t o s
<|GRE|>απαρηγόρητα	a p a ɾ i ɣ o ɾ i t a
<|GRE|>απελπισία	a p e l p i s i a
<|GRE|>απλούσ	a p l u s
<|GRE|>αποδείχθηκαν	a p o ð i x θ i k a n
<|GRE|>αποδείχτηκε	a p o ð i x t i c e
<|GRE|>αποκάλυψη	a p o k a l i p s i
<|GRE|>αποκαλύψεισ	a p o k a l i p s i s
<|GRE|>αποκλεισμένοσ	a p o k l i z m e n o s
<|GRE|>απομονωμένο	a p o m o n o m e n o
<|GRE|>αποστάσεισ	a p o s t a s i s
<|GRE|>αποστολή	a p o s t o l i
<|GRE|>αποτυχία	a p o t i ç i a
<|GRE|>απρίλη	a p ɾ i l i
<|GRE|>απρίλιοσ	a p ɾ i l i o s
<|GRE|>απριλίου	a p ɾ i l i u
<|GRE|>απόγευμα	a p o ʝ e v m a
<|GRE|>απόφαση	a p o f a s i
<|GRE|>απώλεια	a p o l i a
<|GRE|>αρετή	a r e t i
<|GRE|>αρετών	a r e t o n
<|GRE|>αρμοδιότητα	a ɾ m o ð i o t i t a
<|GRE|>αρρωστημένη	a r o s t i m e n i
<|GRE|>αρχίζω	a r ç i z o
<|GRE|>αρχηγόσ	a ɾ ç i ɣ o s
<|GRE|>ασκώ	a s k o
<|GRE|>αστυνομία	a s t i n o m i a
<|GRE|>αυγούστου	a v ɣ u s t u
<|GRE|>αυτή	a f t i
<|GRE|>αυτί	a f t i
<|GRE|>αυτό	a f t o
<|GRE|>αυτόσ	a f t o s
<|GRE|>αφορά	a f o r a
<|GRE|>αφορμή	a f o ɾ m i
<|GRE|>αφορούσε	a f o r u s e
<|GRE|>αύγουστοσ	a v ɣ u s t o s
<|GRE|>βάζεισ	v a z i s
<|GRE|>βάζοντασ	v a z o n d a s
<|GRE|>βάλει	v a l i
<|GRE|>βάλεισ	v a l i s
<|GRE|>βάλουμε	v a l u m e
<|GRE|>βάλω	v a l o
<|GRE|>βάροσ	v a r o s
<|GRE|>βαθιά	v a θ ç a
<|GRE|>βασίλισσα	v a s i l i s a
<|GRE|>βασιλέασ	v a s i l e a s
<|GRE|>βασιλιάσ	v a s i ʎ a s
<|GRE|>βασιλική	v a s i l i c i
<|GRE|>βεβαίωσ	v e v e o s
<|GRE|>βερολίνο	v e r o l i n o
<|GRE|>βιβλιοθήκη	v i v l i o θ i c i
<|GRE|>βοήθησα	v o i θ i s a
<|GRE|>βοηθάμε	v o i̯ θ a m e
<|GRE|>βοηθούμε	v o i θ u m e
<|GRE|>βουλευτήσ	v u l e f t i s
<|GRE|>βούληση	v u l i s i
<|GRE|>βούλιαξα	v u ʎ a k s a
<|GRE|>βράδυ	v r a ð i
<|GRE|>βρήκα	v ɾ i k a
<|GRE|>βρήκαν	v ɾ i k a n
<|GRE|>βρήκε	v ɾ i c e
<|GRE|>βρίσκω	v ɾ i s k o
<|GRE|>βραχυκύκλωμα	v ɾ a ç i c i k l o m a
<|GRE|>βρει	v ɾ i
<|GRE|>βρετανία	v r e t a n i a
<|GRE|>βρούμε	v ɾ u m e
<|GRE|>γέφυρα	ʝ e f i r a
<|GRE|>γήπεδο	ʝ i p e ð o
<|GRE|>γεγονόσ	ʝ e ɣ o n o s
<|GRE|>γεια	ʝ a
<|GRE|>γενάρη	ʝ e n a ɾ i
<|GRE|>γεννήθηκα	ʝ e n i θ i k a
<|GRE|>γεννημένοσ	ʝ e n i m e n o s
<|GRE|>γενοκτονία	ʝ e n o k t o n i a
<|GRE|>γιάννησ	ʝ a n i s
<|GRE|>γιατί	ʝ a t i
<|GRE|>γιατρόσ	ʝ a t r o s
<|GRE|>γιορτή	ʝ o r t i
<|GRE|>γιοσ	ʝ o s
<|GRE|>γκέι	ɟ e i
<|GRE|>γκρίζο	ɡ ɾ i z o
<|GRE|>γλώσσα	ɣ l o s a
<|GRE|>γνωρίζω	ɣ n o ɾ i z o
<|GRE|>γνώσεισ	ɣ n o s i s
<|GRE|>γνώσεωσ	ɣ n o s e o s
<|GRE|>γνώση	ɣ n o s i
<|GRE|>γριά	ɣ ɾ i a
<|GRE|>γύροσ	ʝ i r o s
<|GRE|>δέχομαι	ð e x o m e
<|GRE|>δείγμα	ð i ɣ m a
<|GRE|>δεη	ð e i
<|GRE|>δεκέμβριο	ð e c e ɱ v ɾ i o
<|GRE|>δεκαπέντε	ð e k a p e n d e
<|GRE|>δεκατέσσερισ	ð e k a t e s e ɾ i s
<|GRE|>δεκεμβρίου	ð e c e ɱ v ɾ i u
<|GRE|>δεν	ð e n
<|GRE|>δεύτεροσ	ð e f t e ɾ o s
<|GRE|>δηλαδή	ð i l a ð i
<|GRE|>δηλώσεισ	ð i l o s i s
<|GRE|>δημήτρησ	ð i m i t ɾ i s
<|GRE|>δημήτριοσ	ð i m i t ɾ i o s
<|GRE|>δημοκρατία	ð i m o k r a t i a
<|GRE|>δημοσιεύουμε	ð i m o s i e v u m e
<|GRE|>δημοτική	ð i m o t i c i
<|GRE|>διαβάζω	ð ʝ a v a z o
<|GRE|>διανομή	ð ʝ a n o m i
<|GRE|>διανύουμε	ð i a n i u m e
<|GRE|>διαφήμιση	ð i a f i m i s i
<|GRE|>δικηγόροσ	ð i c i ɣ o ɾ o s
<|GRE|>δουλεύω	ð u l e v o
<|GRE|>δράμα	ð r a m a
<|GRE|>δρόμοσ	ð r o m o s
<|GRE|>δυνάμεων	ð i n a m e o n
<|GRE|>δυσκολία	ð i s k o l i a
<|GRE|>δύναμη	ð i n a m i
<|GRE|>δύναμησ	ð i n a m i s
<|GRE|>δύο	ð i o
<|GRE|>δύσκολα	ð i s k o l a
<|GRE|>δύσκολοσ	ð i s k o l o s
<|GRE|>δώδεκα	ð o ð e k a
<|GRE|>δώρα	ð o ɾ a
<|GRE|>είμαι	i m e
<|GRE|>είμαστε	i m a s t e
<|GRE|>είναι	i n e
<|GRE|>είσαι	i s e
<|GRE|>είσαστε	i s a s t e
<|GRE|>είχαν	i x a n
<|GRE|>είχανε	i x a n e
<|GRE|>εβδομάδα	e v ð o m a ð a
<|GRE|>εγκατάλειψη	e ŋ ɡ a t a l i p s i
<|GRE|>εθνικόσ	e θ n i k o s
<|GRE|>εισιτήριο	i s i t i ɾ i o
<|GRE|>εκατομμύριο	e k a t o m i ɾ i o
<|GRE|>εκατό	e k a t o
<|GRE|>εκδοτικόσ	e k ð o t i k o s
<|GRE|>εκδρομή	e k ð ɾ o m i
<|GRE|>εκείνη	e c i n i
<|GRE|>εκείνοι	e c i n i
<|GRE|>εκλήθη	e k l i θ i
<|GRE|>εκπληκτικά	e k p l i k t i k a
<|GRE|>εκπομπέσ	e k p o m b e s
<|GRE|>εκπομπή	e k p o m b i
<|GRE|>εκτέλεση	e k t e l e s i
<|GRE|>ελευθερία	e l e f θ e ɾ i a
<|GRE|>ελεύθεροσ	e l e f θ e r o s
<|GRE|>ελλάδα	e l a ð a
<|GRE|>ελληνικό	e l i n i k o
<|GRE|>ελπίζουμε	e l p i z u m e
<|GRE|>εμμανουήλ	e m a n u i l
<|GRE|>εμπιστεύομαι	e m b i s t e v o m e
<|GRE|>εμπόδιο	e m b o ð i o
<|GRE|>εναντίον	e n a n d i o n
<|GRE|>ενδέχεται	e n ð e ç e t e
<|GRE|>ενημέρωση	e n i m e r o s i
<|GRE|>ενημέρωσησ	e n i m e r o s i s
<|GRE|>εντύπωση	e n d i p o s i
<|GRE|>εξέγερση	e k s e ʝ e r s i
<|GRE|>εξέτασα	e k s e t a s a
<|GRE|>εξαιτίασ	e k s e t i a s
<|GRE|>εξοπλισμένη	e k s o p l i z m e n i
<|GRE|>επάγγελμα	e p a ŋ ɡ e l m a
<|GRE|>επέγραψα	e p e ɣ ɾ a p s a
<|GRE|>επανέναρξη	e p a n e n a ɾ k s i
<|GRE|>επαρχία	e p a ɾ ç i a
<|GRE|>επιδράσεισ	e p i ð ɾ a s i s
<|GRE|>επιλογή	e p i l o ʝ i
<|GRE|>επιμελητήσ	e p i m e l i t i s
<|GRE|>επιπλέον	e p i p l e o n
<|GRE|>επιτρέπεται	e p i t ɾ e p e t e
<|GRE|>επιτυχία	e p i t i ç i a
<|GRE|>επιχείρηση	e p i ç i ɾ i s i
<|GRE|>επομένωσ	e p o m e n o s
<|GRE|>επόμενοσ	e p o m e n o s
<|GRE|>ερχόμενο	e r x o m e n o
<|GRE|>εσυ	e s i
<|GRE|>ευκαιρία	e f c e r i a
<|GRE|>ευσέβεια	e f s e v i a
<|GRE|>ευχή	e f ç i
<|GRE|>ευχαριστούμε	e f x a ɾ i s t u m e
<|GRE|>ευχαριστώ	e f x a ɾ i s t o
<|GRE|>εφημερίδα	e f i m e r i ð a
<|GRE|>εύχεται	e f ç e t e
<|GRE|>εύχομαι	e f x o m e
<|GRE|>ζάχαρη	z a x a r i
<|GRE|>ζήτα	z i t a
<|GRE|>ζευγάρι	z e v ɣ a r i
<|GRE|>ζευγάρια	z e v ɣ a r ʝ a
<|GRE|>ζευγαριού	z e v ɣ a r ʝ u
<|GRE|>ζητάμε	z i t a m e
<|GRE|>ζητώ	z i t o
<|GRE|>ζωή	z o i
<|GRE|>ζωηρόσ	z o i r o s
<|GRE|>ζωντανόσ	z o n d a n o s
<|GRE|>ζώο	z o o
<|GRE|>ηγουμενίτσα	i ɣ u m e n i t s a
<|GRE|>ηλικία	i l i c i a
<|GRE|>ησυχία	i s i ç i a
<|GRE|>θέλω	θ e l o
<|GRE|>θέματα	θ e m a t a
<|GRE|>θαρραλέοσ	θ a r a l e o s
<|GRE|>θαύμα	θ a v m a
<|GRE|>θεία	θ i a
<|GRE|>θεραπεία	θ e ɾ a p i a
<|GRE|>θερμοκρασία	θ e ɾ m o k ɾ a s i a
<|GRE|>θεωρώ	θ e o r o
<|GRE|>θεόσ	θ e o s
<|GRE|>θωρώ	θ o r o
<|GRE|>θύελλα	θ i e l a
<|GRE|>ιανουάριο	i a n u a ɾ i o
<|GRE|>ιανουάριοσ	i a n u a ɾ i o s
<|GRE|>ιανουαρίου	i a n u a ɾ i u
<|GRE|>ιδιαίτερα	i ð i e t e ɾ a
<|GRE|>ιδιαιτέρωσ	i ð i e t e ɾ o s
<|GRE|>ιδρύματοσ	i ð r i m a t o s
<|GRE|>ιερουσαλήμ	i e ɾ u s a l i m
<|GRE|>ιουλίου	i u l i u
<|GRE|>ιούλη	i u l i
<|GRE|>ιούλιο	i u l i o
<|GRE|>ιούνησ	i u n i s
<|GRE|>ιούνιο	i u n i o
<|GRE|>ιρλανδία	i ɾ l a n ð i a
<|GRE|>ισπανία	i s p a n i a
<|GRE|>ιστολόγιο	i s t o l o ʝ i o
<|GRE|>ιστορικόσ	i s t o r i k o s
<|GRE|>ιταλική	i t a l i k i
<|GRE|>ιταλικό	i t a l i k o
<|GRE|>ιωάννα	i o a n a
<|GRE|>ιωάννινα	i o a n i n a
<|GRE|>κάθομαι	k a θ o m e
<|GRE|>κάλυψη	k a l i p s i
<|GRE|>κάνοντασ	k a n o n d a s
<|GRE|>κάνω	k a n o
<|GRE|>κάποιοσ	k a p ç o s
<|GRE|>κάστρο	k a s t r o
<|GRE|>κέρδοσ	c e r ð o s
<|GRE|>κέφι	c e f i
<|GRE|>κίνδυνοσ	c i n ð i n o s
<|GRE|>καθίζοντασ	k a θ i z o n d a s
<|GRE|>και	c e
<|GRE|>καινοτομία	c e n o t o m i a
<|GRE|>καινοτομίασ	c e n o t o m i a s
<|GRE|>καινοτομίεσ	c e n o t o m i e s
<|GRE|>κακό	k a k o
<|GRE|>καλημέρα	k a l i m e r a
<|GRE|>καλιφόρνια	k a l i f o ɾ n i a
<|GRE|>καλοί	k a l i
<|GRE|>καλοκαίρι	k a l o c e r i
<|GRE|>καλό	k a l o
<|GRE|>καλόσ	k a l o s
<|GRE|>καν	k a n
<|GRE|>καρδιά	k a r ð ʝ a
<|GRE|>καρεκλάκι	k a ɾ e k l a c i
<|GRE|>κατά	k a t a
<|GRE|>κατάλογοσ	k a t a l o ɣ o s
<|GRE|>κατέβαλε	k a t e v a l e
<|GRE|>καταιγίδασ	k a t e ʝ i ð a s
<|GRE|>κερί	c e r r i
<|GRE|>κεριά	c e r ʝ a
<|GRE|>κιβωτόσ	c i v o t o s
<|GRE|>κινέζικα	c i n e z i k a
<|GRE|>κινδυνεύω	c i n ð i n e v o
<|GRE|>κινδύνευσα	c i n ð i n e f s a
<|GRE|>κιόλασ	c o l a s
<|GRE|>κλίση	k ʎ i s i
<|GRE|>κλαίω	k l e o
<|GRE|>κλαρινέτο	k l a ɾ i n e t o
<|GRE|>κοινή	c i n i
<|GRE|>κοινό	c i n o
<|GRE|>κοινόσ	c i n o s
<|GRE|>κοιτάω	c i t a o
<|GRE|>κοιτίδασ	c i t i ð a s
<|GRE|>κορίνθου	k o ɾ i n θ u
<|GRE|>κορίτσια	k o ɾ i t s ç a
<|GRE|>κοριτσιών	k o ɾ i t s ç o n
<|GRE|>κοτόπουλο	k o t o p u l o
<|GRE|>κουνέλι	k u n e l i
<|GRE|>κουρασμένοι	k u r a z m e n i
<|GRE|>κρέασ	k r e a s
<|GRE|>κρήτη	k r i t i
<|GRE|>κραγιόν	k ɾ a ʝ o n
<|GRE|>κρεμασμένα	k r e m a z m e n a
<|GRE|>κρυμμένα	k r i m e n a
<|GRE|>κυριακή	c i r ʝ a c i
<|GRE|>κυριολεκτικά	c i ɾ i o l e k t i k a
<|GRE|>κωνσταντίνοσ	k o n s t a n d i n o s
<|GRE|>κωνσταντίνου	k o n s t a n d i n u
<|GRE|>κόκκινη	k o c i n i
<|GRE|>κόλαση	k o l a s i
<|GRE|>κόσμοσ	k o z m o s
<|GRE|>κύπρο	c i p ɾ o
<|GRE|>κύπρου	c i p ɾ u
<|GRE|>λάδι	l a ð i
<|GRE|>λάρισα	l a r i s a
<|GRE|>λέγεται	l e ʝ e t e
<|GRE|>λέγω	l e ɣ o
<|GRE|>λέει	l e i
<|GRE|>λέμε	l e m e
<|GRE|>λέσβοσ	l e z v o s
<|GRE|>λήμνοσ	l i m n o s
<|GRE|>λίγο	l i ɣ o
<|GRE|>λεμόνι	l e m o n i
<|GRE|>λεσ	l e s
<|GRE|>λευκά	l e f k a
<|GRE|>λευκέσ	l e f c e s
<|GRE|>λευκή	l e f c i
<|GRE|>λευκό	l e f k o
<|GRE|>λιγότερο	l i ɣ o t e r o
<|GRE|>λιγότεροι	l i ɣ o t e r i
<|GRE|>λιμάνι	l i m a n i
<|GRE|>λιοντάρι	ʎ o n d a ɾ i
<|GRE|>λοιπόν	l i p o n
<|GRE|>λονδίνο	l o n ð i n o
<|GRE|>λουτρό	l u t ɾ o
<|GRE|>λυθεί	l i θ i
<|GRE|>λύθηκε	l i θ i c e
<|GRE|>λύνει	l i n i
<|GRE|>λύσαμε	l i s a m e
<|GRE|>λύσει	l i s i
<|GRE|>λύσεισ	l i s i s
<|GRE|>λύση	l i s i
<|GRE|>λύσουν	l i s u n
<|GRE|>λύσσα	l i s a
<|GRE|>μάγκασ	m a ŋ ɡ a s
<|GRE|>μάζα	m a z a
<|GRE|>μάζεψα	m a z e p s a
<|GRE|>μάησ	m a i s
<|GRE|>μάντεψε	m a n d e p s e
<|GRE|>μάρτιο	m a ɾ t i o
<|GRE|>μάτια	m a t ç a
<|GRE|>μέρα	m e r a
<|GRE|>μέροσ	m e ɾ o s
<|GRE|>μέσα	m e s a
<|GRE|>μέσο	m e s o
<|GRE|>μέσω	m e s o
<|GRE|>μήνυμα	m i n i m a
<|GRE|>μήπωσ	m i p o s
<|GRE|>μία	m i a
<|GRE|>μα	m a
<|GRE|>μαγιονέζα	m a ʝ o n e z a
<|GRE|>μαθηματικά	m a θ i m a t i k a
<|GRE|>μαλάκα	m a l a k a
<|GRE|>μαρτίου	m a ɾ t i u
<|GRE|>μαρτύρων	m a ɾ t i ɾ o n
<|GRE|>μεγάλοσ	m e ɣ a l o s
<|GRE|>μειώσεισ	m i o s i s
<|GRE|>μεξικού	m e k s i k u
<|GRE|>μερίδα	m e ɾ i ð a
<|GRE|>μεσαιωνική	m e s e o n i c i
<|GRE|>μεταφέρω	m e t a f e ɾ o
<|GRE|>μετράω	m e t ɾ a o
<|GRE|>μη	m i
<|GRE|>μητέρα	m i t e r a
<|GRE|>μιάμιση	m ɲ a m i s i
<|GRE|>μια	m ɲ a
<|GRE|>μικρό	m i k ɾ o
<|GRE|>μιλάνο	m i l a n o
<|GRE|>μισθόσ	m i s θ o s
<|GRE|>μισό	m i s o
<|GRE|>μοναχόσ	m o n a x o s
<|GRE|>μοντέλο	m o d e l o
<|GRE|>μυκόνου	m i k o n u
<|GRE|>μυτιλήνη	m i t i l i n i
<|GRE|>μωρό	m o ɾ o
<|GRE|>μόσχα	m o s x a
<|GRE|>μύτη	m i t i
<|GRE|>νάουσα	n a u s a
<|GRE|>νέο	n e o
<|GRE|>νήστεψα	n i s t e p s a
<|GRE|>ναύπακτοσ	n a f p a k t o s
<|GRE|>νεκρόσ	n e k ɾ o s
<|GRE|>νεπάλ	n e p a l
<|GRE|>νερό	n e r o
<|GRE|>νικολάου	n i k o l a u
<|GRE|>νοέμβρη	n o e ɱ v ɾ i
<|GRE|>νοεμβρίου	n o e ɱ v ɾ i u
<|GRE|>νοιάζει	ɲ a z i
<|GRE|>νομίζω	n o m i z o
<|GRE|>νοσοκομείο	n o s o k o m i o
<|GRE|>ντίνα	d i n a
<|GRE|>ντίνοσ	d i n o s
<|GRE|>ντε	d e
<|GRE|>ντουσ	d u s
<|GRE|>ντροπή	d ɾ o p i
<|GRE|>νόσου	n o s u
<|GRE|>ξένα	k s e n a
<|GRE|>ξέχασα	k s e x a s a
<|GRE|>ξενοδοχείο	k s e n o ð o ç i o
<|GRE|>ξωτικό	k s o t i k o
<|GRE|>ξύλο	k s i l o
<|GRE|>οδού	o ð u
<|GRE|>οδό	o ð o
<|GRE|>οικογένεια	i k o ʝ e n i a
<|GRE|>οκτωβρίου	o k t o v ɾ i u
<|GRE|>οκτώ	o k t o
<|GRE|>οκτώβριο	o k t o v ɾ i o
<|GRE|>ομοφυλόφιλο	o m o f i l o f i l o
<|GRE|>ονομάζομαι	o n o m a z o m e
<|GRE|>οποίου	o p i u
<|GRE|>ορίστε	o ɾ i s t e
<|GRE|>οργή	o r ʝ i
<|GRE|>ορεστιάδα	o ɾ e s t i a ð a
<|GRE|>ορθόδοξη	o ɾ θ o ð o k s i
<|GRE|>ορθόδοξοι	o ɾ θ o ð o k s i
<|GRE|>οριστικά	o ɾ i s t i k a
<|GRE|>ούτωσ	u t o s
<|GRE|>πάω	p a o
<|GRE|>πέθανε	p e θ a n e
<|GRE|>πέοσ	p e o s
<|GRE|>πίστεψα	p i s t e p s a
<|GRE|>πίσω	p i s o
<|GRE|>παγκοσμιοποίησησ	p a ŋ ɡ o z m i o p i i s i s
<|GRE|>παιδί	p e ð i
<|GRE|>πανέμορφοσ	p a n e m o ɾ f o s
<|GRE|>παναγία	p a n a ʝ i a
<|GRE|>παντού	p a n d u
<|GRE|>παρίσι	p a ɾ i s i
<|GRE|>παραδεχτεί	p a ɾ a ð e x t i
<|GRE|>παρακαλούμε	p a r a k a l u m e
<|GRE|>παρακαλώ	p a r a k a l o
<|GRE|>παρακολουθώ	p a ɾ a k o l u θ o
<|GRE|>παραμύθι	p a ɾ a m i θ i
<|GRE|>παραπάνω	p a ɾ a p a n o
<|GRE|>παρελθόν	p a r e l θ o n
<|GRE|>παροιμία	p a ɾ i m i a
<|GRE|>παρόν	p a ɾ o n
<|GRE|>παρών	p a ɾ o n
<|GRE|>πασ	p a s
<|GRE|>πασοκ	p a s o k
<|GRE|>πατέρασ	p a t e r a s
<|GRE|>πατρίδα	p a t r i ð a
<|GRE|>παύλοσ	p a v l o s
<|GRE|>πειράζει	p i ɾ a z i
<|GRE|>πειρατήσ	p i r a t i s
<|GRE|>περίπτωση	p e ɾ i p t o s i
<|GRE|>περασμένη	p e r a z m e n i
<|GRE|>περασμένο	p e r a z m e n o
<|GRE|>περιέκοψα	p e ɾ i e k o p s a
<|GRE|>περικλείω	p e r i k l i o
<|GRE|>περιοδικά	p e r i o ð i k a
<|GRE|>περιοδικού	p e r i o ð i k u
<|GRE|>περιοδικό	p e r i o ð i k o
<|GRE|>περιόδουσ	p e r i o ð u s
<|GRE|>περνάει	p e ɾ n a i
<|GRE|>πετράκησ	p e t ɾ a c i s
<|GRE|>πιθανότητα	p i θ a n o t i t a
<|GRE|>πιπεριά	p i p e r ʝ a
<|GRE|>πιστεύετε	p i s t e v e t e
<|GRE|>πιστεύουμε	p i s t e v u m e
<|GRE|>πιστεύω	p i s t e v o
<|GRE|>πλέον	p l e o n
<|GRE|>πλατεία	p l a t i a
<|GRE|>πλειοψηφία	p l i o p s i f i a
<|GRE|>πληθυσμόσ	p l i θ i z m o s
<|GRE|>πλύσιμο	p l i s i m o
<|GRE|>πνεύμα	p n e v m a
<|GRE|>πνεύματοσ	p n e v m a t o s
<|GRE|>ποίηση	p i i s i
<|GRE|>ποδοσφαίρου	p o ð o s f e r u
<|GRE|>ποδόσφαιρο	p o ð o s f e r o
<|GRE|>ποια	p ç a
<|GRE|>πολύ	p o l i
<|GRE|>ποντίκι	p o n d i c i
<|GRE|>ποσότητα	p o s o t i t a
<|GRE|>ποτό	p o t o
<|GRE|>πουδραρίζομαι	p u ð ɾ a ɾ i z o m e
<|GRE|>πουθενά	p u θ e n a
<|GRE|>πράγμα	p ɾ a ɣ m a
<|GRE|>πρέπει	p ɾ e p i
<|GRE|>προέκυψε	p r o e c i p s e
<|GRE|>προβλήματα	p r o v l i m a t a
<|GRE|>προετοιμασία	p ɾ o e t i m a s i a
<|GRE|>προηγουμένων	p r o i ɣ u m e n o n
<|GRE|>προηγούμενα	p r o i ɣ u m e n a
<|GRE|>προηγούμενεσ	p r o i ɣ u m e n e s
<|GRE|>προηγούμενη	p r o i ɣ u m e n i
<|GRE|>προηγούμενησ	p r o i ɣ u m e n i s
<|GRE|>προηγούμενο	p r o i ɣ u m e n o
<|GRE|>προκύπτει	p r o c i p t i
<|GRE|>προπόνηση	p r o p o n i s i
<|GRE|>προσευχή	p ɾ o s e f ç i
<|GRE|>προσθήκη	p r o s θ i c i
<|GRE|>προσοχή	p ɾ o s o ç i
<|GRE|>προσπαθώ	p ɾ o s p a θ o
<|GRE|>προϊόν	p ɾ o i o n
<|GRE|>πρωθυπουργόσ	p ɾ o θ i p u ɾ ɣ o s
<|GRE|>πρωτάθλημα	p ɾ o t a θ l i m a
<|GRE|>πρωταγωνιστή	p ɾ o t a ɣ o n i s t i
<|GRE|>πρωταγωνιστήσ	p ɾ o t a ɣ o n i s t i s
<|GRE|>πρωταθλήτρια	p ɾ o t a θ l i t ɾ i a
<|GRE|>πρωταθλητήσ	p ɾ o t a θ l i t i s
<|GRE|>πρωτοβουλία	p ɾ o t o v u l i a
<|GRE|>πρωτοχρονιά	p ɾ o t o x ɾ o ɲ a
<|GRE|>πρόβλημα	p r o v l i m a
<|GRE|>πρόκειται	p ɾ o c i t e
<|GRE|>πρόσωπο	p r o s o p o
<|GRE|>πρώτοσ	p ɾ o t o s
<|GRE|>πωσ	p o s
<|GRE|>πόλη	p o l i
<|GRE|>πότε	p o t e
<|GRE|>πύργο	p i r ɣ o
<|GRE|>πύργου	p i r ɣ u
<|GRE|>πώσ	p o s
<|GRE|>ρέθυμνο	ɾ e θ i m n o
<|GRE|>ρε	ɾ e
<|GRE|>ρώμη	ɾ o m i
<|GRE|>ρώτησα	ɾ o t i s a
<|GRE|>σίγουροσ	s i ɣ u ɾ o s
<|GRE|>σελήνη	s e l i n i
<|GRE|>σεπτέμβριοσ	s e p t e ɱ v ɾ i o s
<|GRE|>σημάδια	s i m a ð ʝ a
<|GRE|>σημαδιών	s i m a ð ʝ o n
<|GRE|>σιγά	s i ɣ a
<|GRE|>σκάνδαλο	s k a n ð a l o
<|GRE|>σκληρή	s k l i r i
<|GRE|>σκυλίτσα	s c i l i t s a
<|GRE|>σκόπια	s k o p ç a
<|GRE|>σοκάκι	s o k a c i
<|GRE|>σουτ	s u t
<|GRE|>σοφίασ	s o f i a s
<|GRE|>σοφόσ	s o f o s
<|GRE|>σοφότερο	s o f o t e ɾ o
<|GRE|>σούταρε	s u t a ɾ e
<|GRE|>σπίτι	s p i t i
<|GRE|>σπιτική	s p i t i c i
<|GRE|>στάνη	s t a n i
<|GRE|>στέλιοσ	s t e ʎ o s
<|GRE|>στέλλα	s t e l a
<|GRE|>στα	s t a
<|GRE|>σταγόνα	s t a ɣ o n a
<|GRE|>σταματημένοσ	s t a m a t i m e n o s
<|GRE|>στη	s t i
<|GRE|>στην	s t i n
<|GRE|>στισ	s t i s
<|GRE|>στον	s t o n
<|GRE|>στουσ	s t u s
<|GRE|>στρίβω	s t ɾ i v o
<|GRE|>στρατοπέδου	s t ɾ a t o p e ð u
<|GRE|>στρώμα	s t ɾ o m a
<|GRE|>στυμμένη	s t i m e n i
<|GRE|>συγγνώμη	s i ŋ ɣ n o m i
<|GRE|>συγγραφέα	s i ŋ ɣ r a f e a
<|GRE|>συγγραφέασ	s i ŋ ɣ r a f e a s
<|GRE|>συγγραφείσ	s i ŋ ɣ r a f i s
<|GRE|>συγνώμη	s i ɣ n o m i
<|GRE|>συγχαρητήρια	s i ŋ x a ɾ i t i ɾ i a
<|GRE|>συζητούμε	s i z i t u m e
<|GRE|>συλλέκτησ	s i l e k t i s
<|GRE|>συμβούλιο	s i ɱ v u l i o
<|GRE|>συμπεριφορά	s i m b e ɾ i f o ɾ a
<|GRE|>συμφωνώ	s i ɱ f o n o
<|GRE|>συνέχεια	s i n e ç i a
<|GRE|>συνήθωσ	s i n i θ o s
<|GRE|>συνεθλίβη	s i n e θ l i v i
<|GRE|>συνετρίβη	s i n e t ɾ i v i
<|GRE|>συνεχίζουμε	s i n e ç i z u m e
<|GRE|>συνεχώσ	s i n e x o s
<|GRE|>συνηθισμένη	s i n i θ i z m e n i
<|GRE|>συνηθισμένο	s i n i θ i z m e n o
<|GRE|>συριζα	s i ɾ i z a
<|GRE|>σφιχτά	s f i x t a
<|GRE|>σφυρί	s f i r i
<|GRE|>σχετικά	s ç e t i k a
<|GRE|>σύμβουλοσ	s i ɱ v u l o s
<|GRE|>σύνορα	s i n o r a
<|GRE|>σύνταξη	s i n d a k s i
<|GRE|>σύστημα	s i s t i m a
<|GRE|>σώμα	s o m a
<|GRE|>τάχα	t a x a
<|GRE|>τέλεια	t e l i a
<|GRE|>τέταρτο	t e t a ɾ t o
<|GRE|>τέχνη	t e x n i
<|GRE|>ταλέντο	t a l e n d o
<|GRE|>ταμείο	t a m i o
<|GRE|>ταχύτητα	t a ç i t i t a
<|GRE|>τελευταία	t e l e f t e a
<|GRE|>τελευταίοσ	t e l e f t e o s
<|GRE|>τεχνολογία	t e x n o l o ʝ i a
<|GRE|>τεχνολογίασ	t e x n o l o ʝ i a s
<|GRE|>τεχνολογιών	t e x n o l o ʝ i o n
<|GRE|>τζάκι	d z a c i
<|GRE|>τζάμπα	t s a m b a
<|GRE|>τησ	t i s
<|GRE|>τιμή	t i m i
<|GRE|>τιμόνι	t i m o n i
<|GRE|>το	t o
<|GRE|>τον	t o n
<|GRE|>τοποθετημένοσ	t o p o θ e t o
<|GRE|>τούρτα	t u ɾ t a
<|GRE|>τρίκαλα	t ɾ i k a l a
<|GRE|>τραγούδησα	t ɾ a ɣ u ð i s a
<|GRE|>τραπέζι	t ɾ a p e z i
<|GRE|>τρεισ	t ɾ i s
<|GRE|>τρεισήμισι	t ɾ i s i m i s i
<|GRE|>τρελή	t r e l i
<|GRE|>τρελαίνομαι	t ɾ e l e n o m e
<|GRE|>τριάντα	t r i a n d a
<|GRE|>τριμμένη	t r i m e n i
<|GRE|>των	t o n
<|GRE|>τόση	t o s i
<|GRE|>τόσο	t o s o
<|GRE|>τόσοσ	t o s o s
<|GRE|>τύχη	t i ç i
<|GRE|>υγεία	i ʝ i a
<|GRE|>υδράργυροσ	i ð ɾ a ɾ ʝ i ɾ o s
<|GRE|>υπέρ	i p e r
<|GRE|>υπέροχη	i p e ɾ o ç i
<|GRE|>υπεύθυνοσ	i p e f θ i n o s
<|GRE|>υπομονή	i p o m o n i
<|GRE|>υπουργόσ	i p u ɾ ɣ o s
<|GRE|>υπόψη	i p o p s i
<|GRE|>υόρκη	i o ɾ c i
<|GRE|>φάρμακο	f a r m a k o
<|GRE|>φέτοσ	f e t o s
<|GRE|>φίδι	f i ð i
<|GRE|>φίλο	f i l o
<|GRE|>φαντάζομαι	f a n d a z o m e
<|GRE|>φαντασία	f a n d a s i a
<|GRE|>φανταστική	f a n d a s t i ç i
<|GRE|>φαρμακείο	f a r m a c i o
<|GRE|>φασαρία	f a s a ɾ i a
<|GRE|>φασούλι	f a s u l i
<|GRE|>φεβρουάριο	f e v ɾ u a ɾ i o
<|GRE|>φεβρουαρίου	f e v ɾ u a ɾ i u
<|GRE|>φιλοσοφία	f i l o s o f i a
<|GRE|>φλεβάρη	f l e v a ɾ i
<|GRE|>φλερτ	f l e ɾ t
<|GRE|>φλόριντα	f l o ɾ i d a
<|GRE|>φλώροσ	f l o ɾ o s
<|GRE|>φορολογία	f o ɾ o l o ʝ i a
<|GRE|>φυσικά	f i s i k a
<|GRE|>φυτικέσ	f i t i c e s
<|GRE|>φωνή	f o n i
<|GRE|>φόρα	f o ɾ a
<|GRE|>φόρεσα	f o ɾ e s a
<|GRE|>χάριν	x a r i n
<|GRE|>χάρτησ	x a r t i s
<|GRE|>χέρι	ç e ɾ i
<|GRE|>χίλια	ç i ʎ a
<|GRE|>χίο	ç i o
<|GRE|>χίου	ç i u
<|GRE|>χαίρε	ç e r e
<|GRE|>χαμηλόσ	x a m i l o s
<|GRE|>χαμόγελο	x a m o ʝ e l o
<|GRE|>χανιά	x a ɲ a
<|GRE|>χαρτί	x a ɾ t i
<|GRE|>χαρτζιλίκι	x a ɾ d z i l i c i
<|GRE|>χείλη	ç i l i
<|GRE|>χειρότεροσ	ç i ɾ o t e ɾ o s
<|GRE|>χιόνι	ç o n i
<|GRE|>χοντρή	x o d r i
<|GRE|>χοντρό	x o n d ɾ o
<|GRE|>χρήματα	x r i m a t a
<|GRE|>χρειάζεται	x ɾ i a z e t e
<|GRE|>χρειάστηκε	x ɾ i a s t i c e
<|GRE|>χρησιμοποίησα	x ɾ i s i m o p i i s a
<|GRE|>χρησιμοποιήσεισ	x ɾ i s i m o p i i s i s
<|GRE|>χρησιμοποιούμε	x ɾ i s i m o p i u m e
<|GRE|>χριστουγέννων	x ɾ i s t u ʝ e n o n
<|GRE|>χριστούγεννα	x ɾ i s t u ʝ e n a
<|GRE|>χρονιά	x r o ɲ a
<|GRE|>χρονολογία	x r o n o l o ʝ i a
<|GRE|>χρονών	x ɾ o n o n
<|GRE|>χρόνοσ	x ɾ o n o s
<|GRE|>χρώμα	x ɾ o m a
<|GRE|>χτύπαγα	x t i p a ɣ a
<|GRE|>χύτρα	ç i t ɾ a
<|GRE|>ψήφο	p s i f o
<|GRE|>ψήφου	p s i f u
<|GRE|>ψήφουσ	p s i f u s
<|GRE|>ψημένοσ	p s i m e n o s
<|GRE|>ψηφιακή	p s i f i a c i
<|GRE|>ψηφιακού	p s i f i a k u
<|GRE|>ψηφοδέλτιο	p s i f o ð e l t i o
<|GRE|>ψηφοφορία	p s i f o f o ɾ i a
<|GRE|>ψωμάκι	p s o m a c i
<|GRE|>ψωμί	p s o m i
<|GRE|>ωστόσο	o s t o s o
<|GRE|>όμορφη	o m o ɾ f i
<|GRE|>όμορφου	o m o ɾ f u
<|GRE|>όνομα	o n o m a
<|GRE|>όντασ	o n d a s
<|GRE|>όντωσ	o n d o s
<|GRE|>όπλο	o p l o
<|GRE|>όποιο	o p ç o
<|GRE|>ότι	o t i
<|GRE|>όφελοσ	o f e l o s
<|GRE|>ύφεση	i f e s i
<|GRE|>ώρα	o r a
<|GRE|>ώριμα	o ɾ i m a
<|GRE|>ώριμη	o ɾ i m i
<|GRE|>ώστε	o s t e
<|GRE|>ὑπογραφείσ	i p o ɣ r a f i s
<|RUS|>явственно	j a f s t vʲ i n a
<|RUS|>гомер	ɡ a mʲ e r
<|RUS|>сплетавший	s p lʲ i t a f ʂ i j
<|RUS|>усыновляйте	u s i n a v lʲ a j tʲ e
<|RUS|>льда	lʲ d a
<|RUS|>прозвучишь	p r a z v u t͡ɕ i ʂ
<|RUS|>сатирах	s a tʲ i r a x
<|RUS|>ремиксов	rʲ i mʲ i k s a f
<|RUS|>залепляю	z a lʲ i p lʲ a j u
<|RUS|>абсорбированиями	a p s a r bʲ i r a v a nʲ i j a mʲ i
<|RUS|>плавкою	p ɫ a f k a j u
<|RUS|>зашумит	z a ʂ u mʲ i t
<|RUS|>мужененавистничествам	m u ʐ i nʲ i n a vʲ i sʲ nʲ i t͡ɕ i s t v a m
<|RUS|>золотистым	z a ɫ a tʲ i s t i m
<|RUS|>катерочках	k a tʲ i r o t͡ɕ k a x
<|RUS|>смеялось	s mʲ i j a ɫ a sʲ
<|RUS|>замыслу	z a m i s ɫ u
<|RUS|>семиугольника	sʲ i mʲ i u ɡ o lʲ nʲ i k a
<|RUS|>присягнувши	p rʲ i sʲ i ɡ n u f ʂ i
<|RUS|>поносят	p a n o sʲ a t
<|RUS|>изучитесь	i z u t͡ɕ i tʲ i sʲ
<|RUS|>помойкою	p a m o j k a j u
<|RUS|>англицизациею	a n ɡ lʲ i t͡s i z a t͡s i j i j u
<|RUS|>прыщавый	p r i ɕː a v i j
<|RUS|>усопла	u s o p ɫ a
<|RUS|>полетать	p a lʲ i t a tʲ
<|RUS|>укутывающий	u k u t i v a j u ɕː i j
<|RUS|>муруй	m u r u j
<|RUS|>суммируешь	s u mʲ i r u j i ʂ
<|RUS|>секта	sʲ e k t a
<|RUS|>заклейте	z a k lʲ e j tʲ e
<|RUS|>амилазой	a mʲ i ɫ a z a j
<|RUS|>посодействовать	p a s a dʲ e j s t v a v a tʲ
<|RUS|>опьянивший	a p ⁽ʲ ⁾ j i nʲ i f ʂ i j
<|RUS|>заговаривайтесь	z a ɡ a v a rʲ i v a j tʲ i sʲ
<|RUS|>ужесточения	u ʐ i s t a t͡ɕ e nʲ i j a
<|RUS|>расправах	r a s p r a v a x
<|RUS|>летный	lʲ e t n i j
<|RUS|>дубу	d u b u
<|RUS|>загадит	z a ɡ a dʲ i t
<|RUS|>пропитайтесь	p r a pʲ i t a j tʲ i sʲ
<|RUS|>отсчётах	a t͡ɕ ɕː o t a x
<|RUS|>десницу	dʲ i sʲ nʲ i t͡s u
<|RUS|>обуевала	a b u j i v a ɫ a
<|RUS|>вертлуг	vʲ i r t ɫ u k
<|RUS|>навевавший	n a vʲ i v a f ʂ i j
<|RUS|>полиграфиях	p a lʲ i ɡ r a fʲ i j a x
<|RUS|>западаешь	z a p a d a j i ʂ
<|RUS|>дозрею	d a z rʲ e j u
<|RUS|>взыскиваете	v z i s kʲ i v a j i tʲ e
<|RUS|>изъянами	i z j a n a mʲ i
<|RUS|>метафизику	mʲ i t a fʲ i zʲ i k u
<|RUS|>веселеешь	vʲ i sʲ i lʲ e j i ʂ
<|RUS|>технократию	tʲ i x n a k r a tʲ i j u
<|RUS|>пригородом	p rʲ i ɡ a r a d a m
<|RUS|>пионеров	pʲ i a nʲ e r a f
<|RUS|>поручительством	p a r u t͡ɕ i tʲ i lʲ s t v a m
<|RUS|>гостьях	ɡ o sʲ tʲ j a x
<|RUS|>подтягиваюсь	p a tʲː a ɡʲ i v a j u sʲ
<|RUS|>присчитывай	p rʲ i ɕː i t i v a j
<|RUS|>оттаяло	a t a j i ɫ a
<|RUS|>опушалась	a p u ʂ a ɫ a sʲ
<|RUS|>поклонничество	p a k ɫ o nʲ i t͡ɕ i s t v a
<|RUS|>аблаутов	a b ɫ a u t a f
<|RUS|>отекаю	a tʲ i k a j u
<|RUS|>стипендий	sʲ tʲ i pʲ e nʲ dʲ i j
<|RUS|>кромкой	k r o m k a j
<|RUS|>вляпался	v lʲ a p a ɫ s ⁽ʲ ⁾ a
<|RUS|>уверовать	u vʲ e r a v a tʲ
<|RUS|>тускневши	t u s k nʲ e f ʂ i
<|RUS|>прокалываешь	p r a k a ɫ i v a j i ʂ
<|RUS|>сконфузят	s k a n f u zʲ a t
<|RUS|>извиняли	i z vʲ i nʲ a lʲ i
<|RUS|>пофигизмами	p a fʲ i ɡʲ i z m a mʲ i
<|RUS|>мурзиками	m u r zʲ i k a mʲ i
<|RUS|>реквизициями	rʲ i k vʲ i zʲ i t͡s i j a mʲ i
<|RUS|>администрациях	a d mʲ i nʲ i s t r a t͡s i j a x
<|RUS|>оттащила	a t a ɕː i ɫ a
<|RUS|>сроднивший	s r a dʲ nʲ i f ʂ i j
<|RUS|>недолюбливайте	nʲ i d a lʲ u b lʲ i v a j tʲ e
<|RUS|>множится	m n o ʐ i t͡s a
<|RUS|>нарды	n a r d i
<|RUS|>истеки	i sʲ tʲ i kʲ i
<|RUS|>правоохранительный	p r a v a a x r a nʲ i tʲ i lʲ n i j
<|RUS|>выскабливая	v i s k a b lʲ i v a j a
<|RUS|>аудите	a u dʲ i tʲ e
<|RUS|>обвил	a b vʲ i ɫ
<|RUS|>шепнув	ʂ i p n u f
<|RUS|>горкой	ɡ o r k a j
<|RUS|>флексийный	f lʲ i k sʲ i j n i j
<|RUS|>святою	s vʲ i t o j u
<|RUS|>кастаньеты	k a s t a nʲ j e t i
<|RUS|>подействовать	p a dʲ e j s t v a v a tʲ
<|RUS|>кебабах	kʲ i b a b a x
<|RUS|>оживляйтесь	a ʐ i v lʲ a j tʲ i sʲ
<|RUS|>осклабляю	a s k ɫ a b lʲ a j u
<|RUS|>уклонении	u k ɫ a nʲ e nʲ i i
<|RUS|>адекватностях	a d i k v a t n a sʲ tʲ a x
<|RUS|>анализирует	a n a lʲ i zʲ i r u j i t
<|RUS|>лосося	ɫ a s o sʲ a
<|RUS|>бабосам	b a b o s a m
<|RUS|>восстанут	v a s t a n u t
<|RUS|>красив	k r a sʲ i f
<|RUS|>чайковский	t͡ɕ i j k o f s kʲ i j
<|RUS|>асинхронный	a sʲ i n x r o n i j
<|RUS|>мировыми	mʲ i r a v i mʲ i
<|RUS|>вакансию	v a k a n ⁽ʲ ⁾ sʲ i j u
<|RUS|>водяного	v a dʲ i n o v a
<|RUS|>обросший	a b r o ʂ i j
<|RUS|>текилах	tʲ i kʲ i ɫ a x
<|RUS|>насаждавши	n a s a ʐ d a f ʂ i
<|RUS|>дискетах	dʲ i s kʲ e t a x
<|RUS|>приплясывать	p rʲ i p lʲ a s i v a tʲ
<|RUS|>плешь	p lʲ e ʂ
<|RUS|>предъявится	p rʲ i d j a vʲ i t͡s a
<|RUS|>размягчаемый	r a z mʲ i x t͡ɕ a j i m i j
<|RUS|>запрягут	z a p rʲ i ɡ u t
<|RUS|>настучав	n a s t u t͡ɕ a f
<|RUS|>губерниях	ɡ u bʲ e r nʲ i j a x
<|RUS|>унесётесь	u nʲ i sʲ o tʲ i sʲ
<|RUS|>раскачиваемся	r a s k a t͡ɕ i v a j i m sʲ a
<|RUS|>больнаи	b a lʲ n a i
<|RUS|>помазанников	p a m a z a nʲ i k a f
<|RUS|>нумерацией	n u mʲ i r a t͡s i j i j
<|RUS|>изготовлением	i z ɡ a t a v lʲ e nʲ i j i m
<|RUS|>держава	dʲ i r ʐ a v a
<|RUS|>умиришь	u mʲ i rʲ i ʂ
<|RUS|>убежим	u bʲ i ʐ i m
<|RUS|>доводят	d a v o dʲ a t
<|RUS|>отбудьте	a d b u tʲː e
<|RUS|>хиты	xʲ i t i
<|RUS|>силаче	sʲ i ɫ a t͡ɕ e
<|RUS|>прерывавши	p rʲ i r i v a f ʂ i
<|RUS|>зондируем	z a nʲ dʲ i r u j i m
<|RUS|>упроси	u p r a sʲ i
<|RUS|>гирям	ɡʲ i rʲ a m
<|RUS|>назначении	n a z n a t͡ɕ e nʲ i i
<|RUS|>облепляемый	a b lʲ i p lʲ a j i m i j
<|RUS|>реабилитируем	rʲ i a bʲ i lʲ i tʲ i r u j i m
<|RUS|>ликбезам	lʲ i ɡ bʲ e z a m
<|RUS|>мотылькам	m a t i lʲ k a m
<|RUS|>ускоришься	u s k o rʲ i ʂ sʲ a
<|RUS|>фасолей	f a s o lʲ i j
<|RUS|>дуэта	d u e t a
<|RUS|>мимикрий	mʲ i mʲ i k rʲ i j
<|RUS|>мейтнериев	mʲ i j tʲ nʲ e rʲ i j i f
<|RUS|>склеило	s k lʲ e i ɫ a
<|RUS|>буревестника	b u rʲ i vʲ e sʲ nʲ i k a
<|RUS|>благоустрой	b ɫ a ɡ a u s t r o j
<|RUS|>заглинизированности	z a ɡ lʲ i nʲ i zʲ i r a v a n a sʲ tʲ i
<|RUS|>укреплений	u k rʲ i p lʲ e nʲ i j
<|RUS|>гостю	ɡ o sʲ tʲ u
<|RUS|>сгущаюсь	z ɡ u ɕː a j u sʲ
<|RUS|>разговляются	r a z ɡ a v lʲ a j u t͡s a
<|RUS|>биотоксичность	bʲ i a t a k sʲ i t͡ɕ n a sʲ tʲ
<|RUS|>клавдия	k ɫ a v dʲ i j a
<|RUS|>деканаты	d i k a n a t i
<|RUS|>возобновите	v a z a b n a vʲ i tʲ e
<|RUS|>укрылся	u k r i ɫ s ⁽ʲ ⁾ a
<|RUS|>рожаете	r a ʐ a j i tʲ e
<|RUS|>угрожающий	u ɡ r a ʐ a j u ɕː i j
<|RUS|>толковании	t a ɫ k a v a nʲ i i
<|RUS|>деревяшкой	dʲ i rʲ i vʲ a ʂ k a j
<|RUS|>сачкуйте	s a t͡ɕ k u j tʲ e
<|RUS|>гвардейца	ɡ v a r dʲ e j t͡s a
<|RUS|>завешивайте	z a vʲ e ʂ i v a j tʲ e
<|RUS|>висело	vʲ i sʲ e ɫ a
<|RUS|>капибарами	k a pʲ i b a r a mʲ i
<|RUS|>растило	r a sʲ tʲ i ɫ a
<|RUS|>вазочками	v a z a t͡ɕ k a mʲ i
<|RUS|>льдинок	lʲ dʲ i n a k
<|RUS|>туземцами	t u zʲ e m t͡s a mʲ i
<|RUS|>чахотке	t͡ɕ i x o t kʲ e
<|RUS|>привстающий	p rʲ i f s t a j u ɕː i j
<|RUS|>реликта	rʲ i lʲ i k t a
<|RUS|>отдалять	a d a lʲ a tʲ
<|RUS|>блумфонтейн	b ɫ u m f a n t i j n
<|RUS|>отставший	a t͡s s t a f ʂ i j
<|RUS|>токсичный	t a k sʲ i t͡ɕ n i j
<|RUS|>валенком	v a lʲ i n k a m
<|RUS|>приземлявшийся	p rʲ i zʲ i m lʲ a f ʂ i j sʲ a
<|RUS|>невежественна	nʲ i vʲ e ʐ i s t vʲ i n a
<|RUS|>артистка	a r tʲ i s t k a
<|RUS|>шампуня	ʂ a m p u nʲ a
<|RUS|>негодованию	nʲ i ɡ a d a v a nʲ i j u
<|RUS|>приготовлением	p rʲ i ɡ a t a v lʲ e nʲ i j i m
<|RUS|>магнатов	m a ɡ n a t a f
<|RUS|>вступлениях	f s t u p lʲ e nʲ i j a x
<|RUS|>окопа	a k o p a
<|RUS|>озарила	a z a rʲ i ɫ a
<|RUS|>отворачивающийся	a t v a r a t͡ɕ i v a j u ɕː i j sʲ a
<|RUS|>простудивши	p r a s t u dʲ i f ʂ i
<|RUS|>комиссиями	k a mʲ i sʲ i j a mʲ i
<|RUS|>расхищав	r a s xʲ i ɕː a f
<|RUS|>нарекла	n a rʲ i k ɫ a
<|RUS|>сровняйте	s r a v nʲ a j tʲ e
<|RUS|>осияваешь	a sʲ i j i v a j i ʂ
<|RUS|>инактивирую	i n a k tʲ i vʲ i r u j u
<|RUS|>умудрит	u m u d rʲ i t
<|RUS|>гуглите	ɡ u ɡ lʲ i tʲ e
<|RUS|>пропитывав	p r a pʲ i t i v a f
<|RUS|>самоцвета	s a m a t͡s vʲ e t a
<|RUS|>толстяком	t a ɫ s ⁽ʲ ⁾ tʲ i k o m
<|RUS|>всклокоченный	f s k ɫ a k o t͡ɕ i n i j
<|RUS|>нервничавший	nʲ e r v nʲ i t͡ɕ i f ʂ i j
<|RUS|>борющийся	b o rʲ u ɕː i j sʲ a
<|RUS|>зачитывайся	z a t͡ɕ i t i v a j sʲ a
<|RUS|>остужав	a s t u ʐ a f
<|RUS|>лосьонам	ɫ a sʲ j o n a m
<|RUS|>вальцующий	v a lʲ t͡s u j u ɕː i j
<|RUS|>распиная	r a s pʲ i n a j a
<|RUS|>топазу	t a p a z u
<|RUS|>телетекстах	tʲ e lʲ i tʲ e k s t a x
<|RUS|>подзаголовков	p a d͡z z a ɡ a ɫ o f k a f
<|RUS|>ревел	rʲ i vʲ e ɫ
<|RUS|>благословимся	b ɫ a ɡ a s ɫ a vʲ i m sʲ a
<|RUS|>какую	k a k u j u
<|RUS|>зажглись	z a ʐ ɡ lʲ i sʲ
<|RUS|>орошу	a r a ʂ u
<|RUS|>шарахать	ʂ a r a x a tʲ
<|RUS|>руководств	r u k a v o t͡s t f
<|RUS|>клянчу	k lʲ a nʲ t͡ɕ u
<|RUS|>зацепляло	z a t͡s i p lʲ a ɫ a
<|RUS|>абаданце	a b a d a n t͡s i
<|RUS|>реяв	rʲ e j i f
<|RUS|>ранетки	r a nʲ e t kʲ i
<|RUS|>покладая	p a k ɫ a d a j a
<|RUS|>предпишем	p rʲ i t pʲ i ʂ i m
<|RUS|>бороздим	b a r a zʲ dʲ i m
<|RUS|>нуворишам	n u v a rʲ i ʂ a m
<|RUS|>арке	a r kʲ e
<|RUS|>взбегав	v z bʲ i ɡ a f
<|RUS|>гуманизме	ɡ u m a nʲ i z mʲ e
<|RUS|>рожью	r o ʐ j u
<|RUS|>гидраты	ɡʲ i d r a t i
<|RUS|>доверительностям	d a vʲ i rʲ i tʲ i lʲ n a sʲ tʲ a m
<|RUS|>холодавши	x a ɫ a d a f ʂ i
<|RUS|>тюльпана	tʲ u lʲ p a n a
<|RUS|>выкрасило	v i k r a sʲ i ɫ a
<|RUS|>взвинчивал	v z vʲ i nʲ t͡ɕ i v a ɫ
<|RUS|>вуй	v u j
<|RUS|>маразмы	m a r a z m i
<|RUS|>дисгармониею	dʲ i z ɡ a r m o nʲ i j i j u
<|RUS|>ломаку	ɫ a m a k u
<|RUS|>памятей	p a mʲ i tʲ i j
<|RUS|>вседозволенностях	f sʲ i d a z v o lʲ i n a sʲ tʲ a x
<|RUS|>куркумой	k u r k u m a j
<|RUS|>тушуй	t u ʂ u j
<|RUS|>заносит	z a n o sʲ i t
<|RUS|>киноаппаратом	kʲ i n a a p a r a t a m
<|RUS|>припоминаешь	p rʲ i p a mʲ i n a j i ʂ
<|RUS|>зевал	zʲ i v a ɫ
<|RUS|>накалывать	n a k a ɫ i v a tʲ
<|RUS|>контрактниках	k a n t r a k tʲ nʲ i k a x
<|RUS|>обучавшийся	a b u t͡ɕ a f ʂ i j sʲ a
<|RUS|>упоминаются	u p a mʲ i n a j u t͡s a
<|RUS|>абдеритами	a b dʲ i rʲ i t a mʲ i
<|RUS|>теребейчук	tʲ i rʲ i bʲ i j t͡ɕ u k
<|RUS|>учугов	u t͡ɕ u ɡ a f
<|RUS|>изведав	i z vʲ e d a f
<|RUS|>дополнивший	d a p o ɫ nʲ i f ʂ i j
<|RUS|>давлениям	d a v lʲ e nʲ i j a m
<|RUS|>приколоть	p rʲ i k a ɫ o tʲ
<|RUS|>колосьям	k a ɫ o sʲ j a m
<|RUS|>монголом	m a n ɡ o ɫ a m
<|RUS|>высевок	v i sʲ i v a k
<|RUS|>затешешь	z a tʲ e ʂ i ʂ
<|RUS|>дураков	d u r a k o f
<|RUS|>коренившись	k a rʲ i nʲ i f ʂ i sʲ
<|RUS|>тулии	t u lʲ i i
<|RUS|>выкраиваются	v i k r a i v a j u t͡s a
<|RUS|>мнений	m nʲ e nʲ i j
<|RUS|>просветлевший	p r a s vʲ i t lʲ e f ʂ i j
<|RUS|>первые	pʲ e r v i j e
<|RUS|>буханке	b u x a n kʲ e
<|RUS|>светиться	s vʲ i tʲ i t͡s a
<|RUS|>завораживать	z a v a r a ʐ i v a tʲ
<|RUS|>епитрахилей	j i pʲ i t r a xʲ i lʲ i j
<|RUS|>статейкой	s t a tʲ e j k a j
<|RUS|>вмазывай	v m a z i v a j
<|RUS|>прощанья	p r a ɕː a nʲ j a
<|RUS|>кочевнике	k a t͡ɕ e v nʲ i kʲ e
<|RUS|>хлебцем	x lʲ e p t͡s i m
<|RUS|>употребляли	u p a t rʲ i b lʲ a lʲ i
<|RUS|>хадиса	x a dʲ i s a
<|RUS|>ощетинила	a ɕː i tʲ i nʲ i ɫ a
<|RUS|>сочинением	s a t͡ɕ i nʲ e nʲ i j i m
<|RUS|>приползать	p rʲ i p a ɫ z a tʲ
<|RUS|>съедутся	s j e d u t͡s a
<|RUS|>цесарем	t͡s e s a rʲ i m
<|RUS|>сосною	s a s n o j u
<|RUS|>патрульному	p a t r u lʲ n a m u
<|RUS|>гобелене	ɡ a bʲ i lʲ e nʲ e
<|RUS|>анусах	a n u s a x
<|RUS|>исписывало	i s pʲ i s i v a ɫ a
<|RUS|>бесноватыми	bʲ i s n a v a t i mʲ i
<|RUS|>ризе	rʲ i zʲ e
<|RUS|>террористе	t i r a rʲ i sʲ tʲ e
<|RUS|>прислужили	p rʲ i s ɫ u ʐ i lʲ i
<|RUS|>ослихам	a s ⁽ʲ ⁾ lʲ i x a m
<|RUS|>артистке	a r tʲ i s t kʲ e
<|RUS|>облюю	a b lʲ u j u
<|RUS|>вкрадывалась	f k r a d i v a ɫ a sʲ
<|RUS|>перетекли	pʲ i rʲ i tʲ i k lʲ i
<|RUS|>поправишь	p a p r a vʲ i ʂ
<|RUS|>окаю	o k a j u
<|RUS|>резнями	rʲ i zʲ nʲ a mʲ i
<|RUS|>подворотне	p a d v a r o tʲ nʲ e
<|RUS|>жажда	ʐ a ʐ d a
<|RUS|>прожидях	p r o ʐ i dʲ a x
<|RUS|>хаяли	x a j i lʲ i
<|RUS|>свечнике	s vʲ i t͡ɕ nʲ i kʲ e
<|RUS|>обнажите	a b n a ʐ i tʲ e
<|RUS|>раздвинулись	r a z d vʲ i n u lʲ i sʲ
<|RUS|>подметайте	p a d mʲ i t a j tʲ e
<|RUS|>скороговорка	s k a r a ɡ a v o r k a
<|RUS|>осмотрами	a s m o t r a mʲ i
<|RUS|>крошенный	k r o ʂ i n i j
<|RUS|>растревоживают	r a s t rʲ i v o ʐ i v a j u t
<|RUS|>загар	z a ɡ a r
<|RUS|>толкалось	t a ɫ k a ɫ a sʲ
<|RUS|>сердцебиениях	sʲ i r t͡s i bʲ i j e nʲ i j a x
<|RUS|>обветшалый	a b vʲ i t͡ʂ ʂ a ɫ i j
<|RUS|>трактуете	t r a k t u j i tʲ e
<|RUS|>ненадобный	nʲ i n a d a b n i j
<|RUS|>слёзы	s ⁽ʲ ⁾ lʲ o z i
<|RUS|>перетягивавши	pʲ i rʲ i tʲ a ɡʲ i v a f ʂ i
<|RUS|>ободам	o b a d a m
<|RUS|>увезёшь	u vʲ i zʲ o ʂ
<|RUS|>преградивший	p rʲ i ɡ r a dʲ i f ʂ i j
<|RUS|>засвистим	z a s vʲ i sʲ tʲ i m
<|RUS|>киноактрисой	kʲ i n a a k t rʲ i s a j
<|RUS|>уединявшись	u j i dʲ i nʲ a f ʂ i sʲ
<|RUS|>активизируете	a k tʲ i vʲ i zʲ i r u j i tʲ e
<|RUS|>огонькам	a ɡ a nʲ k a m
<|RUS|>дымили	d i mʲ i lʲ i
<|RUS|>аккомпанировали	a k a m p a nʲ i r a v a lʲ i
<|RUS|>бутилируют	b u tʲ i lʲ i r u j u t
<|RUS|>владиславом	v ɫ a dʲ i s ɫ a v a m
<|RUS|>толкнёшь	t a ɫ k nʲ o ʂ
<|RUS|>затирая	z a tʲ i r a j a
<|RUS|>пользованиях	p o lʲ z a v a nʲ i j a x
<|RUS|>прапорщик	p r a p a r ɕː i k
<|RUS|>соревнуйтесь	s a rʲ i v n u j tʲ i sʲ
<|RUS|>фабрикую	f a b rʲ i k u j u
<|RUS|>восприняла	v a s p rʲ i nʲ i ɫ a
<|RUS|>похоронишь	p a x a r o nʲ i ʂ
<|RUS|>сходна	s x o d n a
<|RUS|>возвышенно	v a z v i ʂ i n a
<|RUS|>автогене	a f t a ɡʲ e nʲ e
<|RUS|>промокавший	p r a m a k a f ʂ i j
<|RUS|>перегрелись	pʲ i rʲ i ɡ rʲ e lʲ i sʲ
<|RUS|>подготовляйте	p a d ɡ a t a v lʲ a j tʲ e
<|RUS|>потребностях	p a t rʲ e b n a sʲ tʲ a x
<|RUS|>одаривая	a d a rʲ i v a j a
<|RUS|>чугунно	t͡ɕ u ɡ u n a
<|RUS|>отваживаемся	a t v a ʐ i v a j i m sʲ a
<|RUS|>презумпциями	p rʲ i z u m p t͡s i j a mʲ i
<|RUS|>расстраивался	r a s t r a i v a ɫ s ⁽ʲ ⁾ a
<|RUS|>довлело	d a v lʲ e ɫ a
<|RUS|>смрадишь	s m r a dʲ i ʂ
<|RUS|>адсорбировав	a t͡s s a r bʲ i r a v a f
<|RUS|>рефракторе	rʲ i f r a k t a rʲ e
<|RUS|>излияниями	i z ⁽ʲ ⁾ lʲ i j a nʲ i j a mʲ i
<|RUS|>гобеленами	ɡ a bʲ i lʲ e n a mʲ i
<|RUS|>приглядывавшийся	p rʲ i ɡ lʲ a d i v a f ʂ i j sʲ a
<|RUS|>эксцессов	i k s t͡s e s a f
<|RUS|>взяточникам	v zʲ a t a t͡ɕ nʲ i k a m
<|RUS|>потёрла	p a tʲ o r ɫ a
<|RUS|>абстрактам	a p s t r a k t a m
<|RUS|>сосками	s o s k a mʲ i
<|RUS|>брёха	b rʲ o x a
<|RUS|>поблагодарить	p a b ɫ a ɡ a d a rʲ i tʲ
<|RUS|>жучков	ʐ u t͡ɕ k o f
<|RUS|>осечкам	a sʲ e t͡ɕ k a m
<|RUS|>специализмы	s pʲ i t͡s i a lʲ i z m i
<|RUS|>сертификата	sʲ i r tʲ i fʲ i k a t a
<|RUS|>гонореи	ɡ a n a rʲ e i
<|RUS|>украдёшь	u k r a dʲ o ʂ
<|RUS|>воздадите	v a z d a dʲ i tʲ e
<|RUS|>прожигаем	p r a ʐ i ɡ a j i m
<|RUS|>бутафорией	b u t a f o rʲ i j i j
<|RUS|>дисциплинировала	dʲ i s t͡s i p lʲ i nʲ i r a v a ɫ a
<|RUS|>осунется	a s u nʲ i t͡s a
<|RUS|>виновницах	vʲ i n o v nʲ i t͡s a x
<|RUS|>питомце	pʲ i t o m t͡s i
<|RUS|>замяло	z a mʲ a ɫ a
<|RUS|>порочили	p a r o t͡ɕ i lʲ i
<|RUS|>деточка	dʲ e t a t͡ɕ k a
<|RUS|>пересказываем	pʲ i rʲ i s k a z i v a j i m
<|RUS|>башке	b a ʂ kʲ e
<|RUS|>поблагодарим	p a b ɫ a ɡ a d a rʲ i m
<|RUS|>дублёнки	d u b lʲ o n kʲ i
<|RUS|>развернувший	r a z vʲ i r n u f ʂ i j
<|RUS|>противоположу	p r o tʲ i v a p a ɫ a ʐ u
<|RUS|>нюхальщики	nʲ u x a lʲ ɕː i kʲ i
<|RUS|>озари	a z a rʲ i
<|RUS|>отчужу	a t͡ɕ u ʐ u
<|RUS|>буферах	b u fʲ i r a x
<|RUS|>дотягивающийся	d a tʲ a ɡʲ i v a j u ɕː i j sʲ a
<|RUS|>венчания	vʲ i nʲ t͡ɕ a nʲ i j a
<|RUS|>окупленный	a k u p lʲ i n i j
<|RUS|>построит	p a s t r o i t
<|RUS|>уязвляя	u j i z v lʲ a j a
<|RUS|>поговорите	p a ɡ a v a rʲ i tʲ e
<|RUS|>царевна	t͡s a rʲ e v n a
<|RUS|>болте	b a ɫ tʲ e
<|RUS|>забил	z a bʲ i ɫ
<|RUS|>люкс	lʲ u k s
<|RUS|>сбило	z bʲ i ɫ a
<|RUS|>чаячий	t͡ɕ a j i t͡ɕ i j
<|RUS|>надававший	n a d a v a f ʂ i j
<|RUS|>конку	k o n k u
<|RUS|>усмехаясь	u s mʲ i x a j i sʲ
<|RUS|>привязь	p rʲ i vʲ i sʲ
<|RUS|>парадигмам	p a r a dʲ i ɡ m a m
<|RUS|>зачёркиваем	z a t͡ɕ o r kʲ i v a j i m
<|RUS|>сущностью	s u ɕː n a sʲ tʲ j u
<|RUS|>подмечавший	p a d mʲ i t͡ɕ a f ʂ i j
<|RUS|>реек	rʲ e j i k
<|RUS|>просветишь	p r a s vʲ e tʲ i ʂ
<|RUS|>нидерландского	nʲ i dʲ i r ɫ a n t s k a v a
<|RUS|>поладив	p a ɫ a dʲ i f
<|RUS|>новоангличанах	n o v a a n ɡ lʲ i t͡ɕ a n a x
<|RUS|>пожирает	p a ʐ i r a j i t
<|RUS|>тарифов	t a rʲ i f a f
<|RUS|>насчёт	n a ɕː o t
<|RUS|>распускавшись	r a s p u s k a f ʂ i sʲ
<|RUS|>забывался	z a b i v a ɫ s ⁽ʲ ⁾ a
<|RUS|>оклемаетесь	a k lʲ i m a j i tʲ i sʲ
<|RUS|>провозя	p r a v a zʲ a
<|RUS|>уделах	u dʲ e ɫ a x
<|RUS|>вытряхивает	v i t rʲ a xʲ i v a j i t
<|RUS|>затрудни	z a t r u dʲ nʲ i
<|RUS|>принимавшись	p rʲ i nʲ i m a f ʂ i sʲ
<|RUS|>прокладывающий	p r a k ɫ a d i v a j u ɕː i j
<|RUS|>русифицируешься	r u sʲ i fʲ i t͡s i r u j i ʂ sʲ a
<|RUS|>створу	s t v o r u
<|RUS|>расходовали	r a s x o d a v a lʲ i
<|RUS|>зачаровав	z a t͡ɕ i r a v a f
<|RUS|>чемпионами	t͡ɕ i m ⁽ʲ ⁾ pʲ i o n a mʲ i
<|RUS|>расчёсывалась	r a ɕ t͡ɕ o s i v a ɫ a sʲ
<|RUS|>заревом	z a rʲ i v a m
<|RUS|>неформально	nʲ i f a r m a lʲ n a
<|RUS|>отслеживает	a t͡s s ⁽ʲ ⁾ lʲ e ʐ i v a j i t
<|RUS|>приглядываем	p rʲ i ɡ lʲ a d i v a j i m
<|RUS|>брюссельский	b rʲ u sʲ e lʲ s kʲ i j
<|RUS|>роках	r o k a x
<|RUS|>раскручивало	r a s k r u t͡ɕ i v a ɫ a
<|RUS|>челнок	t͡ɕ i ɫ n o k
<|RUS|>ремешкам	rʲ i mʲ i ʂ k a m
<|RUS|>ведавший	vʲ e d a f ʂ i j
<|RUS|>иволгою	i v a ɫ ɡ a j u
<|RUS|>колледж	k o lʲ i t͡ʂ ʂ
<|RUS|>проверив	p r a vʲ e rʲ i f
<|RUS|>микросхемы	mʲ i k r a s xʲ e m i
<|RUS|>выясняешь	v i j i sʲ nʲ a j i ʂ
<|RUS|>надколеннике	n a t k a lʲ e nʲ i kʲ e
<|RUS|>перекусят	pʲ i rʲ i k u sʲ a t
<|RUS|>покрученный	p a k r u t͡ɕ i n i j
<|RUS|>затирав	z a tʲ i r a f
<|RUS|>перечтём	pʲ i rʲ i t͡ɕ tʲ o m
<|RUS|>подданству	p o d a n s t v u
<|RUS|>выливался	v i lʲ i v a ɫ s ⁽ʲ ⁾ a
<|RUS|>порастёт	p a r a sʲ tʲ o t
<|RUS|>провайдеры	p r a v a j d i r i
<|RUS|>полемику	p a lʲ e mʲ i k u
<|RUS|>переломлю	pʲ i rʲ i ɫ a m lʲ u
<|RUS|>разъём	r a z j o m
<|RUS|>изменяло	i z mʲ i nʲ a ɫ a
<|RUS|>абсорбатам	a p s a r b a t a m
<|RUS|>писателями	pʲ i s a tʲ i lʲ a mʲ i
<|RUS|>лад	ɫ a t
<|RUS|>ахи	a xʲ i
<|RUS|>извлекут	i z v lʲ i k u t
<|RUS|>взбираетесь	v z bʲ i r a j i tʲ i sʲ
<|RUS|>фотокарточками	f a t a k a r t a t͡ɕ k a mʲ i
<|RUS|>объедаемый	a b j i d a j i m i j
<|RUS|>завалитесь	z a v a lʲ i tʲ i sʲ
<|RUS|>закладывай	z a k ɫ a d i v a j
<|RUS|>урезывав	u rʲ e z i v a f
<|RUS|>приделать	p rʲ i dʲ e ɫ a tʲ
<|RUS|>переставить	pʲ i rʲ i s t a vʲ i tʲ
<|RUS|>кремниев	k rʲ e m nʲ i j i f
<|RUS|>всовавши	f s a v a f ʂ i
<|RUS|>цингою	t͡s i n ɡ o j u
<|RUS|>криптонов	k rʲ i p t o n a f
<|RUS|>гомони	ɡ a m a nʲ i
<|RUS|>думаем	d u m a j i m
<|RUS|>повязанный	p a vʲ a z a n i j
<|RUS|>застрелив	z a s t rʲ i lʲ i f
<|RUS|>апограф	a p o ɡ r a f
<|RUS|>подсолнухе	p a t͡s s o ɫ n u xʲ e
<|RUS|>прививай	p rʲ i vʲ i v a j
<|RUS|>буккеры	b u kʲ i r i
<|RUS|>юмористическая	j u m a rʲ i sʲ tʲ i t͡ɕ i s k a j a
<|RUS|>выдворявши	v i d v a rʲ a f ʂ i
<|RUS|>подлодке	p a d ɫ o t kʲ e
<|RUS|>лапали	ɫ a p a lʲ i
<|RUS|>отщепляйте	a t͡ɕ ɕː i p lʲ a j tʲ e
<|RUS|>заведованием	z a vʲ e d a v a nʲ i j i m
<|RUS|>смудрит	s m u d rʲ i t
<|RUS|>здесь	zʲ dʲ e sʲ
<|RUS|>заимейте	z a i mʲ e j tʲ e
<|RUS|>кувшинках	k u f ʂ i n k a x
<|RUS|>покатаешь	p a k a t a j i ʂ
<|RUS|>подшипникам	p a t͡ʂ ʂ i p nʲ i k a m
<|RUS|>несбыточный	nʲ i z b i t a t͡ɕ n i j
<|RUS|>стоил	s t o i ɫ
<|RUS|>заебать	z a j i b a tʲ
<|RUS|>заразятся	z a r a zʲ a t͡s a
<|RUS|>спросонок	s p r a s o n a k
<|RUS|>заперлись	z a pʲ i r lʲ i sʲ
<|RUS|>героинях	ɡʲ i r a i nʲ a x
<|RUS|>мучу	m u t͡ɕ u
<|RUS|>запираюсь	z a pʲ i r a j u sʲ
<|RUS|>непогрешимый	nʲ i p a ɡ rʲ i ʂ i m i j
<|RUS|>пакистанцы	p a kʲ i s t a n t͡s i
<|RUS|>повертит	p a vʲ e r tʲ i t
<|RUS|>епархия	j i p a r xʲ i j a
<|RUS|>покрышка	p a k r i ʂ k a
<|RUS|>театре	tʲ i a t a rʲ e
<|RUS|>тучности	t u t͡ɕ n a sʲ tʲ i
<|RUS|>спёр	s pʲ o r
<|RUS|>вставишься	f s t a vʲ i ʂ sʲ a
<|RUS|>выправлять	v i p r a v lʲ a tʲ
<|RUS|>ветшаем	vʲ i t͡ʂ ʂ a j i m
<|RUS|>надушу	n a d u ʂ u
<|RUS|>лизнув	lʲ i z n u f
<|RUS|>опасения	a p a sʲ e nʲ i j a
<|RUS|>переливает	pʲ i rʲ i lʲ i v a j i t
<|RUS|>чувствуйте	t͡ɕ u s t v u j tʲ e
<|RUS|>осушал	a s u ʂ a ɫ
<|RUS|>вводимся	v o dʲ i m sʲ a
<|RUS|>секунды	sʲ i k u n d i
<|RUS|>походом	p a x o d a m
<|RUS|>осведомляющийся	a s vʲ i d a m lʲ a j u ɕː i j sʲ a
<|RUS|>плюрализмам	p lʲ u r a lʲ i z m a m
<|RUS|>звенеть	z vʲ i nʲ e tʲ
<|RUS|>пейджер	p e j d͡ʐ ʐ i r
<|RUS|>повалила	p a v a lʲ i ɫ a
<|RUS|>аскетом	a s kʲ e t a m
<|RUS|>синтеза	sʲ i n t i z a
<|RUS|>киноплёнках	kʲ i n a p lʲ o n k a x
<|RUS|>клетку	k lʲ e t k u
<|RUS|>отворачиваюсь	a t v a r a t͡ɕ i v a j u sʲ
<|RUS|>закопушкой	z a k a p u ʂ k a j
<|RUS|>преобразовывавшийся	p rʲ i a b r a z o v i v a f ʂ i j sʲ a
<|RUS|>отборы	a d b o r i
<|RUS|>алкинов	a ɫ kʲ i n a f
<|RUS|>треклистах	t r i k lʲ i s t a x
<|RUS|>обнадёживай	a b n a dʲ o ʐ i v a j
<|RUS|>постылевший	p a s t i lʲ i f ʂ i j
<|RUS|>накалялась	n a k a lʲ a ɫ a sʲ
<|RUS|>горячностей	ɡ a rʲ a t͡ɕ n a sʲ tʲ i j
<|RUS|>отворачивай	a t v a r a t͡ɕ i v a j
<|RUS|>симулируй	sʲ i m u lʲ i r u j
<|RUS|>туманностях	t u m a n a sʲ tʲ a x
<|RUS|>усложняем	u s ɫ a ʐ nʲ a j i m
<|RUS|>разгоняете	r a z ɡ a nʲ a j i tʲ e
<|RUS|>трансляциям	t r a n s ⁽ʲ ⁾ lʲ a t͡s i j a m
<|RUS|>ударяемся	u d a rʲ a j i m sʲ a
<|RUS|>осмысливаемый	a s m i s ⁽ʲ ⁾ lʲ i v a j i m i j
<|RUS|>властолюбия	v ɫ a s t a lʲ u bʲ i j a
<|RUS|>залепляя	z a lʲ i p lʲ a j a
<|RUS|>волокут	v a ɫ a k u t
<|RUS|>шаромыгой	ʂ a r a m i ɡ a j
<|RUS|>черемшах	t͡ɕ i rʲ i m ʂ a x
<|RUS|>остротой	a s t r o t a j
<|RUS|>дружественен	d r u ʐ i s t vʲ i nʲ i n
<|RUS|>ассемблера	a s e m b lʲ i r a
<|RUS|>попросись	p a p r a sʲ i sʲ
<|RUS|>темпераментами	tʲ i m ⁽ʲ ⁾ pʲ i r a mʲ i n t a mʲ i
<|RUS|>утком	u t k o m
<|RUS|>пробурчала	p r a b u r t͡ɕ a ɫ a
<|RUS|>опробованный	a p r o b a v a n i j
<|RUS|>потаскушки	p a t a s k u ʂ kʲ i
<|RUS|>заискивали	z a i s kʲ i v a lʲ i
<|RUS|>гидрологиях	ɡʲ i d r a ɫ o ɡʲ i j a x
<|RUS|>спокойствии	s p a k o j s t vʲ i i
<|RUS|>табличку	t a b lʲ i t͡ɕ k u
<|RUS|>информационный	i n f a r m a t͡s i o n i j
<|RUS|>потопталось	p a t a p t a ɫ a sʲ
<|RUS|>интерпретированный	i n t i r p rʲ i tʲ i r a v a n i j
<|RUS|>кусаем	k u s a j i m
<|RUS|>насылаем	n a s i ɫ a j i m
<|RUS|>сталкиваюсь	s t a ɫ kʲ i v a j u sʲ
<|RUS|>накапливаем	n a k a p lʲ i v a j i m
<|RUS|>систола	sʲ i s t a ɫ a
<|RUS|>миньетчиком	mʲ i nʲ j e t͡ɕ i k a m
<|RUS|>краткам	k r a t k a m
<|RUS|>арумынкой	a r u m i n k a j
<|RUS|>вырисовываться	v i rʲ i s o v i v a t͡s a
<|RUS|>обидами	a bʲ i d a mʲ i
<|RUS|>состряпаете	s a s t rʲ a p a j i tʲ e
<|RUS|>одышка	a d i ʂ k a
<|RUS|>тротуару	t r a t u a r u
<|RUS|>безобразием	bʲ i z a b r a zʲ i j i m
<|RUS|>выспрашиваемый	v i s p r a ʂ i v a j i m i j
<|RUS|>плацента	p ɫ a t͡s e n t a
<|RUS|>фургону	f u r ɡ o n u
<|RUS|>выворачиваете	v i v a r a t͡ɕ i v a j i tʲ e
<|RUS|>выражен	v i r a ʐ i n
<|RUS|>соизволением	s a i z v a lʲ e nʲ i j i m
<|RUS|>раздельно	r a zʲ dʲ e lʲ n a
<|RUS|>олимпийкою	a lʲ i m ⁽ʲ ⁾ pʲ i j k a j u
<|RUS|>сформулировал	s f a r m u lʲ i r a v a ɫ
<|RUS|>вскинул	f s kʲ i n u ɫ
<|RUS|>переболевала	pʲ i rʲ i b a lʲ i v a ɫ a
<|RUS|>съязвил	s j i z vʲ i ɫ
<|RUS|>должные	d o ɫ ʐ n i j e
<|RUS|>вытворяешь	v i t v a rʲ a j i ʂ
<|RUS|>поведываете	p a vʲ e d i v a j i tʲ e
<|RUS|>пригибают	p rʲ i ɡʲ i b a j u t
<|RUS|>сигало	sʲ i ɡ a ɫ a
<|RUS|>опаску	a p a s k u
<|RUS|>амбра	a m b r a
<|RUS|>катране	k a t r a nʲ e
<|RUS|>снашивала	s n a ʂ i v a ɫ a
<|RUS|>смыкал	s m i k a ɫ
<|RUS|>сигналю	sʲ i ɡ n a lʲ u
<|RUS|>разрознивши	r a z r o zʲ nʲ i f ʂ i
<|RUS|>заменялись	z a mʲ i nʲ a lʲ i sʲ
<|RUS|>ухаживавши	u x a ʐ i v a f ʂ i
<|RUS|>налегке	n a lʲ i xʲ kʲ e
<|RUS|>жидкостями	ʐ i t k a sʲ tʲ a mʲ i
<|RUS|>свинина	s vʲ i nʲ i n a
<|RUS|>рисовал	rʲ i s a v a ɫ
<|RUS|>ливийка	lʲ i vʲ i j k a
<|RUS|>чохой	t͡ɕ i x o j
<|RUS|>аллюзиями	a lʲ u zʲ i j a mʲ i
<|RUS|>шумов	ʂ u m a f
<|RUS|>хачике	x a t͡ɕ i kʲ e
<|RUS|>текил	tʲ i kʲ i ɫ
<|RUS|>понудит	p a n u dʲ i t
<|RUS|>самосвалах	s a m a s v a ɫ a x
<|RUS|>вскриков	f s k rʲ i k a f
<|RUS|>силиконы	sʲ i lʲ i k o n i
<|RUS|>плевав	p lʲ i v a f
<|RUS|>тыква	t i k v a
<|RUS|>распространяйся	r a s p r a s t r a nʲ a j sʲ a
<|RUS|>варьируют	v a rʲ j i r u j u t
<|RUS|>интриган	i n t rʲ i ɡ a n
<|RUS|>просвещай	p r a s vʲ i ɕː a j
<|RUS|>завернуть	z a vʲ i r n u tʲ
<|RUS|>поживавший	p a ʐ i v a f ʂ i j
<|RUS|>адсорбируя	a t͡s s a r bʲ i r u j a
<|RUS|>оперативностью	a pʲ i r a tʲ i v n a sʲ tʲ j u
<|RUS|>пополнять	p a p a ɫ nʲ a tʲ
<|RUS|>врезаете	v rʲ i z a j i tʲ e
<|RUS|>приятны	p rʲ i j a t n i
<|RUS|>утопаем	u t o p a j i m
<|RUS|>поели	p a j e lʲ i
<|RUS|>манкой	m a n k a j
<|RUS|>садит	s a dʲ i t
<|RUS|>опушавшись	a p u ʂ a f ʂ i sʲ
<|RUS|>антидоте	a nʲ tʲ i d o tʲ e
<|RUS|>комбинируешь	k a m ⁽ʲ ⁾ bʲ i nʲ i r u j i ʂ
<|RUS|>сопроводишь	s a p r a v a dʲ i ʂ
<|RUS|>нормированиями	n a r mʲ i r a v a nʲ i j a mʲ i
<|RUS|>кувшинку	k u f ʂ i n k u
<|RUS|>досадовавший	d a s a d a v a f ʂ i j
<|RUS|>орешь	o rʲ i ʂ
<|RUS|>пригодность	p rʲ i ɡ o d n a sʲ tʲ
<|RUS|>сыроваров	s i r a v a r a f
<|RUS|>октябрь	a k tʲ a b rʲ
<|RUS|>прожёвываемый	p r a ʐ o v i v a j i m i j
<|RUS|>касайтесь	k a s a j tʲ i sʲ
<|RUS|>женит	ʐ e nʲ i t
<|RUS|>жёрнов	ʐ o r n a f
<|RUS|>отпугивало	a t p u ɡʲ i v a ɫ a
<|RUS|>файликах	f a j lʲ i k a x
<|RUS|>изобарою	i z a b a r a j u
<|RUS|>размежует	r a z mʲ i ʐ u j i t
<|RUS|>опушайся	a p u ʂ a j sʲ a
<|RUS|>баклага	b a k ɫ a ɡ a
<|RUS|>категоричностей	k a tʲ i ɡ a rʲ i t͡ɕ n a sʲ tʲ i j
<|RUS|>выводкам	v i v a t k a m
<|RUS|>взвешивавши	v z vʲ e ʂ i v a f ʂ i
<|RUS|>проиграешь	p r a i ɡ r a j i ʂ
<|RUS|>энергоносители	i n e r ɡ a n a sʲ i tʲ i lʲ i
<|RUS|>погрешу	p a ɡ rʲ i ʂ u
<|RUS|>промахах	p r o m a x a x
<|RUS|>опером	o pʲ i r a m
<|RUS|>заела	z a j e ɫ a
<|RUS|>котировать	k a tʲ i r a v a tʲ
<|RUS|>неустроенностям	nʲ i u s t r o j i n a sʲ tʲ a m
<|RUS|>подчёркивают	p a t͡ɕ o r kʲ i v a j u t
<|RUS|>генетикам	ɡʲ i n e tʲ i k a m
<|RUS|>каскадам	k a s k a d a m
<|RUS|>вкладывают	f k ɫ a d i v a j u t
<|RUS|>питону	pʲ i t o n u
<|RUS|>искалечило	i s k a lʲ e t͡ɕ i ɫ a
<|RUS|>неумерен	nʲ i u mʲ e rʲ i n
<|RUS|>финансировало	fʲ i n a n ⁽ʲ ⁾ sʲ i r a v a ɫ a
<|RUS|>общо	a p ɕː o
<|RUS|>вампирах	v a m ⁽ʲ ⁾ pʲ i r a x
<|RUS|>выловят	v i ɫ a vʲ a t
<|RUS|>наноса	n a n o s a
<|RUS|>присмотрев	p rʲ i s m a t rʲ e f
<|RUS|>богословы	b a ɡ a s ɫ o v i
<|RUS|>расстилавши	r a sʲ tʲ i ɫ a f ʂ i
<|RUS|>искорёжило	i s k a rʲ o ʐ i ɫ a
<|RUS|>отчисляем	a t͡ɕ i s ⁽ʲ ⁾ lʲ a j i m
<|RUS|>выдачею	v i d a t͡ɕ i j u
<|RUS|>родословными	r a d a s ɫ o v n i mʲ i
<|RUS|>околёсицах	a k a lʲ o sʲ i t͡s a x
<|RUS|>мораторий	m a r a t o rʲ i j
<|RUS|>штрафовал	ʂ t r a f a v a ɫ
<|RUS|>заутрень	z a u t rʲ i nʲ
<|RUS|>придаваемый	p rʲ i d a v a j i m i j
<|RUS|>сдавило	z d a vʲ i ɫ a
<|RUS|>стремянку	s t rʲ i mʲ a n k u
<|RUS|>времечке	v rʲ e mʲ i t͡ɕ kʲ e
<|RUS|>понимаетесь	p a nʲ i m a j i tʲ i sʲ
<|RUS|>присудим	p rʲ i s u dʲ i m
<|RUS|>скорректировал	s k a rʲ i k tʲ i r a v a ɫ
<|RUS|>искусите	i s k u sʲ i tʲ e
<|RUS|>свергала	s vʲ i r ɡ a ɫ a
<|RUS|>трудовой	t r u d a v o j
<|RUS|>заблагорассудим	z a b ɫ a ɡ a r a s u dʲ i m
<|RUS|>пожелтеем	p a ʐ i ɫ tʲ e j i m
<|RUS|>грузимый	ɡ r u zʲ i m i j
<|RUS|>спарывали	s p a r i v a lʲ i
<|RUS|>востоковедам	v a s t a k a vʲ e d a m
<|RUS|>правобережный	p r a v a bʲ i rʲ e ʐ n i j
<|RUS|>жерлах	ʐ e r ɫ a x
<|RUS|>бесполезный	bʲ i s p a lʲ e z n i j
<|RUS|>выпрямлял	v i p rʲ i m lʲ a ɫ
<|RUS|>вытряхнешь	v i t rʲ i x nʲ i ʂ
<|RUS|>ватка	v a t k a
<|RUS|>садку	s a t k u
<|RUS|>заколебать	z a k a lʲ i b a tʲ
<|RUS|>разживалась	r a ʐ i v a ɫ a sʲ
<|RUS|>ворвитесь	v a r vʲ i tʲ i sʲ
<|RUS|>задремлют	z a d rʲ e m lʲ u t
<|RUS|>раскраской	r a s k r a s k a j
<|RUS|>курский	k u r s kʲ i j
<|RUS|>гувернантку	ɡ u vʲ i r n a n t k u
<|RUS|>бризантностях	b rʲ i z a n t n a sʲ tʲ a x
<|RUS|>дружила	d r u ʐ i ɫ a
<|RUS|>контроллера	k a n t r o lʲ i r a
<|RUS|>оканчивавшись	a k a nʲ t͡ɕ i v a f ʂ i sʲ
<|RUS|>тупишь	t u pʲ i ʂ
<|RUS|>библиотекарша	bʲ i b lʲ i a tʲ e k a r ʂ a
<|RUS|>сраженью	s r a ʐ e nʲ j u
<|RUS|>кошелях	k a ʂ i lʲ a x
<|RUS|>вкалывая	f k a ɫ i v a j a
<|RUS|>сливами	s ⁽ʲ ⁾ lʲ i v a mʲ i
<|RUS|>полутьмах	p a ɫ u tʲ m a x
<|RUS|>выдают	v i d a j u t
<|RUS|>путаюсь	p u t a j u sʲ
<|RUS|>совратили	s a v r a tʲ i lʲ i
<|RUS|>мановении	m a n a vʲ e nʲ i i
<|RUS|>матрасами	m a t r a s a mʲ i
<|RUS|>лесоматериалам	lʲ e s a m a tʲ i rʲ i a ɫ a m
<|RUS|>привяжу	p rʲ i vʲ i ʐ u
<|RUS|>деспотами	dʲ e s p a t a mʲ i
<|RUS|>пропитаниях	p r a pʲ i t a nʲ i j a x
<|RUS|>отворяв	a t v a rʲ a f
<|RUS|>мясорубками	mʲ i s a r u p k a mʲ i
<|RUS|>укутавши	u k u t a f ʂ i
<|RUS|>дынями	d i nʲ a mʲ i
<|RUS|>мудоёба	m u d a j o b a
<|RUS|>подстраховал	p a t͡s s t r a x a v a ɫ
<|RUS|>обзвонит	a b z v a nʲ i t
<|RUS|>лейкозом	lʲ i j k o z a m
<|RUS|>установит	u s t a n o vʲ i t
<|RUS|>совершатся	s a vʲ i r ʂ a t͡s a
<|RUS|>десятиугольнику	dʲ i sʲ i tʲ i u ɡ o lʲ nʲ i k u
<|RUS|>упрятав	u p rʲ a t a f
<|RUS|>щитках	ɕː i t k a x
<|RUS|>недоедавший	nʲ i d a j i d a f ʂ i j
<|RUS|>запросят	z a p r o sʲ a t
<|RUS|>лженаука	ɫ ʐ i n a u k a
<|RUS|>вёзся	vʲ o sʲ a
<|RUS|>одинока	a dʲ i n o k a
<|RUS|>выдавливая	v i d a v lʲ i v a j a
<|RUS|>котелки	k a tʲ i ɫ kʲ i
<|RUS|>придерусь	p rʲ i dʲ i r u sʲ
<|RUS|>типажах	tʲ i p a ʐ a x
<|RUS|>ангстрем	a n k s t r i m
<|RUS|>жестокий	ʐ i s t o kʲ i j
<|RUS|>посвистывали	p a s vʲ i s t i v a lʲ i
<|RUS|>удочерениях	u d a t͡ɕ i rʲ e nʲ i j a x
<|RUS|>азиками	a zʲ i k a mʲ i
<|RUS|>привинти	p rʲ i vʲ i nʲ tʲ i
<|RUS|>синхронизаций	sʲ i n x r a nʲ i z a t͡s i j
<|RUS|>заржаветь	z a r ʐ a vʲ i tʲ
<|RUS|>отлежалась	a t lʲ i ʐ a ɫ a sʲ
<|RUS|>девайсам	dʲ i v a j s a m
<|RUS|>эликсиром	i lʲ i k sʲ i r a m
<|RUS|>взмётываемый	v z mʲ o t i v a j i m i j
<|RUS|>откраиваешь	a t k r a i v a j i ʂ
<|RUS|>пионеру	pʲ i a nʲ e r u
<|RUS|>акойт	a k o j t
<|RUS|>дотаскав	d a t a s k a f
<|RUS|>завершало	z a vʲ i r ʂ a ɫ a
<|RUS|>нику	nʲ i k u
<|RUS|>разъяряете	r a z j i rʲ a j i tʲ e
