<|rus|>явственно	j a f s t vʲ i n a
<|rus|>гомер	ɡ a mʲ e r
<|rus|>сплетавший	s p lʲ i t a f ʂ i j
<|rus|>усыновляйте	u s i n a v lʲ a j tʲ e
<|rus|>льда	lʲ d a
<|rus|>прозвучишь	p r a z v u t͡ɕ i ʂ
<|rus|>сатирах	s a tʲ i r a x
<|rus|>ремиксов	rʲ i mʲ i k s a f
<|rus|>залепляю	z a lʲ i p lʲ a j u
<|rus|>абсорбированиями	a p s a r bʲ i r a v a nʲ i j a mʲ i
<|rus|>плавкою	p ɫ a f k a j u
<|rus|>зашумит	z a ʂ u mʲ i t
<|rus|>мужененавистничествам	m u ʐ i nʲ i n a vʲ i sʲ nʲ i t͡ɕ i s t v a m
<|rus|>золотистым	z a ɫ a tʲ i s t i m
<|rus|>катерочках	k a tʲ i r o t͡ɕ k a x
<|rus|>смеялось	s mʲ i j a ɫ a sʲ
<|rus|>замыслу	z a m i s ɫ u
<|rus|>семиугольника	sʲ i mʲ i u ɡ o lʲ nʲ i k a
<|rus|>присягнувши	p rʲ i sʲ i ɡ n u f ʂ i
<|rus|>поносят	p a n o sʲ a t
<|rus|>изучитесь	i z u t͡ɕ i tʲ i sʲ
<|rus|>помойкою	p a m o j k a j u
<|rus|>англицизациею	a n ɡ lʲ i t͡s i z a t͡s i j i j u
<|rus|>прыщавый	p r i ɕː a v i j
<|rus|>усопла	u s o p ɫ a
<|rus|>полетать	p a lʲ i t a tʲ
<|rus|>укутывающий	u k u t i v a j u ɕː i j
<|rus|>муруй	m u r u j
<|rus|>суммируешь	s u mʲ i r u j i ʂ
<|rus|>секта	sʲ e k t a
<|rus|>заклейте	z a k lʲ e j tʲ e
<|rus|>амилазой	a mʲ i ɫ a z a j
<|rus|>посодействовать	p a s a dʲ e j s t v a v a tʲ
<|rus|>опьянивший	a p ⁽ʲ ⁾ j i nʲ i f ʂ i j
<|rus|>заговаривайтесь	z a ɡ a v a rʲ i v a j tʲ i sʲ
<|rus|>ужесточения	u ʐ i s t a t͡ɕ e nʲ i j a
<|rus|>расправах	r a s p r a v a x
<|rus|>летный	lʲ e t n i j
<|rus|>дубу	d u b u
<|rus|>загадит	z a ɡ a dʲ i t
<|rus|>пропитайтесь	p r a pʲ i t a j tʲ i sʲ
<|rus|>отсчётах	a t͡ɕ ɕː o t a x
<|rus|>десницу	dʲ i sʲ nʲ i t͡s u
<|rus|>обуевала	a b u j i v a ɫ a
<|rus|>вертлуг	vʲ i r t ɫ u k
<|rus|>навевавший	n a vʲ i v a f ʂ i j
<|rus|>полиграфиях	p a lʲ i ɡ r a fʲ i j a x
<|rus|>западаешь	z a p a d a j i ʂ
<|rus|>дозрею	d a z rʲ e j u
<|rus|>взыскиваете	v z i s kʲ i v a j i tʲ e
<|rus|>изъянами	i z j a n a mʲ i
<|rus|>метафизику	mʲ i t a fʲ i zʲ i k u
<|rus|>веселеешь	vʲ i sʲ i lʲ e j i ʂ
<|rus|>технократию	tʲ i x n a k r a tʲ i j u
<|rus|>пригородом	p rʲ i ɡ a r a d a m
<|rus|>пионеров	pʲ i a nʲ e r a f
<|rus|>поручительством	p a r u t͡ɕ i tʲ i lʲ s t v a m
<|rus|>гостьях	ɡ o sʲ tʲ j a x
<|rus|>подтягиваюсь	p a tʲː a ɡʲ i v a j u sʲ
<|rus|>присчитывай	p rʲ i ɕː i t i v a j
<|rus|>оттаяло	a t a j i ɫ a
<|rus|>опушалась	a p u ʂ a ɫ a sʲ
<|rus|>поклонничество	p a k ɫ o nʲ i t͡ɕ i s t v a
<|rus|>аблаутов	a b ɫ a u t a f
<|rus|>отекаю	a tʲ i k a j u
<|rus|>стипендий	sʲ tʲ i pʲ e nʲ dʲ i j
<|rus|>кромкой	k r o m k a j
<|rus|>вляпался	v lʲ a p a ɫ s ⁽ʲ ⁾ a
<|rus|>уверовать	u vʲ e r a v a tʲ
<|rus|>тускневши	t u s k nʲ e f ʂ i
<|rus|>прокалываешь	p r a k a ɫ i v a j i ʂ
<|rus|>сконфузят	s k a n f u zʲ a t
<|rus|>извиняли	i z vʲ i nʲ a lʲ i
<|rus|>пофигизмами	p a fʲ i ɡʲ i z m a mʲ i
<|rus|>мурзиками	m u r zʲ i k a mʲ i
<|rus|>реквизициями	rʲ i k vʲ i zʲ i t͡s i j a mʲ i
<|rus|>администрациях	a d mʲ i nʲ i s t r a t͡s i j a x
<|rus|>оттащила	a t a ɕː i ɫ a
<|rus|>сроднивший	s r a dʲ nʲ i f ʂ i j
<|rus|>недолюбливайте	nʲ i d a lʲ u b lʲ i v a j tʲ e
<|rus|>множится	m n o ʐ i t͡s a
<|rus|>нарды	n a r d i
<|rus|>истеки	i sʲ tʲ i kʲ i
<|rus|>правоохранительный	p r a v a a x r a nʲ i tʲ i lʲ n i j
<|rus|>выскабливая	v i s k a b lʲ i v a j a
<|rus|>аудите	a u dʲ i tʲ e
<|rus|>обвил	a b vʲ i ɫ
<|rus|>шепнув	ʂ i p n u f
<|rus|>горкой	ɡ o r k a j
<|rus|>флексийный	f lʲ i k sʲ i j n i j
<|rus|>святою	s vʲ i t o j u
<|rus|>кастаньеты	k a s t a nʲ j e t i
<|rus|>подействовать	p a dʲ e j s t v a v a tʲ
<|rus|>кебабах	kʲ i b a b a x
<|rus|>оживляйтесь	a ʐ i v lʲ a j tʲ i sʲ
<|rus|>осклабляю	a s k ɫ a b lʲ a j u
<|rus|>уклонении	u k ɫ a nʲ e nʲ i i
<|rus|>адекватностях	a d i k v a t n a sʲ tʲ a x
<|rus|>анализирует	a n a lʲ i zʲ i r u j i t
<|rus|>лосося	ɫ a s o sʲ a
<|rus|>бабосам	b a b o s a m
<|rus|>восстанут	v a s t a n u t
<|rus|>красив	k r a sʲ i f
<|rus|>чайковский	t͡ɕ i j k o f s kʲ i j
<|rus|>асинхронный	a sʲ i n x r o n i j
<|rus|>мировыми	mʲ i r a v i mʲ i
<|rus|>вакансию	v a k a n ⁽ʲ ⁾ sʲ i j u
<|rus|>водяного	v a dʲ i n o v a
<|rus|>обросший	a b r o ʂ i j
<|rus|>текилах	tʲ i kʲ i ɫ a x
<|rus|>насаждавши	n a s a ʐ d a f ʂ i
<|rus|>дискетах	dʲ i s kʲ e t a x
<|rus|>приплясывать	p rʲ i p lʲ a s i v a tʲ
<|rus|>плешь	p lʲ e ʂ
<|rus|>предъявится	p rʲ i d j a vʲ i t͡s a
<|rus|>размягчаемый	r a z mʲ i x t͡ɕ a j i m i j
<|rus|>запрягут	z a p rʲ i ɡ u t
<|rus|>настучав	n a s t u t͡ɕ a f
<|rus|>губерниях	ɡ u bʲ e r nʲ i j a x
<|rus|>унесётесь	u nʲ i sʲ o tʲ i sʲ
<|rus|>раскачиваемся	r a s k a t͡ɕ i v a j i m sʲ a
<|rus|>больнаи	b a lʲ n a i
<|rus|>помазанников	p a m a z a nʲ i k a f
<|rus|>нумерацией	n u mʲ i r a t͡s i j i j
<|rus|>изготовлением	i z ɡ a t a v lʲ e nʲ i j i m
<|rus|>держава	dʲ i r ʐ a v a
<|rus|>умиришь	u mʲ i rʲ i ʂ
<|rus|>убежим	u bʲ i ʐ i m
<|rus|>доводят	d a v o dʲ a t
<|rus|>отбудьте	a d b u tʲː e
<|rus|>хиты	xʲ i t i
<|rus|>силаче	sʲ i ɫ a t͡ɕ e
<|rus|>прерывавши	p rʲ i r i v a f ʂ i
<|rus|>зондируем	z a nʲ dʲ i r u j i m
<|rus|>упроси	u p r a sʲ i
<|rus|>гирям	ɡʲ i rʲ a m
<|rus|>назначении	n a z n a t͡ɕ e nʲ i i
<|rus|>облепляемый	a b lʲ i p lʲ a j i m i j
<|rus|>реабилитируем	rʲ i a bʲ i lʲ i tʲ i r u j i m
<|rus|>ликбезам	lʲ i ɡ bʲ e z a m
<|rus|>мотылькам	m a t i lʲ k a m
<|rus|>ускоришься	u s k o rʲ i ʂ sʲ a
<|rus|>фасолей	f a s o lʲ i j
<|rus|>дуэта	d u e t a
<|rus|>мимикрий	mʲ i mʲ i k rʲ i j
<|rus|>мейтнериев	mʲ i j tʲ nʲ e rʲ i j i f
<|rus|>склеило	s k lʲ e i ɫ a
<|rus|>буревестника	b u rʲ i vʲ e sʲ nʲ i k a
<|rus|>благоустрой	b ɫ a ɡ a u s t r o j
<|rus|>заглинизированности	z a ɡ lʲ i nʲ i zʲ i r a v a n a sʲ tʲ i
<|rus|>укреплений	u k rʲ i p lʲ e nʲ i j
<|rus|>гостю	ɡ o sʲ tʲ u
<|rus|>сгущаюсь	z ɡ u ɕː a j u sʲ
<|rus|>разговляются	r a z ɡ a v lʲ a j u t͡s a
<|rus|>биотоксичность	bʲ i a t a k sʲ i t͡ɕ n a sʲ tʲ
<|rus|>клавдия	k ɫ a v dʲ i j a
<|rus|>деканаты	d i k a n a t i
<|rus|>возобновите	v a z a b n a vʲ i tʲ e
<|rus|>укрылся	u k r i ɫ s ⁽ʲ ⁾ a
<|rus|>рожаете	r a ʐ a j i tʲ e
<|rus|>угрожающий	u ɡ r a ʐ a j u ɕː i j
<|rus|>толковании	t a ɫ k a v a nʲ i i
<|rus|>деревяшкой	dʲ i rʲ i vʲ a ʂ k a j
<|rus|>сачкуйте	s a t͡ɕ k u j tʲ e
<|rus|>гвардейца	ɡ v a r dʲ e j t͡s a
<|rus|>завешивайте	z a vʲ e ʂ i v a j tʲ e
<|rus|>висело	vʲ i sʲ e ɫ a
<|rus|>капибарами	k a pʲ i b a r a mʲ i
<|rus|>растило	r a sʲ tʲ i ɫ a
<|rus|>вазочками	v a z a t͡ɕ k a mʲ i
<|rus|>льдинок	lʲ dʲ i n a k
<|rus|>туземцами	t u zʲ e m t͡s a mʲ i
<|rus|>чахотке	t͡ɕ i x o t kʲ e
<|rus|>привстающий	p rʲ i f s t a j u ɕː i j
<|rus|>реликта	rʲ i lʲ i k t a
<|rus|>отдалять	a d a lʲ a tʲ
<|rus|>блумфонтейн	b ɫ u m f a n t i j n
<|rus|>отставший	a t͡s s t a f ʂ i j
<|rus|>токсичный	t a k sʲ i t͡ɕ n i j
<|rus|>валенком	v a lʲ i n k a m
<|rus|>приземлявшийся	p rʲ i zʲ i m lʲ a f ʂ i j sʲ a
<|rus|>невежественна	nʲ i vʲ e ʐ i s t vʲ i n a
<|rus|>артистка	a r tʲ i s t k a
<|rus|>шампуня	ʂ a m p u nʲ a
<|rus|>негодованию	nʲ i ɡ a d a v a nʲ i j u
<|rus|>приготовлением	p rʲ i ɡ a t a v lʲ e nʲ i j i m
<|rus|>магнатов	m a ɡ n a t a f
<|rus|>вступлениях	f s t u p lʲ e nʲ i j a x
<|rus|>окопа	a k o p a
<|rus|>озарила	a z a rʲ i ɫ a
<|rus|>отворачивающийся	a t v a r a t͡ɕ i v a j u ɕː i j sʲ a
<|rus|>простудивши	p r a s t u dʲ i f ʂ i
<|rus|>комиссиями	k a mʲ i sʲ i j a mʲ i
<|rus|>расхищав	r a s xʲ i ɕː a f
<|rus|>нарекла	n a rʲ i k ɫ a
<|rus|>сровняйте	s r a v nʲ a j tʲ e
<|rus|>осияваешь	a sʲ i j i v a j i ʂ
<|rus|>инактивирую	i n a k tʲ i vʲ i r u j u
<|rus|>умудрит	u m u d rʲ i t
<|rus|>гуглите	ɡ u ɡ lʲ i tʲ e
<|rus|>пропитывав	p r a pʲ i t i v a f
<|rus|>самоцвета	s a m a t͡s vʲ e t a
<|rus|>толстяком	t a ɫ s ⁽ʲ ⁾ tʲ i k o m
<|rus|>всклокоченный	f s k ɫ a k o t͡ɕ i n i j
<|rus|>нервничавший	nʲ e r v nʲ i t͡ɕ i f ʂ i j
<|rus|>борющийся	b o rʲ u ɕː i j sʲ a
<|rus|>зачитывайся	z a t͡ɕ i t i v a j sʲ a
<|rus|>остужав	a s t u ʐ a f
<|rus|>лосьонам	ɫ a sʲ j o n a m
<|rus|>вальцующий	v a lʲ t͡s u j u ɕː i j
<|rus|>распиная	r a s pʲ i n a j a
<|rus|>топазу	t a p a z u
<|rus|>телетекстах	tʲ e lʲ i tʲ e k s t a x
<|rus|>подзаголовков	p a d͡z z a ɡ a ɫ o f k a f
<|rus|>ревел	rʲ i vʲ e ɫ
<|rus|>благословимся	b ɫ a ɡ a s ɫ a vʲ i m sʲ a
<|rus|>какую	k a k u j u
<|rus|>зажглись	z a ʐ ɡ lʲ i sʲ
<|rus|>орошу	a r a ʂ u
<|rus|>шарахать	ʂ a r a x a tʲ
<|rus|>руководств	r u k a v o t͡s t f
<|rus|>клянчу	k lʲ a nʲ t͡ɕ u
<|rus|>зацепляло	z a t͡s i p lʲ a ɫ a
<|rus|>абаданце	a b a d a n t͡s i
<|rus|>реяв	rʲ e j i f
<|rus|>ранетки	r a nʲ e t kʲ i
<|rus|>покладая	p a k ɫ a d a j a
<|rus|>предпишем	p rʲ i t pʲ i ʂ i m
<|rus|>бороздим	b a r a zʲ dʲ i m
<|rus|>нуворишам	n u v a rʲ i ʂ a m
<|rus|>арке	a r kʲ e
<|rus|>взбегав	v z bʲ i ɡ a f
<|rus|>гуманизме	ɡ u m a nʲ i z mʲ e
<|rus|>рожью	r o ʐ j u
<|rus|>гидраты	ɡʲ i d r a t i
<|rus|>доверительностям	d a vʲ i rʲ i tʲ i lʲ n a sʲ tʲ a m
<|rus|>холодавши	x a ɫ a d a f ʂ i
<|rus|>тюльпана	tʲ u lʲ p a n a
<|rus|>выкрасило	v i k r a sʲ i ɫ a
<|rus|>взвинчивал	v z vʲ i nʲ t͡ɕ i v a ɫ
<|rus|>вуй	v u j
<|rus|>маразмы	m a r a z m i
<|rus|>дисгармониею	dʲ i z ɡ a r m o nʲ i j i j u
<|rus|>ломаку	ɫ a m a k u
<|rus|>памятей	p a mʲ i tʲ i j
<|rus|>вседозволенностях	f sʲ i d a z v o lʲ i n a sʲ tʲ a x
<|rus|>куркумой	k u r k u m a j
<|rus|>тушуй	t u ʂ u j
<|rus|>заносит	z a n o sʲ i t
<|rus|>киноаппаратом	kʲ i n a a p a r a t a m
<|rus|>припоминаешь	p rʲ i p a mʲ i n a j i ʂ
<|rus|>зевал	zʲ i v a ɫ
<|rus|>накалывать	n a k a ɫ i v a tʲ
<|rus|>контрактниках	k a n t r a k tʲ nʲ i k a x
<|rus|>обучавшийся	a b u t͡ɕ a f ʂ i j sʲ a
<|rus|>упоминаются	u p a mʲ i n a j u t͡s a
<|rus|>абдеритами	a b dʲ i rʲ i t a mʲ i
<|rus|>теребейчук	tʲ i rʲ i bʲ i j t͡ɕ u k
<|rus|>учугов	u t͡ɕ u ɡ a f
<|rus|>изведав	i z vʲ e d a f
<|rus|>дополнивший	d a p o ɫ nʲ i f ʂ i j
<|rus|>давлениям	d a v lʲ e nʲ i j a m
<|rus|>приколоть	p rʲ i k a ɫ o tʲ
<|rus|>колосьям	k a ɫ o sʲ j a m
<|rus|>монголом	m a n ɡ o ɫ a m
<|rus|>высевок	v i sʲ i v a k
<|rus|>затешешь	z a tʲ e ʂ i ʂ
<|rus|>дураков	d u r a k o f
<|rus|>коренившись	k a rʲ i nʲ i f ʂ i sʲ
<|rus|>тулии	t u lʲ i i
<|rus|>выкраиваются	v i k r a i v a j u t͡s a
<|rus|>мнений	m nʲ e nʲ i j
<|rus|>просветлевший	p r a s vʲ i t lʲ e f ʂ i j
<|rus|>первые	pʲ e r v i j e
<|rus|>буханке	b u x a n kʲ e
<|rus|>светиться	s vʲ i tʲ i t͡s a
<|rus|>завораживать	z a v a r a ʐ i v a tʲ
<|rus|>епитрахилей	j i pʲ i t r a xʲ i lʲ i j
<|rus|>статейкой	s t a tʲ e j k a j
<|rus|>вмазывай	v m a z i v a j
<|rus|>прощанья	p r a ɕː a nʲ j a
<|rus|>кочевнике	k a t͡ɕ e v nʲ i kʲ e
<|rus|>хлебцем	x lʲ e p t͡s i m
<|rus|>употребляли	u p a t rʲ i b lʲ a lʲ i
<|rus|>хадиса	x a dʲ i s a
<|rus|>ощетинила	a ɕː i tʲ i nʲ i ɫ a
<|rus|>сочинением	s a t͡ɕ i nʲ e nʲ i j i m
<|rus|>приползать	p rʲ i p a ɫ z a tʲ
<|rus|>съедутся	s j e d u t͡s a
<|rus|>цесарем	t͡s e s a rʲ i m
<|rus|>сосною	s a s n o j u
<|rus|>патрульному	p a t r u lʲ n a m u
<|rus|>гобелене	ɡ a bʲ i lʲ e nʲ e
<|rus|>анусах	a n u s a x
<|rus|>исписывало	i s pʲ i s i v a ɫ a
<|rus|>бесноватыми	bʲ i s n a v a t i mʲ i
<|rus|>ризе	rʲ i zʲ e
<|rus|>террористе	t i r a rʲ i sʲ tʲ e
<|rus|>прислужили	p rʲ i s ɫ u ʐ i lʲ i
<|rus|>ослихам	a s ⁽ʲ ⁾ lʲ i x a m
<|rus|>артистке	a r tʲ i s t kʲ e
<|rus|>облюю	a b lʲ u j u
<|rus|>вкрадывалась	f k r a d i v a ɫ a sʲ
<|rus|>перетекли	pʲ i rʲ i tʲ i k lʲ i
<|rus|>поправишь	p a p r a vʲ i ʂ
<|rus|>окаю	o k a j u
<|rus|>резнями	rʲ i zʲ nʲ a mʲ i
<|rus|>подворотне	p a d v a r o tʲ nʲ e
<|rus|>жажда	ʐ a ʐ d a
<|rus|>прожидях	p r o ʐ i dʲ a x
<|rus|>хаяли	x a j i lʲ i
<|rus|>свечнике	s vʲ i t͡ɕ nʲ i kʲ e
<|rus|>обнажите	a b n a ʐ i tʲ e
<|rus|>раздвинулись	r a z d vʲ i n u lʲ i sʲ
<|rus|>подметайте	p a d mʲ i t a j tʲ e
<|rus|>скороговорка	s k a r a ɡ a v o r k a
<|rus|>осмотрами	a s m o t r a mʲ i
<|rus|>крошенный	k r o ʂ i n i j
<|rus|>растревоживают	r a s t rʲ i v o ʐ i v a j u t
<|rus|>загар	z a ɡ a r
<|rus|>толкалось	t a ɫ k a ɫ a sʲ
<|rus|>сердцебиениях	sʲ i r t͡s i bʲ i j e nʲ i j a x
<|rus|>обветшалый	a b vʲ i t͡ʂ ʂ a ɫ i j
<|rus|>трактуете	t r a k t u j i tʲ e
<|rus|>ненадобный	nʲ i n a d a b n i j
<|rus|>слёзы	s ⁽ʲ ⁾ lʲ o z i
<|rus|>перетягивавши	pʲ i rʲ i tʲ a ɡʲ i v a f ʂ i
<|rus|>ободам	o b a d a m
<|rus|>увезёшь	u vʲ i zʲ o ʂ
<|rus|>преградивший	p rʲ i ɡ r a dʲ i f ʂ i j
<|rus|>засвистим	z a s vʲ i sʲ tʲ i m
<|rus|>киноактрисой	kʲ i n a a k t rʲ i s a j
<|rus|>уединявшись	u j i dʲ i nʲ a f ʂ i sʲ
<|rus|>активизируете	a k tʲ i vʲ i zʲ i r u j i tʲ e
<|rus|>огонькам	a ɡ a nʲ k a m
<|rus|>дымили	d i mʲ i lʲ i
<|rus|>аккомпанировали	a k a m p a nʲ i r a v a lʲ i
<|rus|>бутилируют	b u tʲ i lʲ i r u j u t
<|rus|>владиславом	v ɫ a dʲ i s ɫ a v a m
<|rus|>толкнёшь	t a ɫ k nʲ o ʂ
<|rus|>затирая	z a tʲ i r a j a
<|rus|>пользованиях	p o lʲ z a v a nʲ i j a x
<|rus|>прапорщик	p r a p a r ɕː i k
<|rus|>соревнуйтесь	s a rʲ i v n u j tʲ i sʲ
<|rus|>фабрикую	f a b rʲ i k u j u
<|rus|>восприняла	v a s p rʲ i nʲ i ɫ a
<|rus|>похоронишь	p a x a r o nʲ i ʂ
<|rus|>сходна	s x o d n a
<|rus|>возвышенно	v a z v i ʂ i n a
<|rus|>автогене	a f t a ɡʲ e nʲ e
<|rus|>промокавший	p r a m a k a f ʂ i j
<|rus|>перегрелись	pʲ i rʲ i ɡ rʲ e lʲ i sʲ
<|rus|>подготовляйте	p a d ɡ a t a v lʲ a j tʲ e
<|rus|>потребностях	p a t rʲ e b n a sʲ tʲ a x
<|rus|>одаривая	a d a rʲ i v a j a
<|rus|>чугунно	t͡ɕ u ɡ u n a
<|rus|>отваживаемся	a t v a ʐ i v a j i m sʲ a
<|rus|>презумпциями	p rʲ i z u m p t͡s i j a mʲ i
<|rus|>расстраивался	r a s t r a i v a ɫ s ⁽ʲ ⁾ a
<|rus|>довлело	d a v lʲ e ɫ a
<|rus|>смрадишь	s m r a dʲ i ʂ
<|rus|>адсорбировав	a t͡s s a r bʲ i r a v a f
<|rus|>рефракторе	rʲ i f r a k t a rʲ e
<|rus|>излияниями	i z ⁽ʲ ⁾ lʲ i j a nʲ i j a mʲ i
<|rus|>гобеленами	ɡ a bʲ i lʲ e n a mʲ i
<|rus|>приглядывавшийся	p rʲ i ɡ lʲ a d i v a f ʂ i j sʲ a
<|rus|>эксцессов	i k s t͡s e s a f
<|rus|>взяточникам	v zʲ a t a t͡ɕ nʲ i k a m
<|rus|>потёрла	p a tʲ o r ɫ a
<|rus|>абстрактам	a p s t r a k t a m
<|rus|>сосками	s o s k a mʲ i
<|rus|>брёха	b rʲ o x a
<|rus|>поблагодарить	p a b ɫ a ɡ a d a rʲ i tʲ
<|rus|>жучков	ʐ u t͡ɕ k o f
<|rus|>осечкам	a sʲ e t͡ɕ k a m
<|rus|>специализмы	s pʲ i t͡s i a lʲ i z m i
<|rus|>сертификата	sʲ i r tʲ i fʲ i k a t a
<|rus|>гонореи	ɡ a n a rʲ e i
<|rus|>украдёшь	u k r a dʲ o ʂ
<|rus|>воздадите	v a z d a dʲ i tʲ e
<|rus|>прожигаем	p r a ʐ i ɡ a j i m
<|rus|>бутафорией	b u t a f o rʲ i j i j
<|rus|>дисциплинировала	dʲ i s t͡s i p lʲ i nʲ i r a v a ɫ a
<|rus|>осунется	a s u nʲ i t͡s a
<|rus|>виновницах	vʲ i n o v nʲ i t͡s a x
<|rus|>питомце	pʲ i t o m t͡s i
<|rus|>замяло	z a mʲ a ɫ a
<|rus|>порочили	p a r o t͡ɕ i lʲ i
<|rus|>деточка	dʲ e t a t͡ɕ k a
<|rus|>пересказываем	pʲ i rʲ i s k a z i v a j i m
<|rus|>башке	b a ʂ kʲ e
<|rus|>поблагодарим	p a b ɫ a ɡ a d a rʲ i m
<|rus|>дублёнки	d u b lʲ o n kʲ i
<|rus|>развернувший	r a z vʲ i r n u f ʂ i j
<|rus|>противоположу	p r o tʲ i v a p a ɫ a ʐ u
<|rus|>нюхальщики	nʲ u x a lʲ ɕː i kʲ i
<|rus|>озари	a z a rʲ i
<|rus|>отчужу	a t͡ɕ u ʐ u
<|rus|>буферах	b u fʲ i r a x
<|rus|>дотягивающийся	d a tʲ a ɡʲ i v a j u ɕː i j sʲ a
<|rus|>венчания	vʲ i nʲ t͡ɕ a nʲ i j a
<|rus|>окупленный	a k u p lʲ i n i j
<|rus|>построит	p a s t r o i t
<|rus|>уязвляя	u j i z v lʲ a j a
<|rus|>поговорите	p a ɡ a v a rʲ i tʲ e
<|rus|>царевна	t͡s a rʲ e v n a
<|rus|>болте	b a ɫ tʲ e
<|rus|>забил	z a bʲ i ɫ
<|rus|>люкс	lʲ u k s
<|rus|>сбило	z bʲ i ɫ a
<|rus|>чаячий	t͡ɕ a j i t͡ɕ i j
<|rus|>надававший	n a d a v a f ʂ i j
<|rus|>конку	k o n k u
<|rus|>усмехаясь	u s mʲ i x a j i sʲ
<|rus|>привязь	p rʲ i vʲ i sʲ
<|rus|>парадигмам	p a r a dʲ i ɡ m a m
<|rus|>зачёркиваем	z a t͡ɕ o r kʲ i v a j i m
<|rus|>сущностью	s u ɕː n a sʲ tʲ j u
<|rus|>подмечавший	p a d mʲ i t͡ɕ a f ʂ i j
<|rus|>реек	rʲ e j i k
<|rus|>просветишь	p r a s vʲ e tʲ i ʂ
<|rus|>нидерландского	nʲ i dʲ i r ɫ a n t s k a v a
<|rus|>поладив	p a ɫ a dʲ i f
<|rus|>новоангличанах	n o v a a n ɡ lʲ i t͡ɕ a n a x
<|rus|>пожирает	p a ʐ i r a j i t
<|rus|>тарифов	t a rʲ i f a f
<|rus|>насчёт	n a ɕː o t
<|rus|>распускавшись	r a s p u s k a f ʂ i sʲ
<|rus|>забывался	z a b i v a ɫ s ⁽ʲ ⁾ a
<|rus|>оклемаетесь	a k lʲ i m a j i tʲ i sʲ
<|rus|>провозя	p r a v a zʲ a
<|rus|>уделах	u dʲ e ɫ a x
<|rus|>вытряхивает	v i t rʲ a xʲ i v a j i t
<|rus|>затрудни	z a t r u dʲ nʲ i
<|rus|>принимавшись	p rʲ i nʲ i m a f ʂ i sʲ
<|rus|>прокладывающий	p r a k ɫ a d i v a j u ɕː i j
<|rus|>русифицируешься	r u sʲ i fʲ i t͡s i r u j i ʂ sʲ a
<|rus|>створу	s t v o r u
<|rus|>расходовали	r a s x o d a v a lʲ i
<|rus|>зачаровав	z a t͡ɕ i r a v a f
<|rus|>чемпионами	t͡ɕ i m ⁽ʲ ⁾ pʲ i o n a mʲ i
<|rus|>расчёсывалась	r a ɕ t͡ɕ o s i v a ɫ a sʲ
<|rus|>заревом	z a rʲ i v a m
<|rus|>неформально	nʲ i f a r m a lʲ n a
<|rus|>отслеживает	a t͡s s ⁽ʲ ⁾ lʲ e ʐ i v a j i t
<|rus|>приглядываем	p rʲ i ɡ lʲ a d i v a j i m
<|rus|>брюссельский	b rʲ u sʲ e lʲ s kʲ i j
<|rus|>роках	r o k a x
<|rus|>раскручивало	r a s k r u t͡ɕ i v a ɫ a
<|rus|>челнок	t͡ɕ i ɫ n o k
<|rus|>ремешкам	rʲ i mʲ i ʂ k a m
<|rus|>ведавший	vʲ e d a f ʂ i j
<|rus|>иволгою	i v a ɫ ɡ a j u
<|rus|>колледж	k o lʲ i t͡ʂ ʂ
<|rus|>проверив	p r a vʲ e rʲ i f
<|rus|>микросхемы	mʲ i k r a s xʲ e m i
<|rus|>выясняешь	v i j i sʲ nʲ a j i ʂ
<|rus|>надколеннике	n a t k a lʲ e nʲ i kʲ e
<|rus|>перекусят	pʲ i rʲ i k u sʲ a t
<|rus|>покрученный	p a k r u t͡ɕ i n i j
<|rus|>затирав	z a tʲ i r a f
<|rus|>перечтём	pʲ i rʲ i t͡ɕ tʲ o m
<|rus|>подданству	p o d a n s t v u
<|rus|>выливался	v i lʲ i v a ɫ s ⁽ʲ ⁾ a
<|rus|>порастёт	p a r a sʲ tʲ o t
<|rus|>провайдеры	p r a v a j d i r i
<|rus|>полемику	p a lʲ e mʲ i k u
<|rus|>переломлю	pʲ i rʲ i ɫ a m lʲ u
<|rus|>разъём	r a z j o m
<|rus|>изменяло	i z mʲ i nʲ a ɫ a
<|rus|>абсорбатам	a p s a r b a t a m
<|rus|>писателями	pʲ i s a tʲ i lʲ a mʲ i
<|rus|>лад	ɫ a t
<|rus|>ахи	a xʲ i
<|rus|>извлекут	i z v lʲ i k u t
<|rus|>взбираетесь	v z bʲ i r a j i tʲ i sʲ
<|rus|>фотокарточками	f a t a k a r t a t͡ɕ k a mʲ i
<|rus|>объедаемый	a b j i d a j i m i j
<|rus|>завалитесь	z a v a lʲ i tʲ i sʲ
<|rus|>закладывай	z a k ɫ a d i v a j
<|rus|>урезывав	u rʲ e z i v a f
<|rus|>приделать	p rʲ i dʲ e ɫ a tʲ
<|rus|>переставить	pʲ i rʲ i s t a vʲ i tʲ
<|rus|>кремниев	k rʲ e m nʲ i j i f
<|rus|>всовавши	f s a v a f ʂ i
<|rus|>цингою	t͡s i n ɡ o j u
<|rus|>криптонов	k rʲ i p t o n a f
<|rus|>гомони	ɡ a m a nʲ i
<|rus|>думаем	d u m a j i m
<|rus|>повязанный	p a vʲ a z a n i j
<|rus|>застрелив	z a s t rʲ i lʲ i f
<|rus|>апограф	a p o ɡ r a f
<|rus|>подсолнухе	p a t͡s s o ɫ n u xʲ e
<|rus|>прививай	p rʲ i vʲ i v a j
<|rus|>буккеры	b u kʲ i r i
<|rus|>юмористическая	j u m a rʲ i sʲ tʲ i t͡ɕ i s k a j a
<|rus|>выдворявши	v i d v a rʲ a f ʂ i
<|rus|>подлодке	p a d ɫ o t kʲ e
<|rus|>лапали	ɫ a p a lʲ i
<|rus|>отщепляйте	a t͡ɕ ɕː i p lʲ a j tʲ e
<|rus|>заведованием	z a vʲ e d a v a nʲ i j i m
<|rus|>смудрит	s m u d rʲ i t
<|rus|>здесь	zʲ dʲ e sʲ
<|rus|>заимейте	z a i mʲ e j tʲ e
<|rus|>кувшинках	k u f ʂ i n k a x
<|rus|>покатаешь	p a k a t a j i ʂ
<|rus|>подшипникам	p a t͡ʂ ʂ i p nʲ i k a m
<|rus|>несбыточный	nʲ i z b i t a t͡ɕ n i j
<|rus|>стоил	s t o i ɫ
<|rus|>заебать	z a j i b a tʲ
<|rus|>заразятся	z a r a zʲ a t͡s a
<|rus|>спросонок	s p r a s o n a k
<|rus|>заперлись	z a pʲ i r lʲ i sʲ
<|rus|>героинях	ɡʲ i r a i nʲ a x
<|rus|>мучу	m u t͡ɕ u
<|rus|>запираюсь	z a pʲ i r a j u sʲ
<|rus|>непогрешимый	nʲ i p a ɡ rʲ i ʂ i m i j
<|rus|>пакистанцы	p a kʲ i s t a n t͡s i
<|rus|>повертит	p a vʲ e r tʲ i t
<|rus|>епархия	j i p a r xʲ i j a
<|rus|>покрышка	p a k r i ʂ k a
<|rus|>театре	tʲ i a t a rʲ e
<|rus|>тучности	t u t͡ɕ n a sʲ tʲ i
<|rus|>спёр	s pʲ o r
<|rus|>вставишься	f s t a vʲ i ʂ sʲ a
<|rus|>выправлять	v i p r a v lʲ a tʲ
<|rus|>ветшаем	vʲ i t͡ʂ ʂ a j i m
<|rus|>надушу	n a d u ʂ u
<|rus|>лизнув	lʲ i z n u f
<|rus|>опасения	a p a sʲ e nʲ i j a
<|rus|>переливает	pʲ i rʲ i lʲ i v a j i t
<|rus|>чувствуйте	t͡ɕ u s t v u j tʲ e
<|rus|>осушал	a s u ʂ a ɫ
<|rus|>вводимся	v o dʲ i m sʲ a
<|rus|>секунды	sʲ i k u n d i
<|rus|>походом	p a x o d a m
<|rus|>осведомляющийся	a s vʲ i d a m lʲ a j u ɕː i j sʲ a
<|rus|>плюрализмам	p lʲ u r a lʲ i z m a m
<|rus|>звенеть	z vʲ i nʲ e tʲ
<|rus|>пейджер	p e j d͡ʐ ʐ i r
<|rus|>повалила	p a v a lʲ i ɫ a
<|rus|>аскетом	a s kʲ e t a m
<|rus|>синтеза	sʲ i n t i z a
<|rus|>киноплёнках	kʲ i n a p lʲ o n k a x
<|rus|>клетку	k lʲ e t k u
<|rus|>отворачиваюсь	a t v a r a t͡ɕ i v a j u sʲ
<|rus|>закопушкой	z a k a p u ʂ k a j
<|rus|>преобразовывавшийся	p rʲ i a b r a z o v i v a f ʂ i j sʲ a
<|rus|>отборы	a d b o r i
<|rus|>алкинов	a ɫ kʲ i n a f
<|rus|>треклистах	t r i k lʲ i s t a x
<|rus|>обнадёживай	a b n a dʲ o ʐ i v a j
<|rus|>постылевший	p a s t i lʲ i f ʂ i j
<|rus|>накалялась	n a k a lʲ a ɫ a sʲ
<|rus|>горячностей	ɡ a rʲ a t͡ɕ n a sʲ tʲ i j
<|rus|>отворачивай	a t v a r a t͡ɕ i v a j
<|rus|>симулируй	sʲ i m u lʲ i r u j
<|rus|>туманностях	t u m a n a sʲ tʲ a x
<|rus|>усложняем	u s ɫ a ʐ nʲ a j i m
<|rus|>разгоняете	r a z ɡ a nʲ a j i tʲ e
<|rus|>трансляциям	t r a n s ⁽ʲ ⁾ lʲ a t͡s i j a m
<|rus|>ударяемся	u d a rʲ a j i m sʲ a
<|rus|>осмысливаемый	a s m i s ⁽ʲ ⁾ lʲ i v a j i m i j
<|rus|>властолюбия	v ɫ a s t a lʲ u bʲ i j a
<|rus|>залепляя	z a lʲ i p lʲ a j a
<|rus|>волокут	v a ɫ a k u t
<|rus|>шаромыгой	ʂ a r a m i ɡ a j
<|rus|>черемшах	t͡ɕ i rʲ i m ʂ a x
<|rus|>остротой	a s t r o t a j
<|rus|>дружественен	d r u ʐ i s t vʲ i nʲ i n
<|rus|>ассемблера	a s e m b lʲ i r a
<|rus|>попросись	p a p r a sʲ i sʲ
<|rus|>темпераментами	tʲ i m ⁽ʲ ⁾ pʲ i r a mʲ i n t a mʲ i
<|rus|>утком	u t k o m
<|rus|>пробурчала	p r a b u r t͡ɕ a ɫ a
<|rus|>опробованный	a p r o b a v a n i j
<|rus|>потаскушки	p a t a s k u ʂ kʲ i
<|rus|>заискивали	z a i s kʲ i v a lʲ i
<|rus|>гидрологиях	ɡʲ i d r a ɫ o ɡʲ i j a x
<|rus|>спокойствии	s p a k o j s t vʲ i i
<|rus|>табличку	t a b lʲ i t͡ɕ k u
<|rus|>информационный	i n f a r m a t͡s i o n i j
<|rus|>потопталось	p a t a p t a ɫ a sʲ
<|rus|>интерпретированный	i n t i r p rʲ i tʲ i r a v a n i j
<|rus|>кусаем	k u s a j i m
<|rus|>насылаем	n a s i ɫ a j i m
<|rus|>сталкиваюсь	s t a ɫ kʲ i v a j u sʲ
<|rus|>накапливаем	n a k a p lʲ i v a j i m
<|rus|>систола	sʲ i s t a ɫ a
<|rus|>миньетчиком	mʲ i nʲ j e t͡ɕ i k a m
<|rus|>краткам	k r a t k a m
<|rus|>арумынкой	a r u m i n k a j
<|rus|>вырисовываться	v i rʲ i s o v i v a t͡s a
<|rus|>обидами	a bʲ i d a mʲ i
<|rus|>состряпаете	s a s t rʲ a p a j i tʲ e
<|rus|>одышка	a d i ʂ k a
<|rus|>тротуару	t r a t u a r u
<|rus|>безобразием	bʲ i z a b r a zʲ i j i m
<|rus|>выспрашиваемый	v i s p r a ʂ i v a j i m i j
<|rus|>плацента	p ɫ a t͡s e n t a
<|rus|>фургону	f u r ɡ o n u
<|rus|>выворачиваете	v i v a r a t͡ɕ i v a j i tʲ e
<|rus|>выражен	v i r a ʐ i n
<|rus|>соизволением	s a i z v a lʲ e nʲ i j i m
<|rus|>раздельно	r a zʲ dʲ e lʲ n a
<|rus|>олимпийкою	a lʲ i m ⁽ʲ ⁾ pʲ i j k a j u
<|rus|>сформулировал	s f a r m u lʲ i r a v a ɫ
<|rus|>вскинул	f s kʲ i n u ɫ
<|rus|>переболевала	pʲ i rʲ i b a lʲ i v a ɫ a
<|rus|>съязвил	s j i z vʲ i ɫ
<|rus|>должные	d o ɫ ʐ n i j e
<|rus|>вытворяешь	v i t v a rʲ a j i ʂ
<|rus|>поведываете	p a vʲ e d i v a j i tʲ e
<|rus|>пригибают	p rʲ i ɡʲ i b a j u t
<|rus|>сигало	sʲ i ɡ a ɫ a
<|rus|>опаску	a p a s k u
<|rus|>амбра	a m b r a
<|rus|>катране	k a t r a nʲ e
<|rus|>снашивала	s n a ʂ i v a ɫ a
<|rus|>смыкал	s m i k a ɫ
<|rus|>сигналю	sʲ i ɡ n a lʲ u
<|rus|>разрознивши	r a z r o zʲ nʲ i f ʂ i
<|rus|>заменялись	z a mʲ i nʲ a lʲ i sʲ
<|rus|>ухаживавши	u x a ʐ i v a f ʂ i
<|rus|>налегке	n a lʲ i xʲ kʲ e
<|rus|>жидкостями	ʐ i t k a sʲ tʲ a mʲ i
<|rus|>свинина	s vʲ i nʲ i n a
<|rus|>рисовал	rʲ i s a v a ɫ
<|rus|>ливийка	lʲ i vʲ i j k a
<|rus|>чохой	t͡ɕ i x o j
<|rus|>аллюзиями	a lʲ u zʲ i j a mʲ i
<|rus|>шумов	ʂ u m a f
<|rus|>хачике	x a t͡ɕ i kʲ e
<|rus|>текил	tʲ i kʲ i ɫ
<|rus|>понудит	p a n u dʲ i t
<|rus|>самосвалах	s a m a s v a ɫ a x
<|rus|>вскриков	f s k rʲ i k a f
<|rus|>силиконы	sʲ i lʲ i k o n i
<|rus|>плевав	p lʲ i v a f
<|rus|>тыква	t i k v a
<|rus|>распространяйся	r a s p r a s t r a nʲ a j sʲ a
<|rus|>варьируют	v a rʲ j i r u j u t
<|rus|>интриган	i n t rʲ i ɡ a n
<|rus|>просвещай	p r a s vʲ i ɕː a j
<|rus|>завернуть	z a vʲ i r n u tʲ
<|rus|>поживавший	p a ʐ i v a f ʂ i j
<|rus|>адсорбируя	a t͡s s a r bʲ i r u j a
<|rus|>оперативностью	a pʲ i r a tʲ i v n a sʲ tʲ j u
<|rus|>пополнять	p a p a ɫ nʲ a tʲ
<|rus|>врезаете	v rʲ i z a j i tʲ e
<|rus|>приятны	p rʲ i j a t n i
<|rus|>утопаем	u t o p a j i m
<|rus|>поели	p a j e lʲ i
<|rus|>манкой	m a n k a j
<|rus|>садит	s a dʲ i t
<|rus|>опушавшись	a p u ʂ a f ʂ i sʲ
<|rus|>антидоте	a nʲ tʲ i d o tʲ e
<|rus|>комбинируешь	k a m ⁽ʲ ⁾ bʲ i nʲ i r u j i ʂ
<|rus|>сопроводишь	s a p r a v a dʲ i ʂ
<|rus|>нормированиями	n a r mʲ i r a v a nʲ i j a mʲ i
<|rus|>кувшинку	k u f ʂ i n k u
<|rus|>досадовавший	d a s a d a v a f ʂ i j
<|rus|>орешь	o rʲ i ʂ
<|rus|>пригодность	p rʲ i ɡ o d n a sʲ tʲ
<|rus|>сыроваров	s i r a v a r a f
<|rus|>октябрь	a k tʲ a b rʲ
<|rus|>прожёвываемый	p r a ʐ o v i v a j i m i j
<|rus|>касайтесь	k a s a j tʲ i sʲ
<|rus|>женит	ʐ e nʲ i t
<|rus|>жёрнов	ʐ o r n a f
<|rus|>отпугивало	a t p u ɡʲ i v a ɫ a
<|rus|>файликах	f a j lʲ i k a x
<|rus|>изобарою	i z a b a r a j u
<|rus|>размежует	r a z mʲ i ʐ u j i t
<|rus|>опушайся	a p u ʂ a j sʲ a
<|rus|>баклага	b a k ɫ a ɡ a
<|rus|>категоричностей	k a tʲ i ɡ a rʲ i t͡ɕ n a sʲ tʲ i j
<|rus|>выводкам	v i v a t k a m
<|rus|>взвешивавши	v z vʲ e ʂ i v a f ʂ i
<|rus|>проиграешь	p r a i ɡ r a j i ʂ
<|rus|>энергоносители	i n e r ɡ a n a sʲ i tʲ i lʲ i
<|rus|>погрешу	p a ɡ rʲ i ʂ u
<|rus|>промахах	p r o m a x a x
<|rus|>опером	o pʲ i r a m
<|rus|>заела	z a j e ɫ a
<|rus|>котировать	k a tʲ i r a v a tʲ
<|rus|>неустроенностям	nʲ i u s t r o j i n a sʲ tʲ a m
<|rus|>подчёркивают	p a t͡ɕ o r kʲ i v a j u t
<|rus|>генетикам	ɡʲ i n e tʲ i k a m
<|rus|>каскадам	k a s k a d a m
<|rus|>вкладывают	f k ɫ a d i v a j u t
<|rus|>питону	pʲ i t o n u
<|rus|>искалечило	i s k a lʲ e t͡ɕ i ɫ a
<|rus|>неумерен	nʲ i u mʲ e rʲ i n
<|rus|>финансировало	fʲ i n a n ⁽ʲ ⁾ sʲ i r a v a ɫ a
<|rus|>общо	a p ɕː o
<|rus|>вампирах	v a m ⁽ʲ ⁾ pʲ i r a x
<|rus|>выловят	v i ɫ a vʲ a t
<|rus|>наноса	n a n o s a
<|rus|>присмотрев	p rʲ i s m a t rʲ e f
<|rus|>богословы	b a ɡ a s ɫ o v i
<|rus|>расстилавши	r a sʲ tʲ i ɫ a f ʂ i
<|rus|>искорёжило	i s k a rʲ o ʐ i ɫ a
<|rus|>отчисляем	a t͡ɕ i s ⁽ʲ ⁾ lʲ a j i m
<|rus|>выдачею	v i d a t͡ɕ i j u
<|rus|>родословными	r a d a s ɫ o v n i mʲ i
<|rus|>околёсицах	a k a lʲ o sʲ i t͡s a x
<|rus|>мораторий	m a r a t o rʲ i j
<|rus|>штрафовал	ʂ t r a f a v a ɫ
<|rus|>заутрень	z a u t rʲ i nʲ
<|rus|>придаваемый	p rʲ i d a v a j i m i j
<|rus|>сдавило	z d a vʲ i ɫ a
<|rus|>стремянку	s t rʲ i mʲ a n k u
<|rus|>времечке	v rʲ e mʲ i t͡ɕ kʲ e
<|rus|>понимаетесь	p a nʲ i m a j i tʲ i sʲ
<|rus|>присудим	p rʲ i s u dʲ i m
<|rus|>скорректировал	s k a rʲ i k tʲ i r a v a ɫ
<|rus|>искусите	i s k u sʲ i tʲ e
<|rus|>свергала	s vʲ i r ɡ a ɫ a
<|rus|>трудовой	t r u d a v o j
<|rus|>заблагорассудим	z a b ɫ a ɡ a r a s u dʲ i m
<|rus|>пожелтеем	p a ʐ i ɫ tʲ e j i m
<|rus|>грузимый	ɡ r u zʲ i m i j
<|rus|>спарывали	s p a r i v a lʲ i
<|rus|>востоковедам	v a s t a k a vʲ e d a m
<|rus|>правобережный	p r a v a bʲ i rʲ e ʐ n i j
<|rus|>жерлах	ʐ e r ɫ a x
<|rus|>бесполезный	bʲ i s p a lʲ e z n i j
<|rus|>выпрямлял	v i p rʲ i m lʲ a ɫ
<|rus|>вытряхнешь	v i t rʲ i x nʲ i ʂ
<|rus|>ватка	v a t k a
<|rus|>садку	s a t k u
<|rus|>заколебать	z a k a lʲ i b a tʲ
<|rus|>разживалась	r a ʐ i v a ɫ a sʲ
<|rus|>ворвитесь	v a r vʲ i tʲ i sʲ
<|rus|>задремлют	z a d rʲ e m lʲ u t
<|rus|>раскраской	r a s k r a s k a j
<|rus|>курский	k u r s kʲ i j
<|rus|>гувернантку	ɡ u vʲ i r n a n t k u
<|rus|>бризантностях	b rʲ i z a n t n a sʲ tʲ a x
<|rus|>дружила	d r u ʐ i ɫ a
<|rus|>контроллера	k a n t r o lʲ i r a
<|rus|>оканчивавшись	a k a nʲ t͡ɕ i v a f ʂ i sʲ
<|rus|>тупишь	t u pʲ i ʂ
<|rus|>библиотекарша	bʲ i b lʲ i a tʲ e k a r ʂ a
<|rus|>сраженью	s r a ʐ e nʲ j u
<|rus|>кошелях	k a ʂ i lʲ a x
<|rus|>вкалывая	f k a ɫ i v a j a
<|rus|>сливами	s ⁽ʲ ⁾ lʲ i v a mʲ i
<|rus|>полутьмах	p a ɫ u tʲ m a x
<|rus|>выдают	v i d a j u t
<|rus|>путаюсь	p u t a j u sʲ
<|rus|>совратили	s a v r a tʲ i lʲ i
<|rus|>мановении	m a n a vʲ e nʲ i i
<|rus|>матрасами	m a t r a s a mʲ i
<|rus|>лесоматериалам	lʲ e s a m a tʲ i rʲ i a ɫ a m
<|rus|>привяжу	p rʲ i vʲ i ʐ u
<|rus|>деспотами	dʲ e s p a t a mʲ i
<|rus|>пропитаниях	p r a pʲ i t a nʲ i j a x
<|rus|>отворяв	a t v a rʲ a f
<|rus|>мясорубками	mʲ i s a r u p k a mʲ i
<|rus|>укутавши	u k u t a f ʂ i
<|rus|>дынями	d i nʲ a mʲ i
<|rus|>мудоёба	m u d a j o b a
<|rus|>подстраховал	p a t͡s s t r a x a v a ɫ
<|rus|>обзвонит	a b z v a nʲ i t
<|rus|>лейкозом	lʲ i j k o z a m
<|rus|>установит	u s t a n o vʲ i t
<|rus|>совершатся	s a vʲ i r ʂ a t͡s a
<|rus|>десятиугольнику	dʲ i sʲ i tʲ i u ɡ o lʲ nʲ i k u
<|rus|>упрятав	u p rʲ a t a f
<|rus|>щитках	ɕː i t k a x
<|rus|>недоедавший	nʲ i d a j i d a f ʂ i j
<|rus|>запросят	z a p r o sʲ a t
<|rus|>лженаука	ɫ ʐ i n a u k a
<|rus|>вёзся	vʲ o sʲ a
<|rus|>одинока	a dʲ i n o k a
<|rus|>выдавливая	v i d a v lʲ i v a j a
<|rus|>котелки	k a tʲ i ɫ kʲ i
<|rus|>придерусь	p rʲ i dʲ i r u sʲ
<|rus|>типажах	tʲ i p a ʐ a x
<|rus|>ангстрем	a n k s t r i m
<|rus|>жестокий	ʐ i s t o kʲ i j
<|rus|>посвистывали	p a s vʲ i s t i v a lʲ i
<|rus|>удочерениях	u d a t͡ɕ i rʲ e nʲ i j a x
<|rus|>азиками	a zʲ i k a mʲ i
<|rus|>привинти	p rʲ i vʲ i nʲ tʲ i
<|rus|>синхронизаций	sʲ i n x r a nʲ i z a t͡s i j
<|rus|>заржаветь	z a r ʐ a vʲ i tʲ
<|rus|>отлежалась	a t lʲ i ʐ a ɫ a sʲ
<|rus|>девайсам	dʲ i v a j s a m
<|rus|>эликсиром	i lʲ i k sʲ i r a m
<|rus|>взмётываемый	v z mʲ o t i v a j i m i j
<|rus|>откраиваешь	a t k r a i v a j i ʂ
<|rus|>пионеру	pʲ i a nʲ e r u
<|rus|>акойт	a k o j t
<|rus|>дотаскав	d a t a s k a f
<|rus|>завершало	z a vʲ i r ʂ a ɫ a
<|rus|>нику	nʲ i k u
<|rus|>разъяряете	r a z j i rʲ a j i tʲ e
<|ukr|>демократично	d ɪ m ɔ k r ɛ t ɪ t͡ʃ n ɔ
<|ukr|>самобутній	s ɛ m ɔ b u tʲ nʲ i i
<|ukr|>сатана	s ɛ t ɛ n ɑ
<|ukr|>афганський	ɛ f ɦ ɑ nʲ sʲ k ɪ i
<|ukr|>літ	lʲ i t
<|ukr|>автобусна	ɛ u t ɔ b u s n ɛ
<|ukr|>щокою	ʃ t͡ʃ ɔ k ɔ j u
<|ukr|>оленина	ɔ ɫ ɪ n ɪ n ɛ
<|ukr|>космодром	k ɔ s m ɔ d r ɔ m
<|ukr|>поступку	p ɔ s t u p k u
<|ukr|>ознайомлення	ɔ z n ɛ j ɔ m ɫ ɪ nʲ ɛ
<|ukr|>другий	d r u ɦ ɪ i
<|ukr|>свіча	sʲ ʋ i t͡ʃ ɛ
<|ukr|>капітал	k ɛ p i t ɑ ɫ
<|ukr|>ім'я	i m j ɛ
<|ukr|>насолодитися	n ɛ s ɔ ɫ ɔ d ɪ t ɪ sʲ ɛ
<|ukr|>чорт	t͡ʃ ɔ r t
<|ukr|>каплиці	k ɛ p ɫ ɪ t͡sʲ i
<|ukr|>перевиховати	p ɪ r ɪ ʋ ɪ x ɔ ʋ ɛ t ɪ
<|ukr|>свояк	s ʋ ɔ j ɑ k
<|ukr|>незалежности	n ɪ z ɛ ɫ ɛ ʒ n ɔ s t ɪ
<|ukr|>досягнення	d ɔ sʲ ɑ ɦ n ɪ nʲ ɛ
<|ukr|>ідеальний	i d ɪ ɑ lʲ n ɪ i
<|ukr|>завдяки	z ɛ u dʲ ɛ k ɪ
<|ukr|>тунелях	t u n ɛ lʲ ɛ x
<|ukr|>обговорювати	ɔ b ɦ ɔ ʋ ɔ rʲ u ʋ ɛ t ɪ
<|ukr|>лакрос	ɫ ɛ k r ɔ s
<|ukr|>занотувати	z ɛ n ɔ t u ʋ ɑ t ɪ
<|ukr|>епохи	ɪ p ɔ x ɪ
<|ukr|>неприйнятний	n ɪ p r ɪ i nʲ ɛ t n ɪ i
<|ukr|>причинний	p r ɪ t͡ʃ ɪ n ɪ i
<|ukr|>щотижневий	ʃ t͡ʃ ɔ t ɪ ʒ n ɛ ʋ ɪ i
<|ukr|>капітулювати	k ɛ p i t u lʲ u ʋ ɑ t ɪ
<|ukr|>протитанковий	p r ɔ t ɪ t ɑ n k ɔ ʋ ɪ i
<|ukr|>трактор	t r ɑ k t ɔ r
<|ukr|>конфлікт	k ɔ n f lʲ i k t
<|ukr|>лебединий	ɫ ɪ b ɪ d ɪ n ɪ i
<|ukr|>пшениця	p ʃ ɪ n ɪ t͡sʲ ɛ
<|ukr|>краб	k r ɑ b
<|ukr|>недоступний	n ɪ d ɔ s t u p n ɪ i
<|ukr|>роззброювати	r ɔ z b r ɔ j u ʋ ɛ t ɪ
<|ukr|>клавіатур	k ɫ ɛ ʋ i ɛ t u r
<|ukr|>тротуари	t r ɔ t u ɑ r ɪ
<|ukr|>ізраїльтянин	i z r ɛ j i lʲ tʲ ɑ n ɪ n
<|ukr|>чудовисько	t͡ʃ u d ɔ ʋ ɪ sʲ k ɔ
<|ukr|>уста	u s t ɑ
<|ukr|>розпочати	r ɔ z p ɔ t͡ʃ ɑ t ɪ
<|ukr|>динаміка	d ɪ n ɑ m i k ɛ
<|ukr|>госпіталізація	ɦ ɔ sʲ p i t ɛ lʲ i z ɑ t͡sʲ i j ɛ
<|ukr|>африканець	ɛ f r ɪ k ɑ n ɪ t͡sʲ
<|ukr|>повість	p ɔ ʋ i sʲ tʲ
<|ukr|>гірський	ɦ i r sʲ k ɪ i
<|ukr|>остаточний	ɔ s t ɛ t ɔ t͡ʃ n ɪ i
<|ukr|>погнати	p ɔ ɦ n ɑ t ɪ
<|ukr|>сірий	sʲ i r ɪ i
<|ukr|>покарань	p ɔ k ɛ r ɑ nʲ
<|ukr|>поширити	p ɔ ʃ ɪ r ɪ t ɪ
<|ukr|>плівка	p lʲ i u k ɛ
<|ukr|>поліціях	p ɔ lʲ i t͡sʲ i j ɛ x
<|ukr|>потворний	p ɔ t ʋ ɔ r n ɪ i
<|ukr|>мотоцикл	m ɔ t ɔ t͡s ɪ k ɫ
<|ukr|>поступки	p ɔ s t u p k ɪ
<|ukr|>позбавляти	p ɔ z b ɛ u lʲ ɑ t ɪ
<|ukr|>виснажувати	ʋ ɪ s n ɑ ʒ u ʋ ɛ t ɪ
<|ukr|>смертоносний	s m ɪ r t ɔ n ɔ s n ɪ i
<|ukr|>глава	ɦ ɫ ɛ ʋ ɑ
<|ukr|>розділ	r ɔ zʲ dʲ i ɫ
<|ukr|>поздоровляти	p ɔ z d ɔ r ɔ u lʲ ɑ t ɪ
<|ukr|>дорога	d ɔ r ɔ ɦ ɛ
<|ukr|>аналізувати	ɛ n ɛ lʲ i z u ʋ ɑ t ɪ
<|ukr|>ілюзія	i lʲ u zʲ i j ɛ
<|ukr|>персональний	p ɪ r s ɔ n ɑ lʲ n ɪ i
<|ukr|>коронавірус	k ɔ r ɔ n ɛ ʋ i r u s
<|ukr|>заспокійливий	z ɛ s p ɔ k i i ɫ ɪ ʋ ɪ i
<|ukr|>дев'яностий	d ɪ ʋ j ɛ n ɔ s t ɪ i
<|ukr|>вступати	ʋ s t u p ɑ t ɪ
<|ukr|>вибирати	ʋ ɪ b ɪ r ɑ t ɪ
<|ukr|>заручати	z ɛ r u t͡ʃ ɑ t ɪ
<|ukr|>помирати	p ɔ m ɪ r ɑ t ɪ
<|ukr|>промовляти	p r ɔ m ɔ u lʲ ɑ t ɪ
<|ukr|>мікроскоп	m i k r ɔ s k ɔ p
<|ukr|>співробітник	sʲ p i u r ɔ b i t n ɪ k
<|ukr|>номінальний	n ɔ m i n ɑ lʲ n ɪ i
<|ukr|>прибічниця	p r ɪ b i t͡ʃ n ɪ t͡sʲ ɛ
<|ukr|>день	d ɛ nʲ
<|ukr|>з'ясувати	z j ɛ s u ʋ ɑ t ɪ
<|ukr|>віртуальний	ʋ i r t u ɑ lʲ n ɪ i
<|ukr|>пересічний	p ɪ r ɪ sʲ i t͡ʃ n ɪ i
<|ukr|>співіснування	sʲ p i ʋ i s n u ʋ ɑ nʲ ɛ
<|ukr|>мелодіям	m ɪ ɫ ɔ dʲ i j ɛ m
<|ukr|>відокремити	ʋ i d ɔ k r ɛ m ɪ t ɪ
<|ukr|>процедурний	p r ɔ t͡s ɪ d u r n ɪ i
<|ukr|>алло	ɛ ɫ ɔ
<|ukr|>гіпотеза	ɦ i p ɔ t ɪ z ɛ
<|ukr|>розв'язувати	r ɔ z ʋ j ɑ z u ʋ ɛ t ɪ
<|ukr|>ті	tʲ i
<|ukr|>антидот	ɛ n t ɪ d ɔ t
<|ukr|>мовознавець	m ɔ ʋ ɔ z n ɑ ʋ ɪ t͡sʲ
<|ukr|>забобон	z ɛ b ɔ b ɔ n
<|ukr|>оренда	ɔ r ɛ n d ɛ
<|ukr|>етап	ɪ t ɑ p
<|ukr|>повіки	p ɔ ʋ i k ɪ
<|ukr|>австромарксист	ɛ u s t r ɔ m ɛ r k s ɪ s t
<|ukr|>етика	ɛ t ɪ k ɛ
<|ukr|>болгарин	b ɔ ɫ ɦ ɑ r ɪ n
<|ukr|>постать	p ɔ s t ɛ tʲ
<|ukr|>мільйон	m i lʲ j ɔ n
<|ukr|>щі	ʃ t͡ʃʲ i
<|ukr|>лавандовий	ɫ ɛ ʋ ɑ n d ɔ ʋ ɪ i
<|ukr|>шведський	ʃ ʋ ɛ d͡zʲ sʲ k ɪ i
<|ukr|>оцими	ɔ t͡s ɪ m ɪ
<|ukr|>вчитель	ʋ t͡ʃ ɪ t ɪ lʲ
<|ukr|>безжурний	b ɪ ʒ u r n ɪ i
<|ukr|>хотітися	x ɔ tʲ i t ɪ sʲ ɛ
<|ukr|>слина	s ɫ ɪ n ɛ
<|ukr|>варіантами	ʋ ɛ rʲ i ɑ n t ɛ m ɪ
<|ukr|>відчути	ʋ i d͡ʒ t͡ʃ u t ɪ
<|ukr|>перлина	p ɪ r ɫ ɪ n ɛ
<|ukr|>релігійний	r ɪ lʲ i ɦ i i n ɪ i
<|ukr|>стать	s t ɑ tʲ
<|ukr|>стримати	s t r ɪ m ɛ t ɪ
<|ukr|>випроменити	ʋ ɪ p r ɔ m ɪ n ɪ t ɪ
<|ukr|>нагромаджувати	n ɛ ɦ r ɔ m ɑ d͡ʒ u ʋ ɛ t ɪ
<|ukr|>корінь	k ɔ rʲ i nʲ
<|ukr|>класовий	k ɫ ɑ s ɔ ʋ ɪ i
<|ukr|>ворота	ʋ ɔ r ɔ t ɛ
<|ukr|>й	j
<|ukr|>дивний	d ɪ u n ɪ i
<|ukr|>відпочивати	ʋ i d p ɔ t͡ʃ ɪ ʋ ɑ t ɪ
<|ukr|>жодний	ʒ ɔ d n ɪ i
<|ukr|>змова	z m ɔ ʋ ɛ
<|ukr|>відданий	ʋ i d ɛ n ɪ i
<|ukr|>теплота	t ɪ p ɫ ɔ t ɑ
<|ukr|>хрест	x r ɛ s t
<|ukr|>овід	ɔ ʋ i d
<|ukr|>козел	k ɔ z ɛ ɫ
<|ukr|>борщ	b ɔ r ʃ t͡ʃ
<|ukr|>роділля	r ɔ dʲ i lʲ ɛ
<|ukr|>періодизаціям	p ɪ rʲ i ɔ d ɪ z ɑ t͡sʲ i j ɛ m
<|ukr|>органічна	ɔ r ɦ ɛ nʲ i t͡ʃ n ɛ
<|ukr|>вирізнятися	ʋ ɪ rʲ i zʲ nʲ ɑ t ɪ sʲ ɛ
<|ukr|>дріжджі	dʲ rʲ i ʒ d͡ʒ i
<|ukr|>крикливий	k r ɪ k ɫ ɪ ʋ ɪ i
<|ukr|>вимикати	ʋ ɪ m ɪ k ɑ t ɪ
<|ukr|>уособити	u ɔ s ɔ b ɪ t ɪ
<|ukr|>видатний	ʋ ɪ d ɛ t n ɪ i
<|ukr|>інтенсивність	i n t ɪ n s ɪ u nʲ i sʲ tʲ
<|ukr|>тощо	t ɔ ʃ t͡ʃ ɔ
<|ukr|>повсюдний	p ɔ u sʲ u d n ɪ i
<|ukr|>перезаписати	p ɪ r ɪ z ɛ p ɪ s ɑ t ɪ
<|ukr|>феє	f ɛ j ɪ
<|ukr|>менше	m ɛ n ʃ ɪ
<|ukr|>чарівник	t͡ʃ ɛ rʲ i u n ɪ k
<|ukr|>зимовий	z ɪ m ɔ ʋ ɪ i
<|ukr|>ламати	ɫ ɛ m ɑ t ɪ
<|ukr|>зара	z ɑ r ɛ
<|ukr|>науковий	n ɛ u k ɔ ʋ ɪ i
<|ukr|>авіапідживлення	ɛ ʋ i ɛ p i d͡ʒ ɪ u ɫ ɪ nʲ ɛ
<|ukr|>принизити	p r ɪ n ɪ z ɪ t ɪ
<|ukr|>брест	b r ɛ s t
<|ukr|>японіє	j ɛ p ɔ nʲ i j ɪ
<|ukr|>диктатор	d ɪ k t ɑ t ɔ r
<|ukr|>шестигранник	ʃ ɪ s t ɪ ɦ r ɑ n ɪ k
<|ukr|>авіапасажир	ɛ ʋ i ɛ p ɛ s ɛ ʒ ɪ r
<|ukr|>бельгійський	b ɪ lʲ ɦ i i sʲ k ɪ i
<|ukr|>легеня	ɫ ɪ ɦ ɛ nʲ ɛ
<|ukr|>сюди	sʲ u d ɪ
<|ukr|>охопити	ɔ x ɔ p ɪ t ɪ
<|ukr|>шинок	ʃ ɪ n ɔ k
<|ukr|>трагічний	t r ɛ ɦ i t͡ʃ n ɪ i
<|ukr|>вкус	ʋ k u s
<|ukr|>брехнями	b r ɛ x nʲ ɛ m ɪ
<|ukr|>високосний	ʋ ɪ s ɔ k ɔ s n ɪ i
<|ukr|>блокадою	b ɫ ɔ k ɑ d ɔ j u
<|ukr|>трав'яний	t r ɛ ʋ j ɛ n ɪ i
<|ukr|>заявити	z ɛ j ɛ ʋ ɪ t ɪ
<|ukr|>біржа	b i r ʒ ɛ
<|ukr|>пінистий	p i n ɪ s t ɪ i
<|ukr|>щоку	ʃ t͡ʃ ɔ k u
<|ukr|>відважний	ʋ i d ʋ ɑ ʒ n ɪ i
<|ukr|>бойко	b ɔ i k ɔ
<|ukr|>технократичний	t ɪ x n ɔ k r ɛ t ɪ t͡ʃ n ɪ i
<|ukr|>михайло	m ɪ x ɑ i ɫ ɔ
<|ukr|>упасти	u p ɑ s t ɪ
<|ukr|>таємницями	t ɛ j ɪ m n ɪ t͡sʲ ɛ m ɪ
<|ukr|>компактний	k ɔ m p ɑ k t n ɪ i
<|ukr|>епідеміологія	ɪ p i d ɪ m i ɔ ɫ ɔ ɦ i j ɛ
<|ukr|>страх	s t r ɑ x
<|ukr|>речі	r ɛ t͡ʃʲ i
<|ukr|>споживчий	s p ɔ ʒ ɪ u t͡ʃ ɪ i
<|ukr|>скаржитися	s k ɑ r ʒ ɪ t ɪ sʲ ɛ
<|ukr|>біологія	b i ɔ ɫ ɔ ɦ i j ɛ
<|ukr|>коханий	k ɔ x ɛ n ɪ i
<|ukr|>водосховище	ʋ ɔ d ɔ s x ɔ ʋ ɪ ʃ t͡ʃ ɪ
<|ukr|>атеїстичний	ɛ t ɪ j i s t ɪ t͡ʃ n ɪ i
<|ukr|>звідкись	zʲ ʋ i d k ɪ sʲ
<|ukr|>липа	ɫ ɪ p ɛ
<|ukr|>стіна	sʲ tʲ i n ɑ
<|ukr|>класти	k ɫ ɑ s t ɪ
<|ukr|>мислити	m ɪ s ɫ ɪ t ɪ
<|ukr|>аброгація	ɛ b r ɔ ɦ ɑ t͡sʲ i j ɛ
<|ukr|>джгут	d͡ʒ ɦ u t
<|ukr|>глек	ɦ ɫ ɛ k
<|ukr|>досьє	d ɔ sʲ j ɛ
<|ukr|>вулиця	ʋ u ɫ ɪ t͡sʲ ɛ
<|ukr|>еволюціонувати	ɪ ʋ ɔ lʲ u t͡sʲ i ɔ n u ʋ ɑ t ɪ
<|ukr|>цнотливий	t͡s n ɔ t ɫ ɪ ʋ ɪ i
<|ukr|>організаціє	ɔ r ɦ ɛ nʲ i z ɑ t͡sʲ i j ɪ
<|ukr|>добувати	d ɔ b u ʋ ɑ t ɪ
<|ukr|>перемир'я	p ɪ r ɪ m ɪ r j ɛ
<|ukr|>сплачувати	s p ɫ ɑ t͡ʃ u ʋ ɛ t ɪ
<|ukr|>ресторан	r ɪ s t ɔ r ɑ n
<|ukr|>мріями	m rʲ i j ɛ m ɪ
<|ukr|>паузу	p ɑ u z u
<|ukr|>емігрувати	ɪ m i ɦ r u ʋ ɑ t ɪ
<|ukr|>наймати	n ɛ i m ɑ t ɪ
<|ukr|>почати	p ɔ t͡ʃ ɑ t ɪ
<|ukr|>мікрофон	m i k r ɔ f ɔ n
<|ukr|>границя	ɦ r ɛ n ɪ t͡sʲ ɛ
<|ukr|>бидло	b ɪ d ɫ ɔ
<|ukr|>піраміда	p i r ɛ m i d ɛ
<|ukr|>бере	b ɪ r ɛ
<|ukr|>херсон	x ɪ r s ɔ n
<|ukr|>легітимація	ɫ ɪ ɦ i t ɪ m ɑ t͡sʲ i j ɛ
<|ukr|>рукою	r u k ɔ j u
<|ukr|>благий	b ɫ ɛ ɦ ɪ i
<|ukr|>позаземний	p ɔ z ɛ z ɛ m n ɪ i
<|ukr|>бувати	b u ʋ ɑ t ɪ
<|ukr|>рослина	r ɔ s ɫ ɪ n ɛ
<|ukr|>дитсадків	d ɪ t͡s ɛ dʲ k i u
<|ukr|>революція	r ɪ ʋ ɔ lʲ u t͡sʲ i j ɛ
<|ukr|>фірма	f i r m ɛ
<|ukr|>рейтузи	r ɪ i t u z ɪ
<|ukr|>легеневий	ɫ ɪ ɦ ɪ n ɛ ʋ ɪ i
<|ukr|>каштан	k ɛ ʃ t ɑ n
<|ukr|>підвищувати	p i d ʋ ɪ ʃ t͡ʃ u ʋ ɛ t ɪ
<|ukr|>спланувати	s p ɫ ɛ n u ʋ ɑ t ɪ
<|ukr|>мовити	m ɔ ʋ ɪ t ɪ
<|ukr|>турнір	t u r nʲ i r
<|ukr|>песимістичний	p ɪ s ɪ m i s t ɪ t͡ʃ n ɪ i
<|ukr|>церковний	t͡s ɪ r k ɔ u n ɪ i
<|ukr|>шаповал	ʃ ɛ p ɔ ʋ ɑ ɫ
<|ukr|>підхожий	p i d x ɔ ʒ ɪ i
<|ukr|>переорієнтувати	p ɪ r ɪ ɔ rʲ i j ɪ n t u ʋ ɑ t ɪ
<|ukr|>відсвяткувати	ʋ i d͡z sʲ ʋ ɛ t k u ʋ ɑ t ɪ
<|ukr|>тригліцерид	t r ɪ ɦ lʲ i t͡s ɪ r ɪ d
<|ukr|>безперебійний	b ɪ z p ɪ r ɪ b i i n ɪ i
<|ukr|>пісня	p i sʲ nʲ ɛ
<|ukr|>портфелях	p ɔ r t f ɛ lʲ ɛ x
<|ukr|>велосипед	ʋ ɪ ɫ ɔ s ɪ p ɛ d
<|ukr|>кончина	k ɔ n t͡ʃ ɪ n ɛ
<|ukr|>міфологія	m i f ɔ ɫ ɔ ɦ i j ɛ
<|ukr|>домашнє	d ɔ m ɑ ʃ nʲ ɪ
<|ukr|>роман	r ɔ m ɑ n
<|ukr|>патріотизмі	p ɛ tʲ rʲ i ɔ t ɪ zʲ m i
<|ukr|>авіатраса	ɛ ʋ i ɛ t r ɑ s ɛ
<|ukr|>порівняння	p ɔ rʲ i u nʲ ɑ nʲ ɛ
<|ukr|>стабільний	s t ɛ b i lʲ n ɪ i
<|ukr|>прибічник	p r ɪ b i t͡ʃ n ɪ k
<|ukr|>відвага	ʋ i d ʋ ɑ ɦ ɛ
<|ukr|>згодний	z ɦ ɔ d n ɪ i
<|ukr|>герцогиня	ɦ ɪ r t͡s ɔ ɦ ɪ nʲ ɛ
<|ukr|>акул	ɛ k u ɫ
<|ukr|>гони	ɦ ɔ n ɪ
<|ukr|>риба	r ɪ b ɛ
<|ukr|>відрізнятися	ʋ i dʲ rʲ i zʲ nʲ ɑ t ɪ sʲ ɛ
<|ukr|>навігаційний	n ɛ ʋ i ɦ ɛ t͡sʲ i i n ɪ i
<|ukr|>рушниця	r u ʃ n ɪ t͡sʲ ɛ
<|ukr|>афганістан	ɛ f ɦ ɛ nʲ i s t ɑ n
<|ukr|>освіжити	ɔ sʲ ʋ i ʒ ɪ t ɪ
<|ukr|>перевага	p ɪ r ɪ ʋ ɑ ɦ ɛ
<|ukr|>арістотель	ɛ rʲ i s t ɔ t ɪ lʲ
<|ukr|>квадратний	k ʋ ɛ d r ɑ t n ɪ i
<|ukr|>вибиратися	ʋ ɪ b ɪ r ɑ t ɪ sʲ ɛ
<|ukr|>змагатися	z m ɛ ɦ ɑ t ɪ sʲ ɛ
<|ukr|>абсолютно	ɛ b s ɔ lʲ u t n ɔ
<|ukr|>довоєнний	d ɔ ʋ ɔ j ɛ n ɪ i
<|ukr|>різноманітний	rʲ i z n ɔ m ɛ nʲ i t n ɪ i
<|ukr|>злочинець	z ɫ ɔ t͡ʃ ɪ n ɪ t͡sʲ
<|ukr|>веретено	ʋ ɪ r ɪ t ɛ n ɔ
<|ukr|>постійно	p ɔ sʲ tʲ i i n ɔ
<|ukr|>брухт	b r u x t
<|ukr|>звернення	z ʋ ɛ r n ɪ nʲ ɛ
<|ukr|>мева	m ɛ ʋ ɛ
<|ukr|>внаслідок	ʋ n ɑ sʲ lʲ i d ɔ k
<|ukr|>другові	d r u ɦ ɔ ʋ i
<|ukr|>феях	f ɛ j ɛ x
<|ukr|>чверті	t͡ʃ ʋ ɛ r tʲ i
<|ukr|>кишенькові	k ɪ ʃ ɪ nʲ k ɔ ʋ i
<|ukr|>дивізіях	d ɪ ʋ i zʲ i j ɛ x
<|ukr|>цікавий	t͡sʲ i k ɑ ʋ ɪ i
<|ukr|>критеріям	k r ɪ t ɛ rʲ i j ɛ m
<|ukr|>аероскопія	ɛ ɪ r ɔ s k ɔ p i j ɛ
<|ukr|>завершення	z ɛ ʋ ɛ r ʃ ɪ nʲ ɛ
<|ukr|>вільнодумець	ʋ i lʲ n ɔ d u m ɪ t͡sʲ
<|ukr|>скловидний	s k ɫ ɔ ʋ ɪ d n ɪ i
<|ukr|>довічний	d ɔ ʋ i t͡ʃ n ɪ i
<|ukr|>нирка	n ɪ r k ɛ
<|ukr|>ковзкий	k ɔ u z k ɪ i
<|ukr|>доброчесний	d ɔ b r ɔ t͡ʃ ɛ s n ɪ i
<|ukr|>обстежувати	ɔ b s t ɛ ʒ u ʋ ɛ t ɪ
<|ukr|>танцювати	t ɛ nʲ t͡sʲ u ʋ ɑ t ɪ
<|ukr|>опитати	ɔ p ɪ t ɑ t ɪ
<|ukr|>ради	r ɑ d ɪ
<|ukr|>слимак	s ɫ ɪ m ɑ k
<|ukr|>зелен	z ɛ ɫ ɪ n
<|ukr|>епох	ɪ p ɔ x
<|ukr|>румунський	r u m u nʲ sʲ k ɪ i
<|ukr|>грізний	ɦ rʲ i z n ɪ i
<|ukr|>ситуаціях	s ɪ t u ɑ t͡sʲ i j ɛ x
<|ukr|>безжальний	b ɪ ʒ ɑ lʲ n ɪ i
<|ukr|>така	t ɛ k ɑ
<|ukr|>драматургічний	d r ɛ m ɛ t u r ɦ i t͡ʃ n ɪ i
<|ukr|>автовласник	ɛ u t ɔ u ɫ ɑ s n ɪ k
<|ukr|>українськими	u k r ɛ j i nʲ sʲ k ɪ m ɪ
<|ukr|>город	ɦ ɔ r ɔ d
<|ukr|>унікальний	u nʲ i k ɑ lʲ n ɪ i
<|ukr|>споживання	s p ɔ ʒ ɪ ʋ ɑ nʲ ɛ
<|ukr|>посуд	p ɔ s u d
<|ukr|>нас	n ɑ s
<|ukr|>діафрагмами	dʲ i ɛ f r ɑ ɦ m ɛ m ɪ
<|ukr|>критикувати	k r ɪ t ɪ k u ʋ ɑ t ɪ
<|ukr|>болниця	b ɔ ɫ n ɪ t͡sʲ ɛ
<|ukr|>привітати	p r ɪ ʋ i t ɑ t ɪ
<|ukr|>ворожнеча	ʋ ɔ r ɔ ʒ n ɛ t͡ʃ ɛ
<|ukr|>недооцінювати	n ɪ d ɔ ɔ t͡sʲ i nʲ u ʋ ɛ t ɪ
<|ukr|>стілець	sʲ tʲ i ɫ ɛ t͡sʲ
<|ukr|>туризм	t u r ɪ z m
<|ukr|>албанія	ɛ ɫ b ɑ nʲ i j ɛ
<|ukr|>глід	ɦ lʲ i d
<|ukr|>медитація	m ɪ d ɪ t ɑ t͡sʲ i j ɛ
<|ukr|>діафрагмі	dʲ i ɛ f r ɑ ɦ m i
<|ukr|>засновник	z ɛ s n ɔ u n ɪ k
<|ukr|>скло	s k ɫ ɔ
<|ukr|>дошках	d ɔ ʃ k ɛ x
<|ukr|>кільце	k i lʲ t͡s ɛ
<|ukr|>ізумрудний	i z u m r u d n ɪ i
<|ukr|>келих	k ɛ ɫ ɪ x
<|ukr|>антибіотики	ɛ n t ɪ b i ɔ t ɪ k ɪ
<|ukr|>сукня	s u k nʲ ɛ
<|ukr|>кишенях	k ɪ ʃ ɛ nʲ ɛ x
<|ukr|>радість	r ɑ dʲ i sʲ tʲ
<|ukr|>портфеля	p ɔ r t f ɛ lʲ ɛ
<|ukr|>можна	m ɔ ʒ n ɛ
<|ukr|>різноманіття	rʲ i z n ɔ m ɛ nʲ i tʲ ɛ
<|ukr|>амбіція	ɛ m b i t͡sʲ i j ɛ
<|ukr|>родзинка	r ɔ d͡z ɪ n k ɛ
<|ukr|>ненароджений	n ɪ n ɛ r ɔ d͡ʒ ɪ n ɪ i
<|ukr|>щоко	ʃ t͡ʃ ɔ k ɔ
<|ukr|>карась	k ɛ r ɑ sʲ
<|ukr|>суспільство	s u sʲ p i lʲ s t ʋ ɔ
<|ukr|>прати	p r ɑ t ɪ
<|ukr|>серцевий	s ɪ r t͡s ɛ ʋ ɪ i
<|ukr|>щавель	ʃ t͡ʃ ɛ ʋ ɛ lʲ
<|ukr|>термометричний	t ɪ r m ɔ m ɪ t r ɪ t͡ʃ n ɪ i
<|ukr|>для	dʲ lʲ ɑ
<|ukr|>шовковий	ʃ ɔ u k ɔ ʋ ɪ i
<|ukr|>склянка	s k lʲ ɑ n k ɛ
<|ukr|>волейболістка	ʋ ɔ ɫ ɪ i b ɔ lʲ i s t k ɛ
<|ukr|>зима	z ɪ m ɑ
<|ukr|>змі	zʲ m i
<|ukr|>помста	p ɔ m s t ɛ
<|ukr|>кара	k ɑ r ɛ
<|ukr|>пархоменко	p ɛ r x ɔ m ɪ n k ɔ
<|ukr|>енергій	ɪ n ɛ r ɦ i i
<|ukr|>терпеливість	t ɪ r p ɪ ɫ ɪ ʋ i sʲ tʲ
<|ukr|>здогадуватися	z d ɔ ɦ ɑ d u ʋ ɛ t ɪ sʲ ɛ
<|ukr|>яловичину	j ɑ ɫ ɔ ʋ ɪ t͡ʃ ɪ n u
<|ukr|>динамічно	d ɪ n ɛ m i t͡ʃ n ɔ
<|ukr|>ягода	j ɑ ɦ ɔ d ɛ
<|ukr|>дієвий	dʲ i j ɛ ʋ ɪ i
<|ukr|>вижлоктати	ʋ ɪ ʒ ɫ ɔ k t ɛ t ɪ
<|ukr|>трагедія	t r ɛ ɦ ɛ dʲ i j ɛ
<|ukr|>підприємство	p i d p r ɪ j ɛ m s t ʋ ɔ
<|ukr|>теща	t ɛ ʃ t͡ʃ ɛ
<|ukr|>дебютувати	d ɪ b u t u ʋ ɑ t ɪ
<|ukr|>відчиняти	ʋ i d͡ʒ t͡ʃ ɪ nʲ ɑ t ɪ
<|ukr|>упевненість	u p ɛ u n ɪ nʲ i sʲ tʲ
<|ukr|>наявний	n ɛ j ɑ u n ɪ i
<|ukr|>комора	k ɔ m ɔ r ɛ
<|ukr|>подібність	p ɔ dʲ i b nʲ i sʲ tʲ
<|ukr|>суб'єкт	s u b j ɛ k t
<|ukr|>звідси	zʲ ʋ i d͡z s ɪ
<|ukr|>неврологія	n ɪ u r ɔ ɫ ɔ ɦ i j ɛ
<|ukr|>долонях	d ɔ ɫ ɔ nʲ ɛ x
<|ukr|>мексиканка	m ɪ k s ɪ k ɑ n k ɛ
<|ukr|>побачення	p ɔ b ɑ t͡ʃ ɪ nʲ ɛ
<|ukr|>маскат	m ɛ s k ɑ t
<|ukr|>обідати	ɔ b i d ɛ t ɪ
<|ukr|>цегла	t͡s ɛ ɦ ɫ ɛ
<|ukr|>трансформаціях	t r ɛ n s f ɔ r m ɑ t͡sʲ i j ɛ x
<|ukr|>двадцятиоднокутник	d ʋ ɛ d͡zʲ t͡sʲ ɛ t ɪ ɔ d n ɔ k u t n ɪ k
<|ukr|>підняти	p i dʲ nʲ ɑ t ɪ
<|ukr|>постатях	p ɔ s t ɛ tʲ ɛ x
<|ukr|>білий	b i ɫ ɪ i
<|ukr|>підвіконня	p i dʲ ʋ i k ɔ nʲ ɛ
<|ukr|>візовий	ʋ i z ɔ ʋ ɪ i
<|ukr|>антагонізм	ɛ n t ɛ ɦ ɔ nʲ i z m
<|ukr|>синтезувати	s ɪ n t ɪ z u ʋ ɑ t ɪ
<|ukr|>зоровий	z ɔ r ɔ ʋ ɪ i
<|ukr|>сприйняття	s p r ɪ i nʲ ɛ tʲ ɑ
<|ukr|>концепт	k ɔ n t͡s ɛ p t
<|ukr|>шанувальник	ʃ ɛ n u ʋ ɑ lʲ n ɪ k
<|ukr|>положення	p ɔ ɫ ɔ ʒ ɪ nʲ ɛ
<|ukr|>забороняти	z ɛ b ɔ r ɔ nʲ ɑ t ɪ
<|ukr|>помідор	p ɔ m i d ɔ r
<|ukr|>аборт	ɛ b ɔ r t
<|ukr|>обчислювати	ɔ b t͡ʃ ɪ sʲ lʲ u ʋ ɛ t ɪ
<|ukr|>галстук	ɦ ɑ ɫ s t u k
<|ukr|>друг	d r u ɦ
<|ukr|>скоро	s k ɔ r ɔ
<|ukr|>акцентувати	ɛ k t͡s ɪ n t u ʋ ɑ t ɪ
<|ukr|>частка	t͡ʃ ɑ s t k ɛ
<|ukr|>скроні	s k r ɔ nʲ i
<|ukr|>комедія	k ɔ m ɛ dʲ i j ɛ
<|ukr|>позиція	p ɔ z ɪ t͡sʲ i j ɛ
<|ukr|>міф	m i f
<|ukr|>ліцензія	lʲ i t͡s ɛ nʲ zʲ i j ɛ
<|ukr|>команда	k ɔ m ɑ n d ɛ
<|ukr|>арка	ɑ r k ɛ
<|ukr|>аероліт	ɛ ɪ r ɔ lʲ i t
<|ukr|>приймати	p r ɪ i m ɑ t ɪ
<|ukr|>добривечір	d ɔ b r ɪ ʋ ɛ t͡ʃʲ i r
<|ukr|>схематизувати	s x ɪ m ɛ t ɪ z u ʋ ɑ t ɪ
<|ukr|>колись	k ɔ ɫ ɪ sʲ
<|ukr|>жасмин	ʒ ɛ s m ɪ n
<|ukr|>авіаметеослужба	ɛ ʋ i ɛ m ɪ t ɪ ɔ s ɫ u ʒ b ɛ
<|ukr|>категоричний	k ɛ t ɪ ɦ ɔ r ɪ t͡ʃ n ɪ i
<|ukr|>гуцульщина	ɦ u t͡s u lʲ ʃ t͡ʃ ɪ n ɛ
<|ukr|>масть	m ɑ sʲ tʲ
<|ukr|>портативний	p ɔ r t ɛ t ɪ u n ɪ i
<|ukr|>репресивний	r ɪ p r ɪ s ɪ u n ɪ i
<|ukr|>просьба	p r ɔ zʲ b ɛ
<|ukr|>убогий	u b ɔ ɦ ɪ i
<|ukr|>безпілотний	b ɪ zʲ p i ɫ ɔ t n ɪ i
<|ukr|>лисиця	ɫ ɪ s ɪ t͡sʲ ɛ
<|ukr|>гладіатор	ɦ ɫ ɛ dʲ i ɑ t ɔ r
<|ukr|>гуманістка	ɦ u m ɛ nʲ i s t k ɛ
<|ukr|>пласт	p ɫ ɑ s t
<|ukr|>єврейський	j ɪ u r ɛ i sʲ k ɪ i
<|ukr|>волокти	ʋ ɔ ɫ ɔ k t ɪ
<|ukr|>нідерланди	nʲ i d ɪ r ɫ ɑ n d ɪ
<|ukr|>органи	ɔ r ɦ ɛ n ɪ
<|ukr|>щитоподібна	ʃ t͡ʃ ɪ t ɔ p ɔ dʲ i b n ɛ
<|ukr|>руку	r u k u
<|ukr|>тісний	tʲ i s n ɪ i
<|ukr|>журнал	ʒ u r n ɑ ɫ
<|ukr|>ліс	lʲ i s
<|ukr|>наблизити	n ɛ b ɫ ɪ z ɪ t ɪ
<|ukr|>квантова	k ʋ ɑ n t ɔ ʋ ɛ
<|ukr|>нестерпний	n ɪ s t ɛ r p n ɪ i
<|ukr|>плавець	p ɫ ɛ ʋ ɛ t͡sʲ
<|ukr|>виборами	ʋ ɪ b ɔ r ɛ m ɪ
<|ukr|>неперервний	n ɪ p ɪ r ɛ r ʋ n ɪ i
<|ukr|>тяжкий	tʲ ɛ ʒ k ɪ i
<|ukr|>експонат	ɪ k s p ɔ n ɑ t
<|ukr|>артеріям	ɛ r t ɛ rʲ i j ɛ m
<|ukr|>богослов'я	b ɔ ɦ ɔ s ɫ ɔ ʋ j ɛ
<|ukr|>парашутизм	p ɛ r ɛ ʃ u t ɪ z m
<|ukr|>родитися	r ɔ d ɪ t ɪ sʲ ɛ
<|ukr|>молекулярна	m ɔ ɫ ɪ k u lʲ ɑ r n ɛ
<|ukr|>авторизувати	ɛ u t ɔ r ɪ z u ʋ ɑ t ɪ
<|ukr|>поєднання	p ɔ j ɪ d n ɑ nʲ ɛ
<|ukr|>листопад	ɫ ɪ s t ɔ p ɑ d
<|ukr|>ікра	i k r ɑ
<|ukr|>працівниці	p r ɛ t͡sʲ i u n ɪ t͡sʲ i
<|ukr|>самоціль	s ɛ m ɔ t͡sʲ i lʲ
<|ukr|>тренер	t r ɛ n ɪ r
<|ukr|>болото	b ɔ ɫ ɔ t ɔ
<|ukr|>існуючий	i s n u j u t͡ʃ ɪ i
<|ukr|>сприятливий	s p r ɪ j ɑ t ɫ ɪ ʋ ɪ i
<|ukr|>можливість	m ɔ ʒ ɫ ɪ ʋ i sʲ tʲ
<|ukr|>родовий	r ɔ d ɔ ʋ ɪ i
<|ukr|>стимул	s t ɪ m u ɫ
<|ukr|>населити	n ɛ s ɪ ɫ ɪ t ɪ
<|ukr|>терем	t ɛ r ɪ m
<|ukr|>крим	k r ɪ m
<|ukr|>аркуш	ɑ r k u ʃ
<|ukr|>гнати	ɦ n ɑ t ɪ
<|ukr|>вівсів	ʋ i u sʲ i u
<|ukr|>прислівниковий	p r ɪ sʲ lʲ i u n ɪ k ɔ ʋ ɪ i
<|ukr|>безвідсотковий	b ɪ zʲ ʋ i d͡z s ɔ t k ɔ ʋ ɪ i
<|ukr|>навруз	n ɛ u r u z
<|ukr|>пень	p ɛ nʲ
<|ukr|>дзиґа	d͡z ɪ ɡ ɛ
<|ukr|>блокадами	b ɫ ɔ k ɑ d ɛ m ɪ
<|ukr|>гаманець	ɦ ɛ m ɛ n ɛ t͡sʲ
<|ukr|>шведка	ʃ ʋ ɛ d k ɛ
<|ukr|>поема	p ɔ ɛ m ɛ
<|ukr|>чайна	t͡ʃ ɛ i n ɑ
<|ukr|>коровай	k ɔ r ɔ ʋ ɑ i
<|ukr|>календарем	k ɛ ɫ ɪ n d ɛ r ɛ m
<|ukr|>орнітологія	ɔ r nʲ i t ɔ ɫ ɔ ɦ i j ɛ
<|ukr|>різновид	rʲ i z n ɔ ʋ ɪ d
<|ukr|>бонусом	b ɔ n u s ɔ m
<|ukr|>досвідчений	d ɔ sʲ ʋ i d͡ʒ t͡ʃ ɪ n ɪ i
<|ukr|>геймплей	ɦ ɪ i m p ɫ ɛ i
<|ukr|>гривень	ɦ r ɪ ʋ ɪ nʲ
<|ukr|>вжити	ʋ ʒ ɪ t ɪ
<|ukr|>корчма	k ɔ r t͡ʃ m ɛ
<|ukr|>ензим	ɪ n z ɪ m
<|ukr|>поступці	p ɔ s t u p t͡sʲ i
<|ukr|>морозиво	m ɔ r ɔ z ɪ ʋ ɔ
<|ukr|>батяри	b ɛ tʲ ɑ r ɪ
<|ukr|>благо	b ɫ ɑ ɦ ɔ
<|ukr|>уособлювати	u ɔ s ɔ b lʲ u ʋ ɛ t ɪ
<|ukr|>ідеалістичний	i d ɪ ɛ lʲ i s t ɪ t͡ʃ n ɪ i
<|ukr|>пропорції	p r ɔ p ɔ r t͡sʲ i j i
<|ukr|>промокнути	p r ɔ m ɔ k n u t ɪ
<|ukr|>монополіст	m ɔ n ɔ p ɔ lʲ i s t
<|ukr|>собівартість	s ɔ b i ʋ ɑ r tʲ i sʲ tʲ
<|ukr|>швидкість	ʃ ʋ ɪ dʲ k i sʲ tʲ
<|ukr|>слухач	s ɫ u x ɑ t͡ʃ
<|ukr|>позбутися	p ɔ z b u t ɪ sʲ ɛ
<|ukr|>тістечко	tʲ i s t ɪ t͡ʃ k ɔ
<|ukr|>соня	s ɔ nʲ ɛ
<|ukr|>нейтралітет	n ɪ i t r ɛ lʲ i t ɛ t
<|ukr|>кіш	k i ʃ
<|ukr|>фільтр	f i lʲ t r
<|ukr|>текстовий	t ɪ k s t ɔ ʋ ɪ i
<|ukr|>імперія	i m p ɛ rʲ i j ɛ
<|ukr|>хмельницький	x m ɪ lʲ n ɪ t͡sʲ k ɪ i
<|ukr|>фактичний	f ɛ k t ɪ t͡ʃ n ɪ i
<|ukr|>тисяч	t ɪ sʲ ɛ t͡ʃ
<|ukr|>відданість	ʋ i d ɛ nʲ i sʲ tʲ
<|ukr|>пріоритет	p rʲ i ɔ r ɪ t ɛ t
<|ukr|>маніпулювати	m ɛ nʲ i p u lʲ u ʋ ɑ t ɪ
<|ukr|>академічний	ɛ k ɛ d ɪ m i t͡ʃ n ɪ i
<|ukr|>гриб	ɦ r ɪ b
<|ukr|>україною	u k r ɛ j i n ɔ j u
<|ukr|>аґрусівка	ɛ ɡ r u sʲ i u k ɛ
<|ukr|>супругою	s u p r u ɦ ɔ j u
<|ukr|>аб'юрація	ɛ b j u r ɑ t͡sʲ i j ɛ
<|ukr|>дисбаланс	d ɪ z b ɛ ɫ ɑ n s
<|ukr|>переоцінювати	p ɪ r ɪ ɔ t͡sʲ i nʲ u ʋ ɛ t ɪ
<|ukr|>позбавити	p ɔ z b ɑ ʋ ɪ t ɪ
<|ukr|>гібридний	ɦ i b r ɪ d n ɪ i
<|ukr|>душ	d u ʃ
<|ukr|>філософія	f i ɫ ɔ s ɔ f i j ɛ
<|ukr|>сусідка	s u sʲ i d k ɛ
<|ukr|>першість	p ɛ r ʃ i sʲ tʲ
<|ukr|>інтенсифікувати	i n t ɪ n s ɪ f i k u ʋ ɑ t ɪ
<|ukr|>феміністичний	f ɪ m i nʲ i s t ɪ t͡ʃ n ɪ i
<|ukr|>дати	d ɑ t ɪ
<|ukr|>підмет	p i d m ɪ t
<|ukr|>прамова	p r ɛ m ɔ ʋ ɛ
<|ukr|>каплицею	k ɛ p ɫ ɪ t͡s ɪ j u
<|ukr|>систематичний	s ɪ s t ɪ m ɛ t ɪ t͡ʃ n ɪ i
<|ukr|>росіянин	r ɔ sʲ i j ɑ n ɪ n
<|ukr|>тополі	t ɔ p ɔ lʲ i
<|ukr|>активність	ɛ k t ɪ u nʲ i sʲ tʲ
<|ukr|>авіасалон	ɛ ʋ i ɛ s ɛ ɫ ɔ n
<|ukr|>даремність	d ɛ r ɛ m nʲ i sʲ tʲ
<|ukr|>головний	ɦ ɔ ɫ ɔ u n ɪ i
<|ukr|>спортивний	s p ɔ r t ɪ u n ɪ i
<|ukr|>кліматичний	k lʲ i m ɛ t ɪ t͡ʃ n ɪ i
<|ukr|>вищий	ʋ ɪ ʃ t͡ʃ ɪ i
<|ukr|>відпочилий	ʋ i d p ɔ t͡ʃ ɪ ɫ ɪ i
<|ukr|>чабер	t͡ʃ ɛ b ɛ r
<|ukr|>психологічний	p s ɪ x ɔ ɫ ɔ ɦ i t͡ʃ n ɪ i
<|ukr|>мізерний	m i z ɪ r n ɪ i
<|ukr|>токар	t ɔ k ɛ r
<|ukr|>угорськомовний	u ɦ ɔ r sʲ k ɔ m ɔ u n ɪ i
<|ukr|>шоколад	ʃ ɔ k ɔ ɫ ɑ d
<|ukr|>яма	j ɑ m ɛ
<|ukr|>дані	d ɑ nʲ i
<|ukr|>зовні	z ɔ u nʲ i
<|ukr|>сумніватися	s u m nʲ i ʋ ɑ t ɪ sʲ ɛ
<|ukr|>вітебськ	ʋ i t ɪ b sʲ k
<|ukr|>друже	d r u ʒ ɪ
<|ukr|>називати	n ɛ z ɪ ʋ ɑ t ɪ
<|ukr|>концепція	k ɔ n t͡s ɛ p t͡sʲ i j ɛ
<|ukr|>конлі	k ɔ nʲ lʲ i
<|ukr|>рости	r ɔ s t ɪ
<|ukr|>будда	b u d ɛ
<|ukr|>активувати	ɛ k t ɪ ʋ u ʋ ɑ t ɪ
<|ukr|>візантійський	ʋ i z ɛ nʲ tʲ i i sʲ k ɪ i
<|ukr|>судно	s u d n ɔ
<|ukr|>фразеологічний	f r ɛ z ɪ ɔ ɫ ɔ ɦ i t͡ʃ n ɪ i
<|ukr|>артеріє	ɛ r t ɛ rʲ i j ɪ
<|ukr|>міжвоєнний	m i ʒ ʋ ɔ j ɛ n ɪ i
<|ukr|>зекономити	z ɪ k ɔ n ɔ m ɪ t ɪ
<|ukr|>апатичний	ɛ p ɛ t ɪ t͡ʃ n ɪ i
<|ukr|>дислокація	d ɪ s ɫ ɔ k ɑ t͡sʲ i j ɛ
<|ukr|>щонайменше	ʃ t͡ʃ ɔ n ɛ i m ɛ n ʃ ɪ
<|ukr|>куток	k u t ɔ k
<|ukr|>несподіваний	n ɪ s p ɔ dʲ i ʋ ɛ n ɪ i
<|ukr|>матеріальний	m ɛ t ɪ rʲ i ɑ lʲ n ɪ i
<|ukr|>хворіти	x ʋ ɔ rʲ i t ɪ
<|ukr|>кошуля	k ɔ ʃ u lʲ ɛ
<|ukr|>продавати	p r ɔ d ɛ ʋ ɑ t ɪ
<|ukr|>петиція	p ɪ t ɪ t͡sʲ i j ɛ
<|ukr|>абластика	ɛ b ɫ ɑ s t ɪ k ɛ
<|ukr|>авіаучилище	ɛ ʋ i ɛ u t͡ʃ ɪ ɫ ɪ ʃ t͡ʃ ɪ
<|ukr|>довг	d ɔ u ɦ
<|ukr|>обмеження	ɔ b m ɛ ʒ ɪ nʲ ɛ
<|ukr|>жолудь	ʒ ɔ ɫ u dʲ
<|ukr|>плювати	p lʲ u ʋ ɑ t ɪ
<|ukr|>салон	s ɛ ɫ ɔ n
<|ukr|>розуміння	r ɔ z u m i nʲ ɛ
<|ukr|>світанок	sʲ ʋ i t ɑ n ɔ k
<|ukr|>неформальний	n ɪ f ɔ r m ɑ lʲ n ɪ i
<|ukr|>продавщиця	p r ɔ d ɛ u ʃ t͡ʃ ɪ t͡sʲ ɛ
<|ukr|>трок	t r ɔ k
<|ukr|>декларацію	d ɪ k ɫ ɛ r ɑ t͡sʲ i j u
<|ukr|>лихоманка	ɫ ɪ x ɔ m ɑ n k ɛ
<|ukr|>матрьошка	m ɛ tʲ rʲ ɔ ʃ k ɛ
<|ukr|>дитсадок	d ɪ t͡s ɛ d ɔ k
<|ukr|>симпатичний	s ɪ m p ɛ t ɪ t͡ʃ n ɪ i
<|ukr|>повідомлення	p ɔ ʋ i d ɔ m ɫ ɪ nʲ ɛ
<|ukr|>довгий	d ɔ u ɦ ɪ i
<|ukr|>репродуктивний	r ɪ p r ɔ d u k t ɪ u n ɪ i
<|ukr|>погрожувати	p ɔ ɦ r ɔ ʒ u ʋ ɛ t ɪ
<|ukr|>батальйон	b ɛ t ɛ lʲ j ɔ n
<|ukr|>травень	t r ɑ ʋ ɪ nʲ
<|ukr|>напружити	n ɛ p r u ʒ ɪ t ɪ
<|ukr|>третій	t r ɛ tʲ i i
<|ukr|>стрічки	s tʲ rʲ i t͡ʃ k ɪ
<|ukr|>працівниками	p r ɛ t͡sʲ i u n ɪ k ɑ m ɪ
<|ukr|>розмова	r ɔ z m ɔ ʋ ɛ
<|ukr|>офіра	ɔ f i r ɛ
<|ukr|>литва	ɫ ɪ t ʋ ɑ
<|ukr|>начиння	n ɛ t͡ʃ ɪ nʲ ɛ
<|ukr|>слух	s ɫ u x
<|ukr|>південь	p i u d ɪ nʲ
<|ukr|>абразія	ɛ b r ɑ zʲ i j ɛ
<|ukr|>цвях	t͡sʲ ʋ ɑ x
<|ukr|>реконструкція	r ɪ k ɔ n s t r u k t͡sʲ i j ɛ
<|ukr|>хороший	x ɔ r ɔ ʃ ɪ i
<|ukr|>зовнішній	z ɔ u nʲ i ʃ nʲ i i
<|ukr|>установа	u s t ɛ n ɔ ʋ ɛ
<|ukr|>присвійний	p r ɪ sʲ ʋ i i n ɪ i
<|ukr|>власті	ʋ ɫ ɑ sʲ tʲ i
<|ukr|>законослухняний	z ɛ k ɔ n ɔ s ɫ u x nʲ ɑ n ɪ i
<|ukr|>пришвидшити	p r ɪ ʃ ʋ ɪ d͡ʒ ʃ ɪ t ɪ
<|ukr|>слівця	sʲ lʲ i u t͡sʲ ɛ
<|ukr|>житній	ʒ ɪ tʲ nʲ i i
<|ukr|>оточувати	ɔ t ɔ t͡ʃ u ʋ ɛ t ɪ
<|ukr|>здатен	z d ɑ t ɪ n
<|ukr|>негативно	n ɪ ɦ ɛ t ɪ u n ɔ
<|ukr|>інфікування	i nʲ f i k u ʋ ɑ nʲ ɛ
<|ukr|>теорію	t ɪ ɔ rʲ i j u
<|ukr|>еротика	ɪ r ɔ t ɪ k ɛ
<|ukr|>федерації	f ɪ d ɪ r ɑ t͡sʲ i j i
<|ukr|>проблема	p r ɔ b ɫ ɛ m ɛ
<|ukr|>брехню	b r ɪ x nʲ u
<|ukr|>психіка	p s ɪ x i k ɛ
<|ukr|>білок	b i ɫ ɔ k
<|ukr|>лист	ɫ ɪ s t
<|ukr|>австралопітек	ɛ u s t r ɛ ɫ ɔ p i t ɛ k
<|ukr|>кайман	k ɛ i m ɑ n
<|ukr|>ніготь	nʲ i ɦ ɔ tʲ
<|ukr|>марія	m ɛ rʲ i j ɛ
<|ukr|>звикнути	z ʋ ɪ k n u t ɪ
<|ukr|>бонусами	b ɔ n u s ɛ m ɪ
<|ukr|>конкурс	k ɔ n k u r s
<|ukr|>птиця	p t ɪ t͡sʲ ɛ
<|ukr|>кота	k ɔ t ɑ
<|ukr|>могутній	m ɔ ɦ u tʲ nʲ i i
<|ukr|>дитсадки	d ɪ t͡s ɛ d k ɪ
<|ukr|>авіамаяк	ɛ ʋ i ɛ m ɛ j ɑ k
<|ukr|>новини	n ɔ ʋ ɪ n ɪ
<|ukr|>безпритульний	b ɪ z p r ɪ t u lʲ n ɪ i
<|ukr|>скандинавія	s k ɛ n d ɪ n ɑ ʋ i j ɛ
<|ukr|>кишенею	k ɪ ʃ ɛ n ɪ j u
<|ukr|>жона	ʒ ɔ n ɑ
<|ukr|>працівницям	p r ɛ t͡sʲ i u n ɪ t͡sʲ ɛ m
<|ukr|>індустріалізувати	i n d u s tʲ rʲ i ɛ lʲ i z u ʋ ɑ t ɪ
<|ukr|>цією	t͡sʲ i j ɛ j u
<|ukr|>катастрофи	k ɛ t ɛ s t r ɔ f ɪ
<|ukr|>в'язниця	ʋ j ɛ z n ɪ t͡sʲ ɛ
<|ukr|>козирок	k ɔ z ɪ r ɔ k
<|ukr|>дорогий	d ɔ r ɔ ɦ ɪ i
<|ukr|>потилице	p ɔ t ɪ ɫ ɪ t͡s ɪ
<|ukr|>грязь	ɦ rʲ ɑ zʲ
<|ukr|>бацяр	b ɑ t͡sʲ ɛ r
<|ukr|>абрикос	ɛ b r ɪ k ɔ s
<|ukr|>заєць	z ɑ j ɪ t͡sʲ
<|ukr|>школа	ʃ k ɔ ɫ ɛ
<|ukr|>курити	k u r ɪ t ɪ
<|ukr|>імпортувати	i m p ɔ r t u ʋ ɑ t ɪ
<|ukr|>тисячоліттями	t ɪ sʲ ɛ t͡ʃ ɔ lʲ i tʲ ɛ m ɪ
<|ukr|>фіскальний	f i s k ɑ lʲ n ɪ i
<|ukr|>абсанс	ɛ b s ɑ n s
<|ukr|>автобусик	ɛ u t ɔ b u s ɪ k
<|ukr|>утомлений	u t ɔ m ɫ ɪ n ɪ i
<|ukr|>ізраїльтянка	i z r ɛ j i lʲ tʲ ɑ n k ɛ
<|ukr|>повернути	p ɔ ʋ ɪ r n u t ɪ
<|ukr|>позичати	p ɔ z ɪ t͡ʃ ɑ t ɪ
<|ukr|>район	r ɛ j ɔ n
<|ukr|>більшати	b i lʲ ʃ ɛ t ɪ
<|ukr|>заїр	z ɛ j i r
<|ukr|>масштаб	m ɛ ʃ t ɑ b
<|ukr|>золото	z ɔ ɫ ɔ t ɔ
<|ukr|>феями	f ɛ j ɛ m ɪ
<|ukr|>снідати	sʲ nʲ i d ɛ t ɪ
<|ukr|>втручання	ʋ t r u t͡ʃ ɑ nʲ ɛ
<|ukr|>бюрократка	b u r ɔ k r ɑ t k ɛ
<|ukr|>трансформаціям	t r ɛ n s f ɔ r m ɑ t͡sʲ i j ɛ m
<|ukr|>білоруський	b i ɫ ɔ r u sʲ k ɪ i
<|ukr|>невидимий	n ɪ ʋ ɪ d ɪ m ɪ i
<|ukr|>смак	s m ɑ k
<|ukr|>наприкінці	n ɛ p r ɪ k i nʲ t͡sʲ i
<|ukr|>автобіограф	ɛ u t ɔ b i ɔ ɦ r ɛ f
<|ukr|>небога	n ɪ b ɔ ɦ ɛ
<|ukr|>заохотити	z ɛ ɔ x ɔ t ɪ t ɪ
<|ukr|>конфета	k ɔ n f ɛ t ɛ
<|ukr|>логістичний	ɫ ɔ ɦ i s t ɪ t͡ʃ n ɪ i
<|ukr|>вирішення	ʋ ɪ rʲ i ʃ ɪ nʲ ɛ
<|ukr|>театр	t ɪ ɑ t r
<|ukr|>кубічний	k u b i t͡ʃ n ɪ i
<|ukr|>додатках	d ɔ d ɑ t k ɛ x
<|ukr|>америка	ɛ m ɛ r ɪ k ɛ
<|ukr|>ними	n ɪ m ɪ
<|ukr|>виконання	ʋ ɪ k ɔ n ɑ nʲ ɛ
<|ukr|>абстракція	ɛ b s t r ɑ k t͡sʲ i j ɛ
<|ukr|>чотирикутний	t͡ʃ ɔ t ɪ r ɪ k u t n ɪ i
<|ukr|>п'ятдесят	p j ɛ d d ɪ sʲ ɑ t
<|ukr|>гуманістичний	ɦ u m ɛ nʲ i s t ɪ t͡ʃ n ɪ i
<|ukr|>батьківщина	b ɛ tʲ k i u ʃ t͡ʃ ɪ n ɛ
<|ukr|>пропорціях	p r ɔ p ɔ r t͡sʲ i j ɛ x
<|ukr|>повечеряти	p ɔ ʋ ɪ t͡ʃ ɛ rʲ ɛ t ɪ
<|ukr|>невідворотний	n ɪ ʋ i d ʋ ɔ r ɔ t n ɪ i
<|ukr|>інна	i n ɛ
<|ukr|>система	s ɪ s t ɛ m ɛ
<|ukr|>геометричний	ɦ ɪ ɔ m ɪ t r ɪ t͡ʃ n ɪ i
<|ukr|>забагти	z ɛ b ɑ ɦ t ɪ
<|ukr|>гомосексуалізм	ɦ ɔ m ɔ s ɪ k s u ɛ lʲ i z m
<|ukr|>троє	t r ɔ j ɪ
<|ukr|>вмерти	ʋ m ɛ r t ɪ
<|ukr|>альбатрос	ɛ lʲ b ɛ t r ɔ s
<|ukr|>ратифікація	r ɛ t ɪ f i k ɑ t͡sʲ i j ɛ
<|ukr|>тож	t ɔ ʒ
<|ukr|>співпереживання	sʲ p i u p ɪ r ɪ ʒ ɪ ʋ ɑ nʲ ɛ
<|ukr|>діагностика	dʲ i ɛ ɦ n ɔ s t ɪ k ɛ
<|ukr|>відвернути	ʋ i d ʋ ɪ r n u t ɪ
<|ukr|>кубинець	k u b ɪ n ɪ t͡sʲ
<|ukr|>вимкнути	ʋ ɪ m k n u t ɪ
<|ukr|>своєрідний	s ʋ ɔ j ɪ rʲ i d n ɪ i
<|ukr|>пропорціям	p r ɔ p ɔ r t͡sʲ i j ɛ m
<|ukr|>янтар	j ɛ n t ɑ r
<|ukr|>станіслав	s t ɛ nʲ i s ɫ ɑ u
<|ukr|>меланія	m ɪ ɫ ɑ nʲ i j ɛ
<|ukr|>багато	b ɛ ɦ ɑ t ɔ
<|ukr|>цитрина	t͡s ɪ t r ɪ n ɛ
<|ukr|>розпізнавання	r ɔ zʲ p i z n ɛ ʋ ɑ nʲ ɛ
<|ukr|>свекруха	s ʋ ɪ k r u x ɛ
<|ukr|>тисячоліттях	t ɪ sʲ ɛ t͡ʃ ɔ lʲ i tʲ ɛ x
<|ukr|>батько	b ɑ tʲ k ɔ
<|ukr|>неправді	n ɪ p r ɑ u dʲ i
<|ukr|>діаграма	dʲ i ɛ ɦ r ɑ m ɛ
<|ukr|>дзеркало	d͡z ɛ r k ɛ ɫ ɔ
<|ukr|>мур	m u r
<|ukr|>молодий	m ɔ ɫ ɔ d ɪ i
<|ukr|>візуальний	ʋ i z u ɑ lʲ n ɪ i
<|ukr|>зоопарк	z ɔ ɔ p ɑ r k
<|ukr|>авіапарк	ɛ ʋ i ɛ p ɑ r k
<|ukr|>плюш	p lʲ u ʃ
<|ukr|>п'ятниця	p j ɑ t n ɪ t͡sʲ ɛ
<|ukr|>письменний	p ɪ sʲ m ɛ n ɪ i
<|ukr|>українських	u k r ɛ j i nʲ sʲ k ɪ x
<|ukr|>хліб	x lʲ i b
<|ukr|>залежний	z ɛ ɫ ɛ ʒ n ɪ i
<|ukr|>мовознавство	m ɔ ʋ ɔ z n ɑ u s t ʋ ɔ
<|ukr|>участь	u t͡ʃ ɛ sʲ tʲ
<|ukr|>сауна	s ɑ u n ɛ
<|ukr|>місяць	m i sʲ ɛ t͡sʲ
<|ukr|>фольклор	f ɔ lʲ k ɫ ɔ r
<|ukr|>успішний	u sʲ p i ʃ n ɪ i
<|ukr|>засмутити	z ɛ s m u t ɪ t ɪ
<|ukr|>тацею	t ɑ t͡s ɪ j u
<|ukr|>критерієм	k r ɪ t ɛ rʲ i j ɪ m
<|ukr|>авіавиставка	ɛ ʋ i ɛ ʋ ɪ s t ɛ u k ɛ
<|ukr|>підкреслювати	p i d k r ɛ sʲ lʲ u ʋ ɛ t ɪ
<|ukr|>тільки	tʲ i lʲ k ɪ
<|ukr|>возити	ʋ ɔ z ɪ t ɪ
<|ukr|>зменшень	z m ɛ n ʃ ɪ nʲ
<|ukr|>тріска	tʲ rʲ i s k ɛ
<|ukr|>рішити	rʲ i ʃ ɪ t ɪ
<|ukr|>інтуїтивно	i n t u j i t ɪ u n ɔ
<|ukr|>хлопчик	x ɫ ɔ p t͡ʃ ɪ k
<|ukr|>коліно	k ɔ lʲ i n ɔ
<|ukr|>жорстокий	ʒ ɔ r s t ɔ k ɪ i
<|ukr|>амфібія	ɛ m f i b i j ɛ
<|ukr|>транзит	t r ɛ n z ɪ t
<|ukr|>виявитися	ʋ ɪ j ɛ ʋ ɪ t ɪ sʲ ɛ
<|ukr|>спростити	s p r ɔ s t ɪ t ɪ
<|ukr|>криголам	k r ɪ ɦ ɔ ɫ ɑ m
<|ukr|>мокнути	m ɔ k n u t ɪ
<|ukr|>ростити	r ɔ s t ɪ t ɪ
<|ukr|>зрости	z r ɔ s t ɪ
<|ukr|>куди	k u d ɪ
<|ukr|>відродження	ʋ i d r ɔ d͡ʒ ɪ nʲ ɛ
<|ukr|>посталий	p ɔ s t ɑ ɫ ɪ i
<|ukr|>його	j ɔ ɦ ɔ
<|ukr|>кривавий	k r ɪ ʋ ɑ ʋ ɪ i
<|ukr|>нескладовий	n ɪ s k ɫ ɛ d ɔ ʋ ɪ i
<|ukr|>автодидакт	ɛ u t ɔ d ɪ d ɑ k t
<|ukr|>їжакевич	j i ʒ ɛ k ɛ ʋ ɪ t͡ʃ
<|ukr|>мем	m ɛ m
<|bul|>холандски	x o ɫ a n t s kʲ i
<|bul|>браташ	b r ɐ t a ʃ
<|bul|>овластителен	o v ɫ ɐ s t i t ɛ lʲ ɛ n
<|bul|>саламандър	s ɐ ɫ ɐ m a n d ɐ r
<|bul|>легла	lʲ ɛ ɡ ɫ a
<|bul|>лакът	ɫ a k ɐ t
<|bul|>липа	lʲ i p a
<|bul|>съзра	s ɐ z r ɤ
<|bul|>състояние	s ɐ s t o j a n i ɛ
<|bul|>викам	v i k ɐ m
<|bul|>хидроелектричен	xʲ i d r o ɛ lʲ ɛ k t r i t͡ʃ ɛ n
<|bul|>диона	d i ɔ n ɐ
<|bul|>събудя	s ɐ b u dʲ ɐ
<|bul|>хомосексуалистка	x ɔ m o s ɛ k s u ɐ lʲ i s k ɐ
<|bul|>морелетник	m o r ɛ lʲ ɛ t n i k
<|bul|>панпсихизъм	p ɐ n p s i xʲ i z ɐ m
<|bul|>абанос	ɐ b ɐ n ɔ s
<|bul|>кои	k o i
<|bul|>улица	u lʲ i t͡s ɐ
<|bul|>вашта	v a ʃ t ɐ
<|bul|>туркменистан	t u r k m ɛ n i s t a n
<|bul|>къжлица	k ɐ ʒ lʲ i t͡s ɐ
<|bul|>бида	b i d ɐ
<|bul|>материя	m ɐ t ɛ r i j ɐ
<|bul|>узаконяваха	u z ɐ k o nʲ a v ɐ x ɐ
<|bul|>зрян	z rʲ a n
<|bul|>лавка	ɫ a f k ɐ
<|bul|>андора	ɐ n d ɔ r ɐ
<|bul|>стръмнина	s t r ɐ m n i n a
<|bul|>работилница	r ɐ b o t i ɫ n i t͡s ɐ
<|bul|>съобщавам	s ɐ o p ʃ t a v ɐ m
<|bul|>върху	v ɐ r x u
<|bul|>съветвам	s ɐ v ɛ t v ɐ m
<|bul|>драка	d r a k ɐ
<|bul|>цезий	t͡s ɛ z i
<|bul|>начало	n ɐ t͡ʃ a ɫ o
<|bul|>протека	p r o t ɛ k ɤ
<|bul|>париж	p ɐ r i ʃ
<|bul|>примирам	p r i m i r ɐ m
<|bul|>галба	ɡ ɐ ɫ b a
<|bul|>щирица	ʃ t i r i t͡s ɐ
<|bul|>въстание	v ɐ s t a n i ɛ
<|bul|>художник	x u d ɔ ʒ n i k
<|bul|>доверчив	d o v ɛ r t͡ʃ i f
<|bul|>чешма	t͡ʃ ɛ ʃ m a
<|bul|>успех	u s p ɛ x
<|bul|>катерица	k a t ɛ r i t͡s ɐ
<|bul|>трепетлика	t r ɛ p ɛ t lʲ i k ɐ
<|bul|>видра	v i d r ɐ
<|bul|>врабче	v r ɐ p t͡ʃ ɛ
<|bul|>светлосянка	s v ɛ t ɫ o sʲ a n k ɐ
<|bul|>щастие	ʃ t a s t i ɛ
<|bul|>живот	ʒ i v ɔ t
<|bul|>проститутка	p r o s t i t u t k ɐ
<|bul|>крехък	k r ɛ x ɐ k
<|bul|>сивкав	s i f k ɐ f
<|bul|>модел	m o d ɛ ɫ
<|bul|>липък	lʲ i p ɐ k
<|bul|>случаен	s ɫ u t͡ʃ ɐ ɛ n
<|bul|>ароматен	ɐ r o m a t ɛ n
<|bul|>мързел	m ɤ r z ɛ ɫ
<|bul|>кое	k o ɛ
<|bul|>платя	p ɫ ɐ tʲ ɤ
<|bul|>цербер	t͡s ɛ r b ɛ r
<|bul|>печален	p ɛ t͡ʃ a lʲ ɛ n
<|bul|>брания	b r a n i j ɐ
<|bul|>първи	p ɤ r v i
<|bul|>зарист	z ɐ r i s t
<|bul|>албания	ɐ ɫ b a n i j ɐ
<|bul|>върша	v ɐ r ʃ a
<|bul|>занимая	z ɐ n i m a j ɐ
<|bul|>абдикиралия	ɐ b d i kʲ i r ɐ lʲ i j ɐ
<|bul|>ама	a m ɐ
<|bul|>как	k a k
<|bul|>декември	d ɛ kʲ ɛ m v r i
<|bul|>забождам	z ɐ b ɔ ʒ d ɐ m
<|bul|>минск	m i n s k
<|bul|>изпея	i s p ɛ j ɐ
<|bul|>стреме	s t r ɛ m ɛ
<|bul|>абсолютен	ɐ p s o lʲ u t ɛ n
<|bul|>селекционен	s ɛ lʲ ɛ k t͡s i ɔ n ɛ n
<|bul|>чуващ	t͡ʃ u v ɐ ʃ t
<|bul|>слава	s ɫ a v ɐ
<|bul|>смрад	s m r a t
<|bul|>хамбургер	x a m b u r ɡʲ ɛ r
<|bul|>крава	k r a v ɐ
<|bul|>ему	ɛ m u
<|bul|>мускулен	m u s k u lʲ ɛ n
<|bul|>ловец	ɫ o v ɛ t͡s
<|bul|>мръсен	m r ɤ s ɛ n
<|bul|>гангстер	ɡ a n k s t ɛ r
<|bul|>кур	k u r
<|bul|>мойто	m ɔ j t o
<|bul|>явен	j a v ɛ n
<|bul|>немкиня	n ɛ m kʲ i nʲ ɐ
<|bul|>светлана	s v ɛ t ɫ a n ɐ
<|bul|>опера	ɔ p ɛ r ɐ
<|bul|>черква	t͡ʃ ɛ r k v ɐ
<|bul|>околен	o k ɔ lʲ ɛ n
<|bul|>паткан	p ɐ t k a n
<|bul|>представям	p r ɛ t s t a vʲ ɐ m
<|bul|>холмий	x ɔ ɫ m i
<|bul|>какъвто	k ɐ k ɤ f t o
<|bul|>алка	a ɫ k ɐ
<|bul|>бижу	b i ʒ u
<|bul|>узаконили	u z ɐ k o n i lʲ i
<|bul|>социален	s o t͡s i a lʲ ɛ n
<|bul|>дъх	d ɤ x
<|bul|>гуждам	ɡ u ʒ d ɐ m
<|bul|>изслушам	i s ɫ u ʃ ɐ m
<|bul|>езичен	ɛ z i t͡ʃ ɛ n
<|bul|>вървите	v ɐ r v i t ɛ
<|bul|>склонен	s k ɫ ɔ n ɛ n
<|bul|>върволяк	v ɐ r v o lʲ a k
<|bul|>тъкан	t ɐ k a n
<|bul|>рай	r a j
<|bul|>панкреатит	p ɐ n k r ɛ ɐ t i t
<|bul|>хладък	x ɫ a d ɐ k
<|bul|>добре	d o b r ɛ
<|bul|>легален	lʲ ɛ ɡ a lʲ ɛ n
<|bul|>алармен	ɐ ɫ a r m ɛ n
<|bul|>възголям	v ɐ z ɡ o lʲ a m
<|bul|>кюлоти	kʲ u ɫ ɔ t i
<|bul|>хамбар	x ɐ m b a r
<|bul|>зърнест	z ɤ r n ɛ s t
<|bul|>нос	n ɔ s
<|bul|>възсин	v ɐ s s i n
<|bul|>побеждавам	p o b ɛ ʒ d a v ɐ m
<|bul|>прага	p r a ɡ ɐ
<|bul|>едноличен	ɛ d n o lʲ i t͡ʃ ɛ n
<|bul|>подпиша	p o t p i ʃ ɐ
<|bul|>височина	v i s o t͡ʃ i n a
<|bul|>наредба	n ɐ r ɛ d b ɐ
<|bul|>прахоляк	p r ɐ x o lʲ a k
<|bul|>зло	z ɫ ɔ
<|bul|>кожа	k ɔ ʒ ɐ
<|bul|>бахър	b a x ɐ r
<|bul|>яд	j a t
<|bul|>кълва	k ɐ ɫ v a
<|bul|>издател	i z d a t ɛ ɫ
<|bul|>напластяване	n ɐ p ɫ ɐ s tʲ a v ɐ n ɛ
<|bul|>продам	p r o d a m
<|bul|>членувана	t͡ʃ lʲ ɛ n u v ɐ n ɐ
<|bul|>изгреба	i z ɡ r ɛ b ɐ
<|bul|>държава	d ɐ r ʒ a v ɐ
<|bul|>изучаем	i z u t͡ʃ a ɛ m
<|bul|>кошара	k o ʃ a r ɐ
<|bul|>пеганка	p ɛ ɡ a n k ɐ
<|bul|>кожарница	k o ʒ a r n i t͡s ɐ
<|bul|>икона	i k ɔ n ɐ
<|bul|>ядяхте	j a dʲ a x t ɛ
<|bul|>затворен	z ɐ t v ɔ r ɛ n
<|bul|>свойство	s v ɔ j s t v o
<|bul|>абдоминалния	ɐ b d o m i n a ɫ n i j ɐ
<|bul|>гледам	ɡ lʲ ɛ d ɐ m
<|bul|>поп	p ɔ p
<|bul|>история	i s t ɔ r i j ɐ
<|bul|>повтор	p o f t ɔ r
<|bul|>данък	d a n ɐ k
<|bul|>граната	ɡ r ɐ n a t ɐ
<|bul|>предприемач	p r ɛ t p r i ɛ m a t͡ʃ
<|bul|>каца	k a t͡s ɐ
<|bul|>абонаментен	ɐ b o n ɐ m ɛ n t ɛ n
<|bul|>бекон	b ɛ k ɔ n
<|bul|>технеций	t ɛ x n ɛ t͡s i
<|bul|>кокоши	k o k ɔ ʃ i
<|bul|>пропаст	p r ɔ p ɐ s t
<|bul|>авиобомба	a v i o b ɔ m b ɐ
<|bul|>прекален	p r ɛ k ɐ lʲ ɛ n
<|bul|>кофа	k ɔ f ɐ
<|bul|>чия	t͡ʃ i j a
<|bul|>вашия	v a ʃ i j ɐ
<|bul|>забележа	z ɐ b ɛ lʲ ɛ ʒ ɐ
<|bul|>щъркел	ʃ t ɤ r kʲ ɛ ɫ
<|bul|>резултат	r ɛ z u ɫ t a t
<|bul|>неразбория	n ɛ r ɐ z b o r i j ɐ
<|bul|>ноември	n o ɛ m v r i
<|bul|>пафкам	p a f k ɐ m
<|bul|>миг	m i k
<|bul|>сияехте	s i j a ɛ x t ɛ
<|bul|>патица	p a t i t͡s ɐ
<|bul|>преда	p r ɛ d ɤ
<|bul|>длан	d ɫ a n
<|bul|>готов	ɡ ɔ t o f
<|bul|>блед	b lʲ ɛ t
<|bul|>век	v ɛ k
<|bul|>поилка	p o i ɫ k ɐ
<|bul|>досега	d o s ɛ ɡ a
<|bul|>ядящото	j a dʲ a ʃ t o t o
<|bul|>извадя	i z v a dʲ ɐ
<|bul|>повторим	p o f t o r i m
<|bul|>глупост	ɡ ɫ u p o s t
<|bul|>завинаги	z ɐ v i n ɐ ɡʲ i
<|bul|>бърне	b ɐ r n ɛ
<|bul|>сврачи	s v r a t͡ʃ i
<|bul|>хидра	xʲ i d r ɐ
<|bul|>завивка	z ɐ v i f k ɐ
<|bul|>читателка	t͡ʃ i t a t ɛ ɫ k ɐ
<|bul|>плен	p lʲ ɛ n
<|bul|>цупя	t͡s u pʲ ɐ
<|bul|>швейцарски	ʃ v ɛ j t͡s a r s kʲ i
<|bul|>гадина	ɡ ɐ d i n ɐ
<|bul|>девойка	d ɛ v ɔ j k ɐ
<|bul|>ерида	ɛ r i d ɐ
<|bul|>зрящ	z rʲ a ʃ t
<|bul|>инакво	i n a k v o
<|bul|>деймос	d ɛ j m o s
<|bul|>служа	s ɫ u ʒ ɐ
<|bul|>надолу	n ɐ d ɔ ɫ u
<|bul|>шифър	ʃ i f ɐ r
<|bul|>предупредя	p r ɛ d u p r ɛ dʲ ɤ
<|bul|>карти	k a r t i
<|bul|>ищай	i ʃ t a j
<|bul|>среда	s r ɛ d a
<|bul|>буляк	b u lʲ ɐ k
<|bul|>стоя	s t o j ɤ
<|bul|>възхищение	v ɐ s xʲ i ʃ t ɛ n i ɛ
<|bul|>яла	j a ɫ ɐ
<|bul|>пруст	p r u s t
<|bul|>волфрам	v ɔ ɫ f r ɐ m
<|bul|>премяна	p r ɛ mʲ a n ɐ
<|bul|>кавал	k ɐ v a ɫ
<|bul|>юрод	j u r o t
<|bul|>блия	b lʲ i j ɐ
<|bul|>рог	r ɔ k
<|bul|>тухла	t u x ɫ ɐ
<|bul|>мечок	m ɛ t͡ʃ ɔ k
<|bul|>нека	n ɛ k ɐ
<|bul|>зрител	z r i t ɛ ɫ
<|bul|>апологет	ɐ p o ɫ o ɡʲ ɛ t
<|bul|>почти	p o t͡ʃ t i
<|bul|>техничен	t ɛ x n i t͡ʃ ɛ n
<|bul|>анархия	ɐ n a r xʲ i j ɐ
<|bul|>свра	s v r ɤ
<|bul|>индий	i n d i
<|bul|>супермаркет	s u p ɛ r m a r kʲ ɛ t
<|bul|>меч	m ɛ t͡ʃ
<|bul|>парещ	p a r ɛ ʃ t
<|bul|>русалия	r u s a lʲ i j ɐ
<|bul|>щене	ʃ t ɛ n ɛ
<|bul|>зареждам	z ɐ r ɛ ʒ d ɐ m
<|bul|>дрозен	d r ɔ z ɛ n
<|bul|>тъпочовка	t ɐ p o t͡ʃ ɔ f k ɐ
<|bul|>отнеса	o t n ɛ s ɤ
<|bul|>говно	ɡ o v n ɔ
<|bul|>харамия	x ɐ r ɐ m i j ɐ
<|bul|>ваше	v a ʃ ɛ
<|bul|>абстрактен	ɐ p s t r a k t ɛ n
<|bul|>зреше	z r ɛ ʃ ɛ
<|bul|>творя	t v o rʲ a
<|bul|>спомня	s p ɔ m nʲ ɐ
<|bul|>панкреас	p a n k r ɛ ɐ s
<|bul|>дърволазка	d ɐ r v o ɫ a s k ɐ
<|bul|>пек	p ɛ k
<|bul|>чутура	t͡ʃ u t u r ɐ
<|bul|>дъхна	d ɤ x n ɐ
<|bul|>население	n ɐ s ɛ lʲ ɛ n i ɛ
<|bul|>сък	s ɤ k
<|bul|>апология	ɐ p o ɫ ɔ ɡʲ i j ɐ
<|bul|>тон	t ɔ n
<|bul|>керамика	kʲ ɛ r a m i k ɐ
<|bul|>билото	b i ɫ o t o
<|bul|>трева	t r ɛ v a
<|bul|>доказателство	d o k ɐ z a t ɛ ɫ s t v o
<|bul|>абсорбирания	ɐ p s o r b i r ɐ n i j ɐ
<|bul|>сладко	s ɫ a t k o
<|bul|>отделен	o d d ɛ lʲ ɛ n
<|bul|>стихия	s t i xʲ i j ɐ
<|bul|>чиито	t͡ʃ i i t o
<|bul|>пролом	p r o ɫ ɔ m
<|bul|>лидер	lʲ i d ɛ r
<|bul|>дотичам	d o t i t͡ʃ ɐ m
<|bul|>дигна	d i ɡ n ɐ
<|bul|>нет	n ɛ t
<|bul|>какаду	k ɐ k ɐ d u
<|bul|>текстилен	t ɛ k s t i lʲ ɛ n
<|bul|>обсъждам	o p s ɤ ʒ d ɐ m
<|bul|>корморан	k o r m o r a n
<|bul|>местност	m ɛ s n o s t
<|bul|>членувам	t͡ʃ lʲ ɛ n u v ɐ m
<|bul|>тарос	t a r o s
<|bul|>небеса	n ɛ b ɛ s a
<|bul|>анкетен	ɐ n kʲ ɛ t ɛ n
<|bul|>имала	i m a ɫ ɐ
<|bul|>внезапен	v n ɛ z a p ɛ n
<|bul|>конгрес	k o n ɡ r ɛ s
<|bul|>пепеляв	p ɛ p ɛ lʲ a f
<|bul|>август	a v ɡ u s t
<|bul|>гяур	ɡʲ ɐ u r
<|bul|>стърга	s t ɤ r ɡ ɐ
<|bul|>софийски	s o f i s kʲ i
<|bul|>неопределен	n ɛ o p r ɛ d ɛ lʲ ɛ n
<|bul|>кайгана	k ɐ j ɡ ɐ n a
<|bul|>швейцарка	ʃ v ɛ j t͡s a r k ɐ
<|bul|>заплитам	z ɐ p lʲ i t ɐ m
<|bul|>летя	lʲ ɛ tʲ a
<|bul|>зърнен	z ɤ r n ɛ n
<|bul|>мартеница	m a r t ɛ n i t͡s ɐ
<|bul|>средновековие	s r ɛ d n o v ɛ k ɔ v i ɛ
<|bul|>градус	ɡ r a d u s
<|bul|>отвор	o t v ɔ r
<|bul|>проклитичен	p r o k lʲ i t i t͡ʃ ɛ n
<|bul|>чуя	t͡ʃ u j ɐ
<|bul|>зрак	z r a k
<|bul|>мирта	m i r t ɐ
<|bul|>март	m a r t
<|bul|>напека	n ɐ p ɛ k ɤ
<|bul|>карам	k a r ɐ m
<|bul|>палав	p a ɫ ɐ f
<|bul|>зашивам	z ɐ ʃ i v ɐ m
<|bul|>шум	ʃ u m
<|bul|>накаже	n ɐ k a ʒ ɛ
<|bul|>управителен	u p r a v i t ɛ lʲ ɛ n
<|bul|>автобиографично	ɐ f t o b i o ɡ r ɐ f i t͡ʃ n o
<|bul|>лъжи	ɫ ɐ ʒ i
<|bul|>показвам	p o k a z v ɐ m
<|bul|>къртица	k ɐ r t i t͡s ɐ
<|bul|>южнячка	j u ʒ nʲ a t͡ʃ k ɐ
<|bul|>обърна	o b ɤ r n ɐ
<|bul|>зор	z ɔ r
<|bul|>град	ɡ r a t
<|bul|>обесвам	o b ɛ s v ɐ m
<|bul|>зярвам	zʲ a r v ɐ m
<|bul|>русе	r u s ɛ
<|bul|>биографичен	b i o ɡ r ɐ f i t͡ʃ ɛ n
<|bul|>чествам	t͡ʃ ɛ s t v ɐ m
<|bul|>връст	v r ɤ s t
<|bul|>сплав	s p ɫ a f
<|bul|>гургулица	ɡ u r ɡ u lʲ i t͡s ɐ
<|bul|>намака	n ɐ m a k ɐ
<|bul|>противоречив	p r o t i v o r ɛ t͡ʃ i f
<|bul|>куфар	k u f ɐ r
<|bul|>парфюм	p ɐ r fʲ u m
<|bul|>ден	d ɛ n
<|bul|>спя	s pʲ ɤ
<|bul|>затека	z ɐ t ɛ k ɤ
<|bul|>корист	k ɔ r i s t
<|bul|>азот	ɐ z ɔ t
<|bul|>театър	t ɛ a t ɐ r
<|bul|>гемия	ɡʲ ɛ m i j ɐ
<|bul|>предполагам	p r ɛ t p o ɫ a ɡ ɐ m
<|bul|>мишца	m i ʃ t͡s ɐ
<|bul|>пека	p ɛ k ɤ
<|bul|>инстинкт	i n s t i n k t
<|bul|>вестник	v ɛ s n i k
<|bul|>абсциса	ɐ p s t͡s i s ɐ
<|bul|>пигментен	p i ɡ m ɛ n t ɛ n
<|bul|>свалям	s v a lʲ ɐ m
<|bul|>ласка	ɫ a s k ɐ
<|bul|>кимна	kʲ i m n ɐ
<|bul|>пасох	p a s o x
<|bul|>дизя	d i zʲ ɐ
<|bul|>роднина	r o d n i n ɐ
<|bul|>пакет	p ɐ kʲ ɛ t
<|bul|>богиня	b o ɡʲ i nʲ ɐ
<|bul|>щяхме	ʃ tʲ a x m ɛ
<|bul|>исландски	i s ɫ a n t s kʲ i
<|bul|>жужел	ʒ u ʒ ɛ ɫ
<|bul|>феникс	f ɛ n i k s
<|bul|>хирургически	xʲ i r u r ɡʲ i t͡ʃ ɛ s kʲ i
<|bul|>имахте	i m a x t ɛ
<|bul|>апс	a p s
<|bul|>мъгла	m ɐ ɡ ɫ a
<|bul|>тъмница	t ɐ m n i t͡s ɐ
<|bul|>авлия	ɐ v lʲ i j ɐ
<|bul|>става	s t a v ɐ
<|bul|>индикативен	i n d i k ɐ t i v ɛ n
<|bul|>взривен	v z r i v ɛ n
<|bul|>лук	ɫ u k
<|bul|>бургас	b u r ɡ a s
<|bul|>нагриза	n ɐ ɡ r i z ɐ
<|bul|>дрехи	d r ɛ xʲ i
<|bul|>токачка	t o k a t͡ʃ k ɐ
<|bul|>моля	m ɔ lʲ ɐ
<|bul|>бълха	b ɐ ɫ x a
<|bul|>основателност	o s n o v a t ɛ ɫ n o s t
<|bul|>защо	z ɐ ʃ t ɔ
<|bul|>брегът	b r ɛ ɡ ɤ t
<|bul|>кубик	k u b i k
<|bul|>строг	s t r ɔ k
<|bul|>черта	t͡ʃ ɛ r t a
<|bul|>котка	k ɔ t k ɐ
<|bul|>узаконях	u z ɐ k o nʲ a x
<|bul|>сой	s ɔ j
<|bul|>юрган	j u r ɡ a n
<|bul|>острие	o s t r i ɛ
<|bul|>мрящото	m rʲ a ʃ t o t o
<|bul|>ледовит	lʲ ɛ d o v i t
<|bul|>конкретен	k o n k r ɛ t ɛ n
<|bul|>огромен	o ɡ r ɔ m ɛ n
<|bul|>махам	m a x ɐ m
<|bul|>разлог	r ɐ z ɫ ɔ k
<|bul|>арка	a r k ɐ
<|bul|>лава	ɫ a v ɐ
<|bul|>мушитрънка	m u ʃ i t r ɤ n k ɐ
<|bul|>дрипав	d r i p ɐ f
<|bul|>изтребя	i s t r ɛ bʲ ɐ
<|bul|>узаконяваше	u z ɐ k o nʲ a v ɐ ʃ ɛ
<|bul|>узаконяват	u z ɐ k o nʲ a v ɐ t
<|bul|>авиационен	a v i ɐ t͡s i ɔ n ɛ n
<|bul|>узаконените	u z ɐ k o n ɛ n i t ɛ
<|bul|>офис	ɔ f i s
<|bul|>прям	p rʲ a m
<|bul|>зависим	z ɐ v i s i m
<|bul|>пуйка	p u j k ɐ
<|bul|>шествие	ʃ ɛ s t v i ɛ
<|bul|>тръгна	t r ɐ ɡ n a
<|bul|>операция	o p ɛ r a t͡s i j ɐ
<|bul|>надонеса	n ɐ d o n ɛ s ɤ
<|bul|>оръдие	o r ɤ d i ɛ
<|bul|>продавам	p r o d a v ɐ m
<|bul|>безсмъртен	b ɛ s s m ɤ r t ɛ n
<|bul|>солен	s o lʲ ɛ n
<|bul|>ухапете	u x a p ɛ t ɛ
<|bul|>арестувахме	a r ɛ s t u v a x m ɛ
<|bul|>спътник	s p ɤ t n i k
<|bul|>долар	d ɔ ɫ ɐ r
<|bul|>жертва	ʒ ɛ r t v ɐ
<|bul|>падина	p ɐ d i n a
<|bul|>забранявам	z ɐ b r ɐ nʲ a v ɐ m
<|bul|>допринасям	d o p r i n a sʲ ɐ m
<|bul|>литий	lʲ i t i
<|bul|>градовете	ɡ r ɐ d o v ɛ t ɛ
<|bul|>трудно	t r u d n o
<|bul|>физичен	f i z i t͡ʃ ɛ n
<|bul|>отпущам	o t p u ʃ t ɐ m
<|bul|>тук	t u k
<|bul|>вашто	v a ʃ t o
<|bul|>освен	o s v ɛ n
<|bul|>боже	b ɔ ʒ ɛ
<|bul|>свитък	s v i t ɐ k
<|bul|>странен	s t r a n ɛ n
<|bul|>сквозе	s k v ɔ z ɛ
<|bul|>основателно	o s n o v a t ɛ ɫ n o
<|bul|>къделя	k ɐ d ɛ lʲ ɐ
<|bul|>река	r ɛ k a
<|bul|>у	u
<|bul|>съединител	s ɐ ɛ d i n i t ɛ ɫ
<|bul|>горест	ɡ ɔ r ɛ s t
<|bul|>отново	o t n ɔ v o
<|bul|>дворец	d v o r ɛ t͡s
<|bul|>чък	t͡ʃ ɤ k
<|bul|>боец	b o ɛ t͡s
<|bul|>дилянка	d i lʲ a n k ɐ
<|bul|>четири	t͡ʃ ɛ t i r i
<|bul|>затресе	z ɐ t r ɛ s ɛ
<|bul|>маниак	m ɐ n i a k
<|bul|>изковавам	i s k o v a v ɐ m
<|bul|>екип	ɛ kʲ i p
<|bul|>адет	ɐ d ɛ t
<|bul|>фабрика	f a b r i k ɐ
<|bul|>законен	z ɐ k ɔ n ɛ n
<|bul|>помолвам	p o m ɔ ɫ v ɐ m
<|bul|>бивам	b i v ɐ m
<|bul|>учителски	u t͡ʃ i t ɛ ɫ s kʲ i
<|bul|>отвес	o t v ɛ s
<|bul|>такава	t ɐ k a v ɐ
<|bul|>прозорче	p r o z ɔ r t͡ʃ ɛ
<|bul|>британия	b r i t a n i j ɐ
<|bul|>костница	k ɔ s n i t͡s ɐ
<|bul|>кожух	k o ʒ u x
<|bul|>аварски	ɐ v a r s kʲ i
<|bul|>бъди	b ɐ d i
<|bul|>пари	p a r i
<|bul|>книжен	k n i ʒ ɛ n
<|bul|>гадолиний	ɡ ɐ d o lʲ i n i
<|bul|>твойто	t v ɔ j t o
<|bul|>заема	z ɐ ɛ m ɐ
<|bul|>глас	ɡ ɫ a s
<|bul|>единица	ɛ d i n i t͡s ɐ
<|bul|>стилистка	s t i lʲ i s k ɐ
<|bul|>пате	p a t ɛ
<|bul|>ирландски	i r ɫ a n t s kʲ i
<|bul|>депонентен	d ɛ p o n ɛ n t ɛ n
<|bul|>тайна	t a j n ɐ
<|bul|>купи	k u p i
<|bul|>вирус	v i r u s
<|bul|>ламаринен	ɫ ɐ m ɐ r i n ɛ n
<|bul|>бележит	b ɛ lʲ ɛ ʒ i t
<|bul|>експедиция	ɛ k s p ɛ d i t͡s i j ɐ
<|bul|>любов	lʲ u b ɔ f
<|bul|>танц	t a n t͡s
<|bul|>граждански	ɡ r a ʒ d ɐ n s kʲ i
<|bul|>енциклопедия	ɛ n t͡s i k ɫ o p ɛ d i j ɐ
<|bul|>антре	ɐ n t r ɛ
<|bul|>шибой	ʃ i b ɔ j
<|bul|>почва	p o t͡ʃ v a
<|bul|>венера	v ɛ n ɛ r ɐ
<|bul|>ален	a lʲ ɛ n
<|bul|>авантюристически	ɐ v ɐ n tʲ u r i s t i t͡ʃ ɛ s kʲ i
<|bul|>свойто	s v ɔ j t o
<|bul|>калай	k ɐ ɫ a j
<|bul|>сатанински	s ɐ t ɐ n i n s kʲ i
<|bul|>елементарен	ɛ lʲ ɛ m ɛ n t a r ɛ n
<|bul|>як	j a k
<|bul|>прочут	p r o t͡ʃ u t
<|bul|>пристоен	p r i s t ɔ ɛ n
<|bul|>писмо	p i s m ɔ
<|bul|>узаконилото	u z ɐ k o n i ɫ o t o
<|bul|>алигатор	ɐ lʲ i ɡ a t o r
<|bul|>въоръжавам	v ɐ o r ɐ ʒ a v ɐ m
<|bul|>полуостров	p o ɫ u ɔ s t r o f
<|bul|>коноп	k o n ɔ p
<|bul|>подчертавам	p o t t͡ʃ ɛ r t a v ɐ m
<|bul|>пречупвам	p r ɛ t͡ʃ u p v ɐ m
<|bul|>лебедица	lʲ ɛ b ɛ d i t͡s ɐ
<|bul|>философия	f i ɫ o s ɔ f i j ɐ
<|bul|>полувреме	p o ɫ u v r ɛ m ɛ
<|bul|>кино	kʲ i n o
<|bul|>регистрационен	r ɛ ɡʲ i s t r ɐ t͡s i ɔ n ɛ n
<|bul|>любопитен	lʲ u b o p i t ɛ n
<|bul|>жаба	ʒ a b ɐ
<|bul|>родителен	r o d i t ɛ lʲ ɛ n
<|bul|>майтнерий	m ɐ j t n ɛ r i
<|bul|>игрив	i ɡ r i f
<|bul|>чужденец	t͡ʃ u ʒ d ɛ n ɛ t͡s
<|bul|>извикам	i z v i k ɐ m
<|bul|>отдел	o d d ɛ ɫ
<|bul|>жълтеникав	ʒ ɐ ɫ t ɛ n i k ɐ f
<|bul|>никта	n i k t ɐ
<|bul|>чушле	t͡ʃ u ʃ lʲ ɛ
<|bul|>ядящо	j a dʲ a ʃ t o
<|bul|>имате	i m ɐ t ɛ
<|bul|>монако	m o n a k o
<|bul|>вид	v i t
<|bul|>фалшив	f ɐ ɫ ʃ i f
<|bul|>водород	v o d o r ɔ t
<|bul|>лимони	lʲ i m ɔ n i
<|bul|>тербий	t ɛ r b i
<|bul|>дойда	d ɔ j d ɐ
<|bul|>разпределение	r ɐ s p r ɛ d ɛ lʲ ɛ n i ɛ
<|bul|>бруя	b r u j ɐ
<|bul|>бъдеш	b ɤ d ɛ ʃ
<|bul|>начален	n ɐ t͡ʃ a lʲ ɛ n
<|bul|>червеношийка	t͡ʃ ɛ r v ɛ n o ʃ i k ɐ
<|bul|>хокам	x ɔ k ɐ m
<|bul|>октомври	o k t ɔ m v r i
<|bul|>тигър	t i ɡ ɐ r
<|bul|>ватикана	v ɐ t i k a n ɐ
<|bul|>магаре	m ɐ ɡ a r ɛ
<|bul|>мир	m i r
<|bul|>смущение	s m u ʃ t ɛ n i ɛ
<|bul|>средище	s r ɛ d i ʃ t ɛ
<|bul|>узаконеният	u z ɐ k o n ɛ n i j ɐ t
<|bul|>оженя	o ʒ ɛ nʲ ɐ
<|bul|>българка	b ɤ ɫ ɡ ɐ r k ɐ
<|bul|>торба	t o r b a
<|bul|>за	z a
<|bul|>акумулатор	ɐ k u m u ɫ a t o r
<|bul|>мразовит	m r ɐ z o v i t
<|bul|>брош	b r ɔ ʃ
<|bul|>звънлив	z v ɐ n lʲ i f
<|bul|>йерарх	j ɛ r a r x
<|bul|>промеждутък	p r o m ɛ ʒ d u t ɐ k
<|bul|>фир	f i r
<|bul|>ладия	ɫ ɐ d i j ɐ
<|bul|>понапека	p o n ɐ p ɛ k ɤ
<|bul|>абисински	ɐ b i s i n s kʲ i
<|bul|>членувано	t͡ʃ lʲ ɛ n u v ɐ n o
<|bul|>чивия	t͡ʃ i v i j ɐ
<|bul|>чук	t͡ʃ u k
<|bul|>кукувица	k u k u v i t͡s ɐ
<|bul|>избия	i z b i j ɐ
<|bul|>мазен	m a z ɛ n
<|bul|>лактационен	ɫ ɐ k t ɐ t͡s i ɔ n ɛ n
<|bul|>мрели	m r ɛ lʲ i
<|bul|>случай	s ɫ u t͡ʃ a j
<|bul|>шоколад	ʃ o k o ɫ a t
<|bul|>узаконявахте	u z ɐ k o nʲ a v ɐ x t ɛ
<|bul|>разлат	r ɐ z ɫ a t
<|bul|>всякаква	f sʲ a k ɐ k v ɐ
<|bul|>мъжкар	m ɐ ʃ k a r
<|bul|>бедя	b ɛ dʲ ɤ
<|bul|>кон	k ɔ n
<|bul|>беларус	b ɛ ɫ ɐ r u s
<|bul|>двойствен	d v ɔ j s t v ɛ n
<|bul|>толкоз	t ɔ ɫ k o s
<|bul|>машина	m ɐ ʃ i n ɐ
<|bul|>дърводелец	d ɐ r v o d ɛ lʲ ɛ t͡s
<|bul|>мощ	m ɔ ʃ t
<|bul|>техни	t ɛ x n i
<|bul|>драгой	d r ɐ ɡ ɔ j
<|bul|>откриваем	o t k r i v a ɛ m
<|bul|>загивам	z ɐ ɡʲ i v ɐ m
<|bul|>съдебен	s ɐ d ɛ b ɛ n
<|bul|>сеизмичен	s ɛ i z m i t͡ʃ ɛ n
<|bul|>дайка	d a j k ɐ
<|bul|>вадя	v a dʲ ɐ
<|bul|>благоевград	b ɫ ɐ ɡ ɔ ɛ v ɡ r ɐ t
<|bul|>лиляк	lʲ i lʲ ɐ k
<|bul|>пирон	p i r ɔ n
<|bul|>швеция	ʃ v ɛ t͡s i j ɐ
<|bul|>ядящата	j a dʲ a ʃ t ɐ t ɐ
<|bul|>право	p r a v o
<|bul|>робия	r o b i j ɐ
<|bul|>странноприемница	s t r ɐ n n o p r i ɛ m n i t͡s ɐ
<|bul|>дръвце	d r ɐ f t͡s ɛ
<|bul|>вина	v i n a
<|bul|>оцветявам	o t͡s v ɛ tʲ a v ɐ m
<|bul|>варшава	v ɐ r ʃ a v ɐ
<|bul|>израстък	i z r a s t ɐ k
<|bul|>електронен	ɛ lʲ ɛ k t r ɔ n ɛ n
<|bul|>съществувам	s ɐ ʃ t ɛ s t v u v ɐ m
<|bul|>мренетата	m r ɛ n ɛ t ɐ t ɐ
<|bul|>подозра	p o d o z r ɤ
<|bul|>говорете	ɡ o v o r ɛ t ɛ
<|bul|>било	b i ɫ o
<|bul|>разум	r a z u m
<|bul|>абдоминален	ɐ b d o m i n a lʲ ɛ n
<|bul|>клоун	k ɫ ɔ u n
<|bul|>вероятно	v ɛ r o j a t n o
<|bul|>кадифе	k ɐ d i f ɛ
<|bul|>едновременен	ɛ d n o v r ɛ m ɛ n ɛ n
<|bul|>дреха	d r ɛ x ɐ
<|bul|>шугав	ʃ u ɡ ɐ f
<|bul|>мастит	m ɐ s t i t
<|bul|>тайван	t ɐ j v a n
<|bul|>матрак	m ɐ t r a k
<|bul|>раждане	r a ʒ d ɐ n ɛ
<|bul|>чедо	t͡ʃ ɛ d o
<|bul|>избоде	i z b o d ɛ
<|bul|>черешарка	t͡ʃ ɛ r ɛ ʃ a r k ɐ
<|bul|>доверие	d o v ɛ r i ɛ
<|bul|>архитектурен	ɐ r xʲ i t ɛ k t u r ɛ n
<|bul|>сияехме	s i j a ɛ x m ɛ
<|bul|>грънчарница	ɡ r ɐ n t͡ʃ a r n i t͡s ɐ
<|bul|>гълъбица	ɡ ɐ ɫ ɐ b i t͡s ɐ
<|bul|>ястребов	j a s t r ɛ b o f
<|bul|>щем	ʃ t ɛ m
<|bul|>напълно	n ɐ p ɤ ɫ n o
<|bul|>неголям	n ɛ ɡ o lʲ ɐ m
<|bul|>зрете	z r ɛ t ɛ
<|bul|>кей	kʲ ɛ j
<|bul|>лейди	lʲ ɛ j d i
<|bul|>трескав	t r ɛ s k ɐ f
<|bul|>иглика	i ɡ lʲ i k ɐ
<|bul|>поличба	p o lʲ i d͡ʒ b ɐ
<|bul|>бъдете	b ɐ d ɛ t ɛ
<|bul|>пошъл	p ɔ ʃ ɐ ɫ
<|bul|>изговори	i z ɡ o v o r i
<|bul|>носия	n o s i j ɐ
<|bul|>боб	b ɔ p
<|bul|>криеница	k r i ɛ n i t͡s ɐ
<|bul|>членестоного	t͡ʃ lʲ ɛ n ɛ s t o n ɔ ɡ o
<|bul|>хлорофил	x ɫ o r o f i ɫ
<|bul|>луча	ɫ u t͡ʃ ɐ
<|bul|>жираф	ʒ i r a f
<|bul|>особняк	o s o b nʲ a k
<|bul|>неговото	n ɛ ɡ o v o t o
<|bul|>единайсет	ɛ d i n a j s ɛ t
<|bul|>нещастие	n ɛ ʃ t a s t i ɛ
<|bul|>снощи	s n ɔ ʃ t i
<|bul|>мряхме	m rʲ a x m ɛ
<|bul|>ясмин	j ɐ s m i n
<|bul|>протоме	p r o t ɔ m ɛ
<|bul|>панаир	p ɐ n ɐ i r
<|bul|>шести	ʃ ɛ s t i
<|bul|>струга	s t r u ɡ ɐ
<|bul|>често	t͡ʃ ɛ s t o
<|bul|>волан	v o ɫ a n
<|bul|>срака	s r a k ɐ
<|bul|>работничка	r ɐ b ɔ t n i t͡ʃ k ɐ
<|bul|>ваште	v a ʃ t ɛ
<|bul|>школа	ʃ k ɔ ɫ ɐ
<|bul|>въвра	v ɐ v r ɤ
<|bul|>бог	b ɔ k
<|bul|>тези	t ɛ z i
<|bul|>къртичи	k ɐ r t i t͡ʃ i
<|bul|>пасохме	p a s o x m ɛ
<|bul|>принц	p r i n t͡s
<|bul|>съчетавам	s ɐ t͡ʃ ɛ t a v ɐ m
<|bul|>равен	r a v ɛ n
<|bul|>нейни	n ɛ j n i
<|bul|>дори	d o r i
<|bul|>прощален	p r o ʃ t a lʲ ɛ n
<|bul|>оцет	o t͡s ɛ t
<|bul|>храм	x r a m
<|bul|>джийн	d ʒ i n
<|bul|>шептя	ʃ ɛ p tʲ ɤ
<|bul|>стилов	s t i ɫ o f
<|bul|>рухо	r u x o
<|bul|>управителка	u p r a v i t ɛ ɫ k ɐ
<|bul|>разшифровам	r ɐ ʃ ʃ i f r ɔ v ɐ m
<|bul|>киноцентър	kʲ i n o t͡s ɛ n t ɐ r
<|bul|>телефон	t ɛ lʲ ɛ f ɔ n
<|bul|>пасящия	p ɐ sʲ a ʃ t i j ɐ
<|bul|>чукундур	t͡ʃ u k u n d u r
<|bul|>оберон	ɔ b ɛ r o n
<|bul|>запреда	z ɐ p r ɛ d ɤ
<|bul|>татко	t a t k o
<|bul|>плавей	p ɫ a v ɛ j
<|bul|>канара	k ɐ n ɐ r a
<|bul|>ганимед	ɡ ɐ n i m ɛ t
<|bul|>къщо	k ɤ ʃ t o
<|bul|>коля	k ɔ lʲ ɐ
<|bul|>хулиганство	x u lʲ i ɡ a n s t v o
<|bul|>собол	s o b ɔ ɫ
<|bul|>деспотизъм	d ɛ s p o t i z ɐ m
<|bul|>движа	d v i ʒ ɐ
<|bul|>би	b i
<|bul|>отличим	o t lʲ i t͡ʃ i m
<|bul|>доя	d o j ɤ
<|bul|>дециметър	d ɛ t͡s i m ɛ t ɐ r
<|bul|>акушерка	ɐ k u ʃ ɛ r k ɐ
<|bul|>злъч	z ɫ ɤ t͡ʃ
<|bul|>долина	d o lʲ i n a
<|bul|>загреб	z a ɡ r ɛ p
<|bul|>рунтав	r u n t ɐ f
<|bul|>радвам	r a d v ɐ m
<|bul|>тоалет	t o ɐ lʲ ɛ t
<|bul|>превъзхождам	p r ɛ v ɐ s x ɔ ʒ d ɐ m
<|bul|>атентат	ɐ t ɛ n t a t
<|bul|>гълъб	ɡ ɤ ɫ ɐ p
<|bul|>гостилница	ɡ o s t i ɫ n i t͡s ɐ
<|bul|>изгубя	i z ɡ u bʲ ɐ
<|bul|>преперец	p r ɛ p ɛ r ɛ t͡s
<|bul|>панталон	p ɐ n t ɐ ɫ ɔ n
<|bul|>серен	s ɛ r ɛ n
<|bul|>вегав	v ɛ ɡ ɐ f
<|bul|>бодил	b o d i ɫ
<|bul|>плащ	p ɫ a ʃ t
<|bul|>лютив	lʲ u t i f
<|bul|>определен	o p r ɛ d ɛ lʲ ɛ n
<|bul|>плащам	p ɫ a ʃ t ɐ m
<|bul|>саксия	s ɐ k s i j ɐ
<|bul|>пищен	p i ʃ t ɛ n
<|bul|>озаглавя	o z ɐ ɡ ɫ ɐ vʲ ɤ
<|bul|>невъзможно	n ɛ v ɐ z m ɔ ʒ n o
<|bul|>бастилия	b ɐ s t i lʲ i j ɐ
<|bul|>узаконяването	u z ɐ k o nʲ a v ɐ n ɛ t o
<|bul|>щедър	ʃ t ɛ d ɐ r
<|bul|>огорча	o ɡ o r t͡ʃ a
<|bul|>много	m n ɔ ɡ o
<|bul|>бразилия	b r ɐ z i lʲ i j ɐ
<|bul|>ярък	j a r ɐ k
<|bul|>клюн	k lʲ u n
<|bul|>абдикиралата	ɐ b d i kʲ i r ɐ ɫ ɐ t ɐ
<|bul|>мях	mʲ a x
<|bul|>извиквам	i z v i k v ɐ m
<|bul|>апсида	ɐ p s i d ɐ
<|bul|>напредък	n ɐ p r ɛ d ɐ k
<|bul|>култура	k u ɫ t u r ɐ
<|bul|>братски	b r a t s kʲ i
<|bul|>азе	a z ɛ
<|bul|>зърна	z ɤ r n ɐ
<|bul|>годинак	ɡ o d i n a k
<|bul|>раждам	r a ʒ d ɐ m
<|bul|>глух	ɡ ɫ u x
<|bul|>лют	lʲ u t
<|bul|>очен	ɔ t͡ʃ ɛ n
<|bul|>фикус	f i k u s
<|bul|>парк	p a r k
<|bul|>посетител	p o s ɛ t i t ɛ ɫ
<|bul|>мегаметър	m ɛ ɡ ɐ m ɛ t ɐ r
<|bul|>сценарий	s t͡s ɛ n a r i
<|bul|>камшик	k ɐ m ʃ i k
<|bul|>вашето	v a ʃ ɛ t o
<|bul|>смрадливец	s m r ɐ d lʲ i v ɛ t͡s
<|bul|>университет	u n i v ɛ r s i t ɛ t
<|bul|>матерен	m a t ɛ r ɛ n
<|bul|>краен	k r a ɛ n
<|bul|>нар	n a r
<|bul|>картал	k ɐ r t a ɫ
<|bul|>дрозд	d r ɔ s t
<|bul|>петрол	p ɛ t r ɔ ɫ
<|bul|>пасене	p ɐ s ɛ n ɛ
<|bul|>извличам	i z v lʲ i t͡ʃ ɐ m
<|bul|>ищах	i ʃ t a x
<|bul|>колибри	k o lʲ i b r i
<|bul|>русло	r u s ɫ o
<|bul|>редя	r ɛ dʲ a
<|bul|>институт	i n s t i t u t
<|bul|>труден	t r u d ɛ n
<|bul|>кралски	k r a ɫ s kʲ i
<|bul|>ексалитър	ɐ t o lʲ i t ɐ r
<|bul|>гнилоч	ɡ n i ɫ ɔ t͡ʃ
<|bul|>двуличен	d v u lʲ i t͡ʃ ɛ n
<|bul|>сърбин	s ɤ r b i n
<|bul|>трици	t r i t͡s i
<|bul|>миризма	m i r i z m a
<|bul|>деепричастие	d ɛ ɛ p r i t͡ʃ a s t i ɛ
<|bul|>прегиня	p r ɛ ɡʲ i nʲ ɐ
<|bul|>щяла	ʃ tʲ a ɫ ɐ
<|bul|>мамут	m ɐ m u t
<|bul|>узаконят	u z ɐ k o nʲ ɤ t
<|bul|>леко	lʲ ɛ k o
<|bul|>пръчица	p r ɤ t͡ʃ i t͡s ɐ
<|bul|>гигантски	ɡʲ i ɡ a n t s kʲ i
<|bul|>дума	d u m ɐ
<|bul|>изток	i s t o k
<|bul|>усмихвам	u s m i x v ɐ m
<|bul|>благословия	b ɫ ɐ ɡ o s ɫ o v i j ɐ
<|bul|>сви	s v i
<|bul|>германски	ɡʲ ɛ r m a n s kʲ i
<|bul|>гибел	ɡʲ i b ɛ ɫ
<|bul|>багър	b a ɡ ɐ r
<|bul|>безплатен	b ɛ s p ɫ a t ɛ n
<|bul|>корона	k o r ɔ n ɐ
<|bul|>аерометър	a ɛ r o m ɛ t ɐ r
<|bul|>суровина	s u r o v i n a
