<|ITA|>abbonamento	a b b o n a m e n t o
<|ITA|>accettare	a t t͡ʃ e t t a r e
<|ITA|>accoglienza	a k k o ʎ ʎ ɛ n t͡s a
<|ITA|>accompagnare	a k k o m p a ɲ ɲ a r e
<|ITA|>accordo	a k k ɔ r d o
<|ITA|>acqua	a k k w a
<|ITA|>acquazzone	a k k w a t t͡s o n e
<|ITA|>acquistare	a k k w i s t a r e
<|ITA|>ad	a d
<|ITA|>adatto	a d a t t o
<|ITA|>adesso	a d ɛ s s o
<|ITA|>affermato	a f f e r m a t o
<|ITA|>agenti	a d͡ʒ ɛ n t i
<|ITA|>agenzia	a d͡ʒ e n t͡s i a
<|ITA|>aggiunge	a d d͡ʒ u n d͡ʒ e
<|ITA|>aggiunto	a d d͡ʒ u n t o
<|ITA|>agli	a ʎ ʎ i
<|ITA|>aiuto	a j u t o
<|ITA|>albergo	a l b ɛ r ɡ o
<|ITA|>alberto	a l b ɛ r t o
<|ITA|>alessandra	a l e s s a n d r a
<|ITA|>alghero	a l ɡ ɛ r o
<|ITA|>alle	a l l e
<|ITA|>allenatore	a l l e n a t o r e
<|ITA|>allineato	a l l i n e a t o
<|ITA|>allo	a l l o
<|ITA|>allucinato	a l l u t͡ʃ i n a t o
<|ITA|>alternato	a l t e r n a t o
<|ITA|>alti	a l t i
<|ITA|>altra	a l t r a
<|ITA|>altre	a l t r e
<|ITA|>altri	a l t r i
<|ITA|>altro	a l t r o
<|ITA|>alture	a l t u r e
<|ITA|>america	a m ɛ r i k a
<|ITA|>amministrazione	a m m i n i s t r a t t͡s j o n e
<|ITA|>ampio	a m p j o
<|ITA|>anatroccolo	a n a t r ɔ k k o l o
<|ITA|>anche	a n k e
<|ITA|>andare	a n d a r e
<|ITA|>animale	a n i m a l e
<|ITA|>animazione	a n i m a t t͡s j o n e
<|ITA|>antognoni	a n t o ɲ ɲ o n i
<|ITA|>antonella	a n t o n ɛ l l a
<|ITA|>aperto	a p ɛ r t o
<|ITA|>appalti	a p p a l t i
<|ITA|>apparecchio	a p p a r e k k j o
<|ITA|>appello	a p p ɛ l l o
<|ITA|>appena	a p p e n a
<|ITA|>applicare	a p p l i k a r e
<|ITA|>aprile	a p r i l e
<|ITA|>ara	a r a
<|ITA|>armati	a r m a t i
<|ITA|>arricchito	a r r i k k i t o
<|ITA|>arrivare	a r r i v a r e
<|ITA|>arsenico	a r s ɛ n i k o
<|ITA|>articolo	a r t i k o l o
<|ITA|>assente	a s s ɛ n t e
<|ITA|>assenza	a s s ɛ n t͡s a
<|ITA|>assicurato	a s s i k u r a t o
<|ITA|>assistenza	a s s i s t ɛ n t͡s a
<|ITA|>assistere	a s s i s t e r e
<|ITA|>assolutistico	a s s o l u t i s t i k o
<|ITA|>attività	a t t i v i t a
<|ITA|>attraverso	a t t r a v ɛ r s o
<|ITA|>attuale	a t t u a l e
<|ITA|>attualità	a t t u a l i t a
<|ITA|>augusta	a w ɡ u s t a
<|ITA|>auto	a w t o
<|ITA|>autorevole	a u t o r e v o l e
<|ITA|>autorità	a u̯ t o r i t a
<|ITA|>autunno	a w t u n n o
<|ITA|>avanti	a v a n t i
<|ITA|>avere	a v e r e
<|ITA|>aveva	a v e v a
<|ITA|>badia	b a d i a
<|ITA|>ballo	b a l l o
<|ITA|>balzo	b a l t͡s o
<|ITA|>banca	b a n k a
<|ITA|>banda	b a n d a
<|ITA|>banditi	b a n d i t i
<|ITA|>basta	b a s t a
<|ITA|>battaglia	b a t t a ʎ ʎ a
<|ITA|>battere	b a t t e r e
<|ITA|>befana	b e f a n a
<|ITA|>benissimo	b e n i s s i m o
<|ITA|>beppe	b ɛ p p e
<|ITA|>biglietto	b i ʎ ʎ e t t o
<|ITA|>bisogno	b i z o ɲ ɲ o
<|ITA|>bolla	b o l l a
<|ITA|>bologna	b o l o ɲ ɲ a
<|ITA|>borse	b o r s e
<|ITA|>brevi	b r ɛ v i
<|ITA|>brutale	b r u t a l e
<|ITA|>buon	b w ɔ n
<|ITA|>cadavere	k a d a v e r e
<|ITA|>calabria	k a l a b r j a
<|ITA|>calcio	k a l t͡ʃ o
<|ITA|>calendario	k a l e n d a r j o
<|ITA|>calore	k a l o r e
<|ITA|>cambiare	k a m b j a r e
<|ITA|>camion	k a m j o n
<|ITA|>camminare	k a m m i n a r e
<|ITA|>cammino	k a m m i n o
<|ITA|>campagna	k a m p a ɲ ɲ a
<|ITA|>campo	k a m p o
<|ITA|>candidato	k a n d i d a t o
<|ITA|>cane	k a n e
<|ITA|>canzone	k a n t͡s o n e
<|ITA|>capire	k a p i r e
<|ITA|>capita	k a p i t a
<|ITA|>capito	k a p i t o
<|ITA|>capo	k a p o
<|ITA|>capolino	k a p o l i n o
<|ITA|>capoluogo	k a p o l w ɔ ɡ o
<|ITA|>cappa	k a p p a
<|ITA|>cardinale	k a r d i n a l e
<|ITA|>casinò	k a z i n ɔ
<|ITA|>caso	k a z o
<|ITA|>castello	k a s t ɛ l l o
<|ITA|>cattedrale	k a t t e d r a l e
<|ITA|>cattolico	k a t t o l i k o
<|ITA|>ce	t͡ʃ e
<|ITA|>celebre	t͡ʃ ɛ l e b r e
<|ITA|>cena	t͡ʃ e n a
<|ITA|>cento	t͡ʃ ɛ n t o
<|ITA|>centrale	t ʃ e n t r a l e
<|ITA|>centro	t ʃ ɛ n t r o
<|ITA|>cerca	t͡ʃ e r k a
<|ITA|>cercare	t ʃ e r k a r e
<|ITA|>cerco	t͡ʃ e r k o
<|ITA|>certo	t͡ʃ ɛ r t o
<|ITA|>che	k e
<|ITA|>chiamo	k j a m o
<|ITA|>chiaro	k j a r o
<|ITA|>chiedere	k j ɛ d e r e
<|ITA|>chiuso	k j u z o
<|ITA|>chiù	k j u
<|ITA|>ciclo	t͡ʃ i k l o
<|ITA|>cinque	t͡ʃ i n k w e
<|ITA|>cioccolato	t͡ʃ o k k o l a t o
<|ITA|>cittadino	t͡ʃ i t t a d i n o
<|ITA|>civile	t͡ʃ i v i l e
<|ITA|>coerenza	k o e r ɛ n t͡s a
<|ITA|>collegamento	k o l l e ɡ a m e n t o
<|ITA|>colloquio	k o l l ɔ k w j o
<|ITA|>colore	k o l o r e
<|ITA|>combattere	k o m b a t t e r e
<|ITA|>come	k o m e
<|ITA|>cominciare	k o m i n t͡ʃ a r e
<|ITA|>compagnia	k o m p a ɲ ɲ i a
<|ITA|>compilazione	k o m p i l a t t͡s j o n e
<|ITA|>complessità	k o m p l e s s i t a
<|ITA|>complotto	k o m p l ɔ t t o
<|ITA|>comprare	k o m p r a r e
<|ITA|>comunque	k o m u n k w e
<|ITA|>concetto	k o n t͡ʃ ɛ t t o
<|ITA|>conclusione	k o n k l u z j o n e
<|ITA|>condividere	k o n d i v i d e r e
<|ITA|>condizione	k o n d i t t͡s j o n e
<|ITA|>condurre	k o n d u r r e
<|ITA|>conduttore	k o n d u t t o r e
<|ITA|>connessione	k o n n e s s j o n e
<|ITA|>contagi	k o n t a d͡ʒ i
<|ITA|>contatto	k o n t a t t o
<|ITA|>conte	k o n t e
<|ITA|>contenimento	k o n t e n i m e n t o
<|ITA|>contenuto	k o n t e n u t o
<|ITA|>continuo	k o n t i n w o
<|ITA|>contrastato	k o n t r a s t a t o
<|ITA|>contro	k o n t r o
<|ITA|>convinto	k o n v i n t o
<|ITA|>copertina	k o p e r t i n a
<|ITA|>copie	k ɔ p j e
<|ITA|>coprire	k o p r i r e
<|ITA|>corona	k o r o n a
<|ITA|>corruscare	k o r r u s k a r e
<|ITA|>costituzionale	k o s t i t u t t͡s j o n a l e
<|ITA|>creare	k r e a r e
<|ITA|>credo	k r e d o
<|ITA|>criterio	k r i t ɛ r j o
<|ITA|>cruciforme	k r u t͡ʃ i f o r m e
<|ITA|>cui	k u j
<|ITA|>curato	k u r a t o
<|ITA|>daffare	d a f f a r e
<|ITA|>dallo	d a l l o
<|ITA|>danno	d a n n o
<|ITA|>deboli	d e b o l i
<|ITA|>debutto	d e b u t t o
<|ITA|>decesso	d e t͡ʃ ɛ s s o
<|ITA|>decisamente	d e t͡ʃ i z a m e n t e
<|ITA|>deciso	d e t͡ʃ i z o
<|ITA|>democratico	d e m o k r a t i k o
<|ITA|>densità	d e n s i t a
<|ITA|>dentro	d e n t r o
<|ITA|>dettaglio	d e t t a ʎ ʎ o
<|ITA|>deve	d ɛ v e
<|ITA|>dice	d i t͡ʃ e
<|ITA|>dichiarato	d i k j a r a t o
<|ITA|>didattica	d i d a t t i k a
<|ITA|>dieci	d j ɛ t͡ʃ i
<|ITA|>difendere	d i f ɛ n d e r e
<|ITA|>difesa	d i f e s a
<|ITA|>difficoltà	d i f f i k o l t a
<|ITA|>diffondere	d i f f o n d e r e
<|ITA|>diffusione	d i f f u z j o n e
<|ITA|>dilettantistico	d i l e t t a n t i s t i k o
<|ITA|>diminuzione	d i m i n u t t͡s j o n e
<|ITA|>dipendente	d i p e n d ɛ n t e
<|ITA|>dire	d i r e
<|ITA|>direzione	d i r e t t s j o n e
<|ITA|>dirotto	d i r o t t o
<|ITA|>disagi	d i z a d͡ʒ i
<|ITA|>disastro	d i z a s t r o
<|ITA|>disposizione	d i s p o z i t t͡s j o n e
<|ITA|>diva	d i v a
<|ITA|>diversità	d i v e r s i t a
<|ITA|>divisione	d i v i z j o n e
<|ITA|>diviso	d i v i z o
<|ITA|>dobbiamo	d o b b j a m o
<|ITA|>dolore	d o l o r e
<|ITA|>domani	d o m a n i
<|ITA|>donna	d ɔ n n a
<|ITA|>donne	d ɔ n n e
<|ITA|>dopo	d o p o
<|ITA|>dormire	d o r m i r e
<|ITA|>dottrina	d o t t r i n a
<|ITA|>dove	d o v e
<|ITA|>dovuto	d o v u t o
<|ITA|>drammatico	d r a m m a t i k o
<|ITA|>droga	d r ɔ ɡ a
<|ITA|>due	d u e
<|ITA|>dunque	d u n k w e
<|ITA|>durante	d u r a n t e
<|ITA|>ebbene	e b b ɛ n e
<|ITA|>ebraico	e b r a j k o
<|ITA|>ecco	ɛ k k o
<|ITA|>economista	e k o n o m i s t a
<|ITA|>ed	e d
<|ITA|>edizione	e d i t t͡s j o n e
<|ITA|>efficiente	e f f i t͡ʃ ɛ n t e
<|ITA|>elicottero	e l i k ɔ t t e r o
<|ITA|>emotivo	e m o t i v o
<|ITA|>energetica	e n e r d͡ʒ ɛ t i k a
<|ITA|>energia	e n e r d͡ʒ i a
<|ITA|>episodi	e p i z ɔ d i
<|ITA|>episodio	e p i z ɔ d j o
<|ITA|>era	ɛ r a
<|ITA|>ero	ɛ r o
<|ITA|>errore	e r r o r e
<|ITA|>errori	e r r o r i
<|ITA|>esattamente	e z a t t a m e n t e
<|ITA|>eseguire	e z e ɡ w i r e
<|ITA|>esempio	e z ɛ m p j o
<|ITA|>esperienza	e s p e r j ɛ n t͡s a
<|ITA|>essere	ɛ s s e r e
<|ITA|>eterno	e t ɛ r n o
<|ITA|>evidente	e v i d ɛ n t e
<|ITA|>evitando	e v i t a n d o
<|ITA|>evitare	e v i t a r e
<|ITA|>fa	f a
<|ITA|>fabbisogno	f a b b i z o ɲ ɲ o
<|ITA|>fabbrica	f a b b r i k a
<|ITA|>fabrizio	f a b r i t t s j o
<|ITA|>faccio	f a t t ʃ o
<|ITA|>fallo	f a l l o
<|ITA|>famiglia	f a m i ʎ ʎ a
<|ITA|>fanno	f a n n o
<|ITA|>fantasia	f a n t a z i a
<|ITA|>fasce	f a ʃ ʃ e
<|ITA|>fascia	f a ʃ ʃ a
<|ITA|>fascista	f a ʃ ʃ i s t a
<|ITA|>fase	f a z e
<|ITA|>fatica	f a t i k a
<|ITA|>fatto	f a t t o
<|ITA|>fatturato	f a t t u r a t o
<|ITA|>febbraio	f e b b r a j o
<|ITA|>federale	f e d e r a l e
<|ITA|>federico	f e d e r i k o
<|ITA|>felice	f e l i t͡ʃ e
<|ITA|>femminile	f e m m i n i l e
<|ITA|>fenomeno	f e n ɔ m e n o
<|ITA|>fermato	f e r m a t o
<|ITA|>ferro	f ɛ r r o
<|ITA|>festa	f ɛ s t a
<|ITA|>festività	f e s t i v i t a
<|ITA|>fiducioso	f i d u t͡ʃ o z o
<|ITA|>figlia	f i ʎ ʎ a
<|ITA|>figlio	f i ʎ ʎ o
<|ITA|>fila	f i l a
<|ITA|>fine	f i n e
<|ITA|>finite	f i n i t e
<|ITA|>fiorentina	f j o r e n t i n a
<|ITA|>firenze	f i r ɛ n t͡s e
<|ITA|>fiscale	f i s k a l e
<|ITA|>fisica	f i z i k a
<|ITA|>fisico	f i z i k o
<|ITA|>fornitura	f o r n i t u r a
<|ITA|>forse	f o r s e
<|ITA|>fortuna	f o r t u n a
<|ITA|>foto	f ɔ t o
<|ITA|>fra	f r a
<|ITA|>frase	f r a z e
<|ITA|>friuli	f r i u l i
<|ITA|>fucile	f u t͡ʃ i l e
<|ITA|>funzione	f u n t͡s j o n e
<|ITA|>furto	f u r t o
<|ITA|>futuro	f u t u r o
<|ITA|>gazebo	ɡ a d d͡z ɛ b o
<|ITA|>genere	d͡ʒ ɛ n e r e
<|ITA|>genio	d͡ʒ ɛ n j o
<|ITA|>giornale	d͡ʒ o r n a l e
<|ITA|>giornata	d͡ʒ o r n a t a
<|ITA|>giorno	d͡ʒ o r n o
<|ITA|>giovanile	d͡ʒ o v a n i l e
<|ITA|>giovanni	d͡ʒ o v a n n i
<|ITA|>giudiziario	d͡ʒ u d i t t͡s j a r j o
<|ITA|>giulietta	d͡ʒ u l j e t t a
<|ITA|>già	d͡ʒ a
<|ITA|>globale	ɡ l o b a l e
<|ITA|>governo	ɡ o v ɛ r n o
<|ITA|>gran	ɡ r a n
<|ITA|>grandi	ɡ r a n d i
<|ITA|>grasso	ɡ r a s s o
<|ITA|>grazie	ɡ r a t t͡s j e
<|ITA|>greco	ɡ r ɛ k o
<|ITA|>griffe	ɡ r i f f e
<|ITA|>gruppetto	ɡ r u p p e t t o
<|ITA|>ieri	j ɛ r i
<|ITA|>il	i l
<|ITA|>ilarità	i l a r i t a
<|ITA|>impeto	i m p e t o
<|ITA|>in	i n
<|ITA|>incontrare	i n k o n t r a r e
<|ITA|>indignazione	i n d i ɲ ɲ a t t͡s j o n e
<|ITA|>inedito	i n ɛ d i t o
<|ITA|>infelice	i n f e l i t͡ʃ e
<|ITA|>infermiere	i n f e r m j ɛ r e
<|ITA|>ingiustizia	i n d͡ʒ u s t i t t͡s j a
<|ITA|>inglese	i n ɡ l e z e
<|ITA|>ingressi	i n ɡ r ɛ s s i
<|ITA|>iniezione	i n j e t t͡s j o n e
<|ITA|>intanto	i n t a n t o
<|ITA|>intenzione	i n t e n t͡s j o n e
<|ITA|>intervista	i n t e r v i s t a
<|ITA|>intorno	i n t o r n o
<|ITA|>introdotto	i n t r o d o t t o
<|ITA|>invece	i n v e t͡ʃ e
<|ITA|>invito	i n v i t o
<|ITA|>io	i o
<|ITA|>istituto	i s t i t u t o
<|ITA|>italiana	i t a l j a n a
<|ITA|>italo	i t a l o
<|ITA|>le	l e
<|ITA|>legato	l e ɡ a t o
<|ITA|>legislativo	l e d͡ʒ i z l a t i v o
<|ITA|>lentamente	l e n t a m ɛ n t e
<|ITA|>leone	l e o n e
<|ITA|>lettera	l ɛ t t e r a
<|ITA|>lettura	l e t t u r a
<|ITA|>lezione	l e t t͡s j o n e
<|ITA|>libertà	l i b e r t a
<|ITA|>limitazione	l i m i t a t t͡s j o n e
<|ITA|>limite	l i m i t e
<|ITA|>lista	l i s t a
<|ITA|>logica	l ɔ d͡ʒ i k a
<|ITA|>lombardia	l o m b a r d i a
<|ITA|>lotta	l ɔ t t a
<|ITA|>luce	l u t͡ʃ e
<|ITA|>luigi	l w i d͡ʒ i
<|ITA|>lupo	l u p o
<|ITA|>maggiore	m a d d͡ʒ o r e
<|ITA|>mail	m ɛ i l
<|ITA|>malore	m a l o r e
<|ITA|>mamma	m a m m a
<|ITA|>manca	m a n k a
<|ITA|>mancato	m a n k a t o
<|ITA|>mantenere	m a n t e n e r e
<|ITA|>marca	m a r k a
<|ITA|>marea	m a r ɛ a
<|ITA|>maria	m a r i a
<|ITA|>marito	m a r i t o
<|ITA|>marocco	m a r ɔ k k o
<|ITA|>martedì	m a r t e d i
<|ITA|>maschera	m a s k e r a
<|ITA|>massaggiatore	m a s s a d d͡ʒ a t o r e
<|ITA|>materiale	m a t e r j a l e
<|ITA|>mattinata	m a t t i n a t a
<|ITA|>medesimo	m e d e z i m o
<|ITA|>medicina	m e d i t͡ʃ i n a
<|ITA|>meglio	m ɛ ʎ ʎ o
<|ITA|>melo	m e l o
<|ITA|>mente	m e n t e
<|ITA|>mentre	m e n t r e
<|ITA|>mercati	m e r k a t i
<|ITA|>mercato	m e r k a t o
<|ITA|>messa	m e s s a
<|ITA|>metà	m e t a
<|ITA|>mezzosoprano	m ɛ d d͡z o s o p r a n o
<|ITA|>mi	m i
<|ITA|>miei	m j ɛ i
<|ITA|>miglior	m i ʎ ʎ o r
<|ITA|>mila	m i l a
<|ITA|>mille	m i l l e
<|ITA|>minore	m i n o r e
<|ITA|>missione	m i s s j o n e
<|ITA|>misto	m i s t o
<|ITA|>modo	m ɔ d o
<|ITA|>moglie	m o ʎ ʎ e
<|ITA|>molto	m o l t o
<|ITA|>monaco	m ɔ n a k o
<|ITA|>mosca	m o s k a
<|ITA|>motivo	m o t i v o
<|ITA|>movimento	m o v i m e n t o
<|ITA|>mugello	m u d͡ʒ ɛ l l o
<|ITA|>multa	m u l t a
<|ITA|>musicale	m u z i k a l e
<|ITA|>napoletano	n a p o l e t a n o
<|ITA|>nascita	n a ʃ ʃ i t a
<|ITA|>nata	n a t a
<|ITA|>natale	n a t a l e
<|ITA|>nato	n a t o
<|ITA|>naturale	n a t u r a l e
<|ITA|>naturalezza	n a t u r a l e t t͡s a
<|ITA|>nazionale	n a t t͡s j o n a l e
<|ITA|>necessario	n e t͡ʃ e s s a r j o
<|ITA|>necessità	n e t͡ʃ e s s i t a
<|ITA|>nemmeno	n e m m e n o
<|ITA|>neonata	n e o n a t a
<|ITA|>nerazzurri	n e r a t t͡s u r r i
<|ITA|>nessun	n e s s u n
<|ITA|>nessuno	n e s s u n o
<|ITA|>netto	n e t t o
<|ITA|>neve	n e v e
<|ITA|>nicola	n i k ɔ l a
<|ITA|>niente	n j ɛ n t e
<|ITA|>nobile	n ɔ b i l e
<|ITA|>non	n o n
<|ITA|>norma	n ɔ r m a
<|ITA|>nostri	n ɔ s t r i
<|ITA|>nostro	n ɔ s t r o
<|ITA|>note	n ɔ t e
<|ITA|>noto	n ɔ t o
<|ITA|>numero	n u m e r o
<|ITA|>nuova	n w ɔ v a
<|ITA|>nuovo	n w ɔ v o
<|ITA|>occhi	ɔ k k i
<|ITA|>offrire	o f f r i r e
<|ITA|>oggi	ɔ d d͡ʒ i
<|ITA|>olanda	o l a n d a
<|ITA|>olimpico	o l i m p i k o
<|ITA|>opera	ɔ p e r a
<|ITA|>operativo	o p e r a t i v o
<|ITA|>operato	o p e r a t o
<|ITA|>oppure	o p p u r e
<|ITA|>orgoglio	o r ɡ o ʎ ʎ o
<|ITA|>oriente	o r j ɛ n t e
<|ITA|>origine	o r i d͡ʒ i n e
<|ITA|>ospite	ɔ s p i t e
<|ITA|>ostinatamente	o s t i n a t a m e n t e
<|ITA|>ottenere	o t t e n e r e
<|ITA|>pace	p a t͡ʃ e
<|ITA|>pagina	p a d͡ʒ i n a
<|ITA|>palazzo	p a l a t t s o
<|ITA|>palco	p a l k o
<|ITA|>palermo	p a l ɛ r m o
<|ITA|>palio	p a l j o
<|ITA|>palo	p a l o
<|ITA|>pane	p a n e
<|ITA|>parere	p a r e r e
<|ITA|>partecipare	p a r t e t͡ʃ i p a r e
<|ITA|>parto	p a r t o
<|ITA|>parziale	p a r t͡s j a l e
<|ITA|>passaporto	p a s s a p o r t o
<|ITA|>passione	p a s s j o n e
<|ITA|>patito	p a t i t o
<|ITA|>paura	p a u r a
<|ITA|>pc	p i t ʃ i
<|ITA|>pellicola	p e l l i k o l a
<|ITA|>pensare	p e n s a r e
<|ITA|>pensavo	p e n s a v o
<|ITA|>pensiero	p e n s j ɛ r o
<|ITA|>pentirsi	p e n t i r s i
<|ITA|>per	p e r
<|ITA|>percorso	p e r k o r s o
<|ITA|>perdere	p ɛ r d e r e
<|ITA|>performance	p e r f ɔ r m a n s
<|ITA|>pericolo	p e r i k o l o
<|ITA|>periodo	p e r i o d o
<|ITA|>perno	p ɛ r n o
<|ITA|>perplessità	p e r p l e s s i t a
<|ITA|>persa	p ɛ r s a
<|ITA|>persino	p e r s i n o
<|ITA|>persona	p e r s o n a
<|ITA|>però	p e r ɔ
<|ITA|>petrolio	p e t r ɔ l j o
<|ITA|>pettorale	p e t t o r a l e
<|ITA|>pezzi	p ɛ t t͡s i
<|ITA|>pianificazione	p j a n i f i k a t t͡s j o n e
<|ITA|>piattaforma	p j a t t a f o r m a
<|ITA|>picciotto	p i t t͡ʃ ɔ t t o
<|ITA|>piccola	p i k k o l a
<|ITA|>piccolo	p i k k o l o
<|ITA|>piovere	p j ɔ v e r e
<|ITA|>più	p j u
<|ITA|>plancia	p l a n t͡ʃ a
<|ITA|>plutone	p l u t o n e
<|ITA|>politico	p o l i t i k o
<|ITA|>pomeriggio	p o m e r i d d͡ʒ o
<|ITA|>pompiere	p o m p j ɛ r e
<|ITA|>popolazione	p o p o l a t t͡s j o n e
<|ITA|>portare	p o r t a r e
<|ITA|>positività	p o z i t i v i t a
<|ITA|>positivo	p o z i t i v o
<|ITA|>possa	p ɔ s s a
<|ITA|>possiamo	p o s s j a m o
<|ITA|>possibile	p o s s i b i l e
<|ITA|>posso	p ɔ s s o
<|ITA|>potrà	p o t r a
<|ITA|>pranzo	p r a n d͡z o
<|ITA|>prefigge	p r e f i d d͡ʒ e
<|ITA|>prende	p r ɛ n d e
<|ITA|>preparazione	p r e p a r a t t͡s j o n e
<|ITA|>presenza	p r e z ɛ n t͡s a
<|ITA|>presto	p r ɛ s t o
<|ITA|>primaria	p r i m a r j a
<|ITA|>primavera	p r i m a v ɛ r a
<|ITA|>primo	p r i m o
<|ITA|>principi	p r i n t͡ʃ i p i
<|ITA|>prodotto	p r o d o t t o
<|ITA|>profonda	p r o f o n d a
<|ITA|>programma	p r o ɡ r a m m a
<|ITA|>progresso	p r o ɡ r ɛ s s o
<|ITA|>promozione	p r o m o t t͡s j o n e
<|ITA|>propria	p r ɔ p r j a
<|ITA|>prossimo	p r ɔ s s i m o
<|ITA|>protezione	p r o t e t t͡s j o n e
<|ITA|>protocollo	p r o t o k ɔ l l o
<|ITA|>prova	p r ɔ v a
<|ITA|>provvedimento	p r o v v e d i m e n t o
<|ITA|>puntata	p u n t a t a
<|ITA|>pupo	p u p o
<|ITA|>pure	p u r e
<|ITA|>qualche	k w a l k e
<|ITA|>qualcosa	k w a l k ɔ z a
<|ITA|>qualcuno	k w a l k u n o
<|ITA|>quando	k w a n d o
<|ITA|>quarantena	k w a r a n t ɛ n a
<|ITA|>quarta	k w a r t a
<|ITA|>quella	k w e l l a
<|ITA|>quelli	k w e l l i
<|ITA|>quello	k w e l l o
<|ITA|>questione	k w e s t j o n e
<|ITA|>quinta	k w i n t a
<|ITA|>quirinale	k w i r i n a l e
<|ITA|>ragazza	r a ɡ a t t͡s a
<|ITA|>ragazzi	r a ɡ a t t͡s i
<|ITA|>rai	r a i̯
<|ITA|>rapire	r a p i r e
<|ITA|>reciproco	r e t͡ʃ i p r o k o
<|ITA|>regola	r ɛ ɡ o l a
<|ITA|>relativo	r e l a t i v o
<|ITA|>renato	r e n a t o
<|ITA|>rende	r ɛ n d e
<|ITA|>rendere	r ɛ n d e r e
<|ITA|>rendiconto	r ɛ n d i k o n t o
<|ITA|>resa	r e z a
<|ITA|>responsabilità	r e s p o n s a b i l i t a
<|ITA|>rete	r e t e
<|ITA|>reticolo	r e t i k o l o
<|ITA|>retrocessione	r e t r o t͡ʃ e s s j o n e
<|ITA|>revisione	r e v i z j o n e
<|ITA|>ricchezza	r i k k e t t͡s a
<|ITA|>riferimento	r i f e r i m e n t o
<|ITA|>riforma	r i f o r m a
<|ITA|>rimanere	r i m a n e r e
<|ITA|>rimangono	r i m a n ɡ o n o
<|ITA|>rimasto	r i m a s t o
<|ITA|>rimettere	r i m e t t e r e
<|ITA|>riscossione	r i s k o s s j o n e
<|ITA|>risposta	r i s p o s t a
<|ITA|>risultato	r i z u l t a t o
<|ITA|>ritmo	r i t m o
<|ITA|>riuscito	r i u ʃ ʃ i t o
<|ITA|>roberta	r o b ɛ r t a
<|ITA|>roberto	r o b ɛ r t o
<|ITA|>roma	r o m a
<|ITA|>romano	r o m a n o
<|ITA|>rossa	r o s s a
<|ITA|>rosso	r o s s o
<|ITA|>rotto	r o t t o
<|ITA|>russa	r u s s a
<|ITA|>saggio	s a d d͡ʒ o
<|ITA|>salerno	s a l ɛ r n o
<|ITA|>saltare	s a l t a r e
<|ITA|>salvini	s a l v i n i
<|ITA|>san	s a n
<|ITA|>sanitario	s a n i t a r j o
<|ITA|>sarà	s a r a
<|ITA|>savoia	s a v ɔ j a
<|ITA|>scadenza	s k a d ɛ n t͡s a
<|ITA|>scatola	s k a t o l a
<|ITA|>scegliere	ʃ e ʎ ʎ e r e
<|ITA|>scelta	ʃ e l t a
<|ITA|>scelto	ʃ e l t o
<|ITA|>sciatrice	ʃ a t r i t͡ʃ e
<|ITA|>scienza	ʃ ɛ n t͡s a
<|ITA|>scorso	s k o r s o
<|ITA|>scudetto	s k u d e t t o
<|ITA|>scuola	s k w ɔ l a
<|ITA|>se	s e
<|ITA|>segno	s e ɲ o
<|ITA|>seguire	s e ɡ w i r e
<|ITA|>sembra	s e m b r a
<|ITA|>sento	s ɛ n t o
<|ITA|>sera	s e r a
<|ITA|>serie	s ɛ r j e
<|ITA|>sesto	s ɛ s t o
<|ITA|>settembre	s e t t ɛ m b r e
<|ITA|>settore	s e t t o r e
<|ITA|>sfida	s f i d a
<|ITA|>sfiducia	s f i d u t͡ʃ a
<|ITA|>sfortuna	s f o r t u n a
<|ITA|>sguardo	z ɡ w a r d o
<|ITA|>siamo	s j a m o
<|ITA|>sicilia	s i t͡ʃ i l j a
<|ITA|>sicuramente	s i k u r a m e n t e
<|ITA|>siena	s j ɛ n a
<|ITA|>signore	s i ɲ o r e
<|ITA|>silvia	s u l v j a
<|ITA|>sindaco	s i n d a k o
<|ITA|>sinistro	s i n i s t r o
<|ITA|>sinossi	s i n ɔ s s i
<|ITA|>sociale	s o t͡ʃ a l e
<|ITA|>sofferenza	s o f f e r ɛ n t͡s a
<|ITA|>soglia	s ɔ ʎ ʎ a
<|ITA|>sogna	s o ɲ ɲ a
<|ITA|>sogno	s o ɲ ɲ o
<|ITA|>sole	s o l e
<|ITA|>solo	s o l o
<|ITA|>sopra	s o p r a
<|ITA|>soprattutto	s o p r a t t u t t o
<|ITA|>soprintendenza	s o p r i n t e n d ɛ n t͡s a
<|ITA|>sorreggono	s o r r ɛ ɡ ɡ o n o
<|ITA|>sorriso	s o r r i s o
<|ITA|>sorveglianza	s o r v e ʎ ʎ a n t͡s a
<|ITA|>sostanza	s o s t a n t͡s a
<|ITA|>sostegno	s o s t e ɲ ɲ o
<|ITA|>sostituire	s o s t i t u i r e
<|ITA|>sottotitoli	s o t t o t i t o l i
<|ITA|>sparito	s p a r i t o
<|ITA|>speciale	s p e t͡ʃ a l e
<|ITA|>spendere	s p ɛ n d e r e
<|ITA|>speranza	s p e r a n t͡s a
<|ITA|>spesa	s p e z a
<|ITA|>spesso	s p e s s o
<|ITA|>spettacolo	s p e t t a k o l o
<|ITA|>sportivo	s p o r t i v o
<|ITA|>squadra	s k w a d r a
<|ITA|>sta	s t a
<|ITA|>stabilità	s t a b i l i t a
<|ITA|>stadio	s t a d j o
<|ITA|>stagionale	s t a d͡ʒ o n a l e
<|ITA|>stagione	s t a d͡ʒ o n e
<|ITA|>stampa	s t a m p a
<|ITA|>stanziati	s t a n t͡s j a t i
<|ITA|>stata	s t a t a
<|ITA|>state	s t a t e
<|ITA|>stavo	s t a v o
<|ITA|>stefano	s t e f a n o
<|ITA|>stima	s t i m a
<|ITA|>stipendio	s t i p ɛ n d j o
<|ITA|>stoccolma	s t o k k o l m a
<|ITA|>storica	s t ɔ r i k a
<|ITA|>stradale	s t r a d a l e
<|ITA|>strano	s t r a n o
<|ITA|>struttura	s t r u t t u r a
<|ITA|>studente	s t u d ɛ n t e
<|ITA|>studio	s t u d j o
<|ITA|>sturzo	s t u r t͡s o
<|ITA|>su	s u
<|ITA|>sua	s u a
<|ITA|>successo	s u t t͡ʃ ɛ s s o
<|ITA|>suo	s u o
<|ITA|>superare	s u p e r a r e
<|ITA|>superato	s u p e r a t o
<|ITA|>susanna	s u z a n n a
<|ITA|>sviluppare	z v i l u p p a r e
<|ITA|>svolta	z v ɔ l t a
<|ITA|>sì	s i
<|ITA|>tabacco	t a b a k k o
<|ITA|>tacchi	t a k k i
<|ITA|>taccuino	t a k k u i n o
<|ITA|>talmente	t a l m e n t e
<|ITA|>talpa	t a l p a
<|ITA|>tanto	t a n t o
<|ITA|>tarantino	t a r a n t i n o
<|ITA|>tariffa	t a r i f f a
<|ITA|>teatro	t e a t r o
<|ITA|>tecnica	t ɛ k n i k a
<|ITA|>tecnicamente	t e k n i k a m e n t e
<|ITA|>tecnico	t ɛ k n i k o
<|ITA|>tedesco	t e d e s k o
<|ITA|>tegame	t e ɡ a m e
<|ITA|>temperature	t e m p e r a t u r e
<|ITA|>tempo	t ɛ m p o
<|ITA|>termine	t ɛ r m i n e
<|ITA|>terra	t ɛ r r a
<|ITA|>terreno	t e r r e n o
<|ITA|>terrestre	t e r r ɛ s t r e
<|ITA|>territorio	t e r r i t ɔ r j o
<|ITA|>terzo	t ɛ r t͡s o
<|ITA|>tesi	t ɛ z i
<|ITA|>testa	t ɛ s t a
<|ITA|>testamento	t e s t a m e n t o
<|ITA|>ti	t i
<|ITA|>tipicamente	t i p i k a m e n t e
<|ITA|>tipo	t i p o
<|ITA|>titoli	t i t o l i
<|ITA|>tokyo	t ɔ k j o
<|ITA|>tornare	t o r n a r e
<|ITA|>tradizionale	t r a d i t t͡s j o n a l e
<|ITA|>tramite	t r a m i t e
<|ITA|>tranquillo	t r a n k w i l l o
<|ITA|>trattamento	t r a t t a m e n t o
<|ITA|>tre	t r e
<|ITA|>tregua	t r ɛ ɡ w a
<|ITA|>treno	t r ɛ n o
<|ITA|>treviso	t r e v i z o
<|ITA|>tridente	t r i d ɛ n t e
<|ITA|>trimestre	t r i m ɛ s t r e
<|ITA|>tromba	t r o m b a
<|ITA|>trova	t r o v a
<|ITA|>turchia	t u r k i a
<|ITA|>tutte	t u t t e
<|ITA|>tutti	t u t t i
<|ITA|>tutto	t u t t o
<|ITA|>tv	t i v u
<|ITA|>udine	u d i n e
<|ITA|>ufficialmente	u f f i t ʃ a l m e n t e
<|ITA|>ulteriore	u l t e r j o r e
<|ITA|>ulteriormente	u l t e r j o r m e n t e
<|ITA|>ultimi	u l t i m i
<|ITA|>umbria	u m b r j a
<|ITA|>umore	u m o r e
<|ITA|>uninominali	u n i n o m i n a l i
<|ITA|>unisce	u n i ʃ ʃ e
<|ITA|>unità	u n i t a
<|ITA|>urina	u r i n a
<|ITA|>usa	u z a
<|ITA|>usare	u z a r e
<|ITA|>uscire	u ʃ ʃ i r e
<|ITA|>uscito	u ʃ ʃ i t o
<|ITA|>utile	u t i l e
<|ITA|>valanga	v a l a n ɡ a
<|ITA|>valere	v a l e r e
<|ITA|>vanno	v a n n o
<|ITA|>vano	v a n o
<|ITA|>vantaggio	v a n t a d d͡ʒ o
<|ITA|>variazione	v a r j a t t͡s j o n e
<|ITA|>ventimiglia	v e n t i m i ʎ ʎ a
<|ITA|>vera	v e r a
<|ITA|>verde	v e r d e
<|ITA|>verdure	v e r d u r e
<|ITA|>vero	v e r o
<|ITA|>versante	v e r s a n t e
<|ITA|>verso	v ɛ r s o
<|ITA|>vettura	v e t t u r a
<|ITA|>vi	v i
<|ITA|>via	v i a
<|ITA|>viaggio	v i a d d͡ʒ o
<|ITA|>vicina	v i t͡ʃ i n a
<|ITA|>vicine	v i t͡ʃ i n e
<|ITA|>video	v i d e o
<|ITA|>viene	v j ɛ n e
<|ITA|>vigente	v i d͡ʒ ɛ n t e
<|ITA|>vigile	v i d͡ʒ i l e
<|ITA|>villa	v i l l a
<|ITA|>vincere	v i n t ʃ e r e
<|ITA|>viste	v i s t e
<|ITA|>vive	v i v e
<|ITA|>vivere	v i v e r e
<|ITA|>vivo	v i v o
<|ITA|>voce	v o t͡ʃ e
<|ITA|>voglia	v ɔ ʎ ʎ a
<|ITA|>voler	v o l e r
<|ITA|>volontà	v o l o n t a
<|ITA|>volutamente	v o l u t a m e n t e
<|ITA|>vorrebbe	v o r r ɛ b b e
<|ITA|>vorrei	v o r r e j
<|ITA|>vostro	v ɔ s t r o
<|ITA|>votare	v o t a r e
<|ITA|>web	w ɛ b
<|ITA|>whisky	w i s k i
<|ITA|>york	j ɔ r k
<|ITA|>zanetti	d͡z a n e t t i
<|ITA|>zero	d͡z ɛ r o
<|ITA|>zona	d͡z ɔ n a
<|ITA|>épagneul	e p a ɲ ɲ ɔ l
<|ITA|>étoile	e t w a l
<|SPA|>difónicas	d i f o n i k a s
<|SPA|>proclamados	p ɾ o k l a m a d o s
<|SPA|>esprín	e s p ɾ i n
<|SPA|>jugadas	x u ɡ a d a s
<|SPA|>disputable	d i s p u t a b l e
<|SPA|>solaré	s o l a ɾ e
<|SPA|>leninistas	l e n i n i s t a s
<|SPA|>fotografiados	f o t o ɡ ɾ a f j a d o s
<|SPA|>deformar	d e f o ɾ m a ɾ
<|SPA|>fijar	f i x a ɾ
<|SPA|>monitorear	m o n i t o ɾ e a ɾ
<|SPA|>cuasidelito	k w a s i d e l i t o
<|SPA|>contrarrestadas	k o n t ɾ a r e s t a d a s
<|SPA|>desintegrar	d e s i n t e ɡ ɾ a ɾ
<|SPA|>germanio	x e ɾ m a n j o
<|SPA|>hanguear	a n ɡ e a ɾ
<|SPA|>fariano	f a ɾ j a n o
<|SPA|>adores	a d o ɾ e s
<|SPA|>presupuestario	p ɾ e s u p w e s t a ɾ j o
<|SPA|>Fani	f a n i
<|SPA|>disparado	d i s p a ɾ a d o
<|SPA|>aduana	a d w a n a
<|SPA|>abluidas	a b l w i d a s
<|SPA|>amillararemos	a m i ʝ a ɾ a ɾ e m o s
<|SPA|>lamentaste	l a m e n t a s t e
<|SPA|>detectados	d e t e ɡ t a d o s
<|SPA|>indumentaria	i n d u m e n t a ɾ j a
<|SPA|>alcano	a l k a n o
<|SPA|>góndola	ɡ o n d o l a
<|SPA|>brótola	b ɾ o t o l a
<|SPA|>reintensificado	r e i n t e n s i f i k a d o
<|SPA|>pisamos	p i s a m o s
<|SPA|>cantalupo	k a n t a l u p o
<|SPA|>premeditar	p ɾ e m e d i t a ɾ
<|SPA|>pegón	p e ɡ o n
<|SPA|>espectrómetros	e s p e ɡ t ɾ o m e t ɾ o s
<|SPA|>empapelar	e m p a p e l a ɾ
<|SPA|>lisosómico	l i s o s o m i k o
<|SPA|>llamarlos	ʝ a m a ɾ l o s
<|SPA|>temblequeado	t e m b l e k e a d o
<|SPA|>alojara	a l o x a ɾ a
<|SPA|>pavo	p a b o
<|SPA|>aireadas	a i ɾ e a d a s
<|SPA|>Cauquenes	k a u k e n e s
<|SPA|>variables	b a ɾ j a b l e s
<|SPA|>carcanapire	k a ɾ k a n a p i ɾ e
<|SPA|>designado	d e s i ɡ n a d o
<|SPA|>garabateada	ɡ a ɾ a b a t e a d a
<|SPA|>vermiculadas	b e ɾ m i k u l a d a s
<|SPA|>consensuar	k o n s e n s w a ɾ
<|SPA|>deambuladas	d e a m b u l a d a s
<|SPA|>oncohematológico	o n k o e m a t o l o x i k o
<|SPA|>juguetonamente	x u ɡ e ˌt o n a m e n t e
<|SPA|>monoaural	m o n o a u ɾ a l
<|SPA|>desvirtuados	d e s b i ɾ t w a d o s
<|SPA|>elegible	e l e x i b l e
<|SPA|>fontanería	f o n t a n e ɾ i a
<|SPA|>semisedentario	s e m i s e d e n t a ɾ j o
<|SPA|>ecléctico	e k l e ɡ t i k o
<|SPA|>caed	k a e d
<|SPA|>volcadas	b o l k a d a s
<|SPA|>prestatario	p ɾ e s t a t a ɾ j o
<|SPA|>coreografiar	k o ɾ e o ɡ ɾ a f j a ɾ
<|SPA|>okapi	o k a p i
<|SPA|>riñón	r i ɲ o n
<|SPA|>reinona	r e i n o n a
<|SPA|>encantadores	e n k a n t a d o ɾ e s
<|SPA|>galio	ɡ a l j o
<|SPA|>babélica	b a b e l i k a
<|SPA|>superaremos	s u p e ɾ a ɾ e m o s
<|SPA|>amenguados	a m e n ɡ w a d o s
<|SPA|>hipsómetros	i b s o m e t ɾ o s
<|SPA|>chele	t͡ʃ e l e
<|SPA|>elaborados	e l a b o ɾ a d o s
<|SPA|>continuando	k o n t i n w a n d o
<|SPA|>derribar	d e r i b a ɾ
<|SPA|>posesivos	p o s e s i b o s
<|SPA|>twittero	t w i t e ɾ o
<|SPA|>hidrográfico	i d ɾ o ɡ ɾ a f i k o
<|SPA|>vieran	b j e ɾ a n
<|SPA|>definiríamos	d e f i n i ɾ i a m o s
<|SPA|>torpedeados	t o ɾ p e d e a d o s
<|SPA|>criopreservadas	k ɾ j o p ɾ e s e ɾ b a d a s
<|SPA|>haríamos	a ɾ i a m o s
<|SPA|>chontaduro	t͡ʃ o n t a d u ɾ o
<|SPA|>engallar	e n ɡ a ʝ a ɾ
<|SPA|>andaos	a n d a o s
<|SPA|>depilar	d e p i l a ɾ
<|SPA|>dialogadas	d j a l o ɡ a d a s
<|SPA|>tened	t e n e d
<|SPA|>atutía	a t u t i a
<|SPA|>sobrescribir	s o b ɾ e s k ɾ i b i ɾ
<|SPA|>Donaire	d o n a i ɾ e
<|SPA|>aviará	a b j a ɾ a
<|SPA|>multáramos	m u l t a ɾ a m o s
<|SPA|>numerable	n u m e ɾ a b l e
<|SPA|>oleados	o l e a d o s
<|SPA|>Goliat	ɡ o l j a t
<|SPA|>tardadas	t a ɾ d a d a s
<|SPA|>sacristía	s a k ɾ i s t i a
<|SPA|>aglomeradas	a ɡ l o m e ɾ a d a s
<|SPA|>sunroof	s a n r u f
<|SPA|>peligro	p e l i ɡ ɾ o
<|SPA|>arraigar	a r a i ɡ a ɾ
<|SPA|>jacau	x a k a u
<|SPA|>codifiques	k o d i f i k e s
<|SPA|>IFE	i f e
<|SPA|>escavar	e s k a b a ɾ
<|SPA|>autómata	a u t o m a t a
<|SPA|>difractada	d i f ɾ a ɡ t a d a
<|SPA|>padouca	p a d o u k a
<|SPA|>koala	k o a l a
<|SPA|>compensadas	k o m p e n s a d a s
<|SPA|>desincorporar	d e s i n k o ɾ p o ɾ a ɾ
<|SPA|>confesora	k o n f e s o ɾ a
<|SPA|>villalbés	b i ʝ a l b e s
<|SPA|>impetrado	i m p e t ɾ a d o
<|SPA|>alcaldada	a l k a l d a d a
<|SPA|>tascó	t a s k o
<|SPA|>archivado	a ɾ t͡ʃ i b a d o
<|SPA|>achorar	a t͡ʃ o ɾ a ɾ
<|SPA|>posibles	p o s i b l e s
<|SPA|>abarrares	a b a r a ɾ e s
<|SPA|>amohinadas	a m o i n a d a s
<|SPA|>tururú	t u ɾ u ɾ u
<|SPA|>atravesar	a t ɾ a b e s a ɾ
<|SPA|>sobresaltadas	s o b ɾ e s a l t a d a s
<|SPA|>abacoras	a b a k o ɾ a s
<|SPA|>aserrados	a s e r a d o s
<|SPA|>compurgar	k o m p u ɾ ɡ a ɾ
<|SPA|>chingongo	t͡ʃ i n ɡ o n ɡ o
<|SPA|>fondeados	f o n d e a d o s
<|SPA|>modifico	m o d i f i k o
<|SPA|>supuesto	s u p w e s t o
<|SPA|>presa	p ɾ e s a
<|SPA|>acostaste	a k o s t a s t e
<|SPA|>súcubo	s u k u b o
<|SPA|>intervalo	i n t e ɾ b a l o
<|SPA|>psicofisiología	s i k o f i s j o l o x i a
<|SPA|>encanijar	e n k a n i x a ɾ
<|SPA|>desgarrante	d e s ɡ a r a n t e
<|SPA|>agusánese	a ɡ u s a n e s e
<|SPA|>coescriptas	k o e s k ɾ i b t a s
<|SPA|>Blas	b l a s
<|SPA|>bamba	b a m b a
<|SPA|>trastabillear	t ɾ a s t a b i ʝ e a ɾ
<|SPA|>tortures	t o ɾ t u ɾ e s
<|SPA|>penco	p e n k o
<|SPA|>envolver	e m b o l b e ɾ
<|SPA|>mixturamos	m i ɡ s t u ɾ a m o s
<|SPA|>caricatures	k a ɾ i k a t u ɾ e s
<|SPA|>periquitos	p e ɾ i k i t o s
<|SPA|>abreviara	a b ɾ e b j a ɾ a
<|SPA|>desclasificado	d e s k l a s i f i k a d o
<|SPA|>guiñadas	ɡ i ɲ a d a s
<|SPA|>gobernados	ɡ o b e ɾ n a d o s
<|SPA|>hilandera	i l a n d e ɾ a
<|SPA|>conjuntadas	k o n x u n t a d a s
<|SPA|>administráramos	a d m i n i s t ɾ a ɾ a m o s
<|SPA|>alguien	a l ɡ j e n
<|SPA|>cabreada	k a b ɾ e a d a
<|SPA|>Alexandrescu	a l e ɡ s a n d ɾ e s k u
<|SPA|>varsoviano	b a ɾ s o b j a n o
<|SPA|>monárquica	m o n a ɾ k i k a
<|SPA|>pastes	p a s t e s
<|SPA|>influjo	i n f l u x o
<|SPA|>dietilo	d j e t i l o
<|SPA|>desprotegida	d e s p ɾ o t e x i d a
<|SPA|>coordinadas	k o o ɾ d i n a d a s
<|SPA|>remoloneada	r e m o l o n e a d a
<|SPA|>petipuá	p e t i p w a
<|SPA|>evangelio	e b a n x e l j o
<|SPA|>fosforosa	f o s f o ɾ o s a
<|SPA|>chaquetita	t͡ʃ a k e t i t a
<|SPA|>copada	k o p a d a
<|SPA|>Argentina	a ɾ x e n t i n a
<|SPA|>brie	b ɾ i
<|SPA|>legítima	l e x i t i m a
<|SPA|>matas	m a t a s
<|SPA|>vételo	b e t e l o
<|SPA|>coexista	k o e ɡ s i s t a
<|SPA|>restauraste	r e s t a u ɾ a s t e
<|SPA|>afiebrada	a f j e b ɾ a d a
<|SPA|>fundidas	f u n d i d a s
<|SPA|>englobadas	e n ɡ l o b a d a s
<|SPA|>argüimos	a ɾ ɡ w i m o s
<|SPA|>inhabitable	i n a b i t a b l e
<|SPA|>invernaderos	i m b e ɾ n a d e ɾ o s
<|SPA|>hipovolémicas	i p o b o l e m i k a s
<|SPA|>fenghuang	f e n x w a n
<|SPA|>próximo	p ɾ o ɡ s i m o
<|SPA|>marihuanas	m a ɾ i w a n a s
<|SPA|>estrafalario	e s t ɾ a f a l a ɾ j o
<|SPA|>portera	p o ɾ t e ɾ a
<|SPA|>laudados	l a u d a d o s
<|SPA|>reseñada	r e s e ɲ a d a
<|SPA|>desabejar	d e s a b e x a ɾ
<|SPA|>vedarte	b e d a ɾ t e
<|SPA|>angostados	a n ɡ o s t a d o s
<|SPA|>hablémoos	a b l e m o o s
<|SPA|>suyos	s u ʝ o s
<|SPA|>repoblar	r e p o b l a ɾ
<|SPA|>tatuada	t a t w a d a
<|SPA|>protesta	p ɾ o t e s t a
<|SPA|>culito	k u l i t o
<|SPA|>enjertal	e n x e ɾ t a l
<|SPA|>enfriadas	e n f ɾ j a d a s
<|SPA|>prontito	p ɾ o n t i t o
<|SPA|>guardoso	ɡ w a ɾ d o s o
<|SPA|>diletante	d i l e t a n t e
<|SPA|>radal	r a d a l
<|SPA|>atenido	a t e n i d o
<|SPA|>comilón	k o m i l o n
<|SPA|>alegal	a l e ɡ a l
<|SPA|>gloriareis	ɡ l o ɾ j a ɾ e i s
<|SPA|>acondroplasia	a k o n d ɾ o p l a s j a
<|SPA|>debías	d e b i a s
<|SPA|>esculpida	e s k u l p i d a
<|SPA|>normativismo	n o ɾ m a t i b i s m o
<|SPA|>pesqueras	p e s k e ɾ a s
<|SPA|>guayadas	ɡ w a ʝ a d a s
<|SPA|>pajúos	p a x u o s
<|SPA|>cantémoslos	k a n t e m o s l o s
<|SPA|>ulco	u l k o
<|SPA|>abaluartares	a b a l w a ɾ t a ɾ e s
<|SPA|>intelectualismo	i n t e l e ɡ t w a l i s m o
<|SPA|>viéndote	b j e n d o t e
<|SPA|>asolada	a s o l a d a
<|SPA|>senador	s e n a d o ɾ
<|SPA|>rematado	r e m a t a d o
<|SPA|>desdoblado	d e s d o b l a d o
<|SPA|>fiteogeográfico	f i t e o x e o ɡ ɾ a f i k o
<|SPA|>inexplicables	i n e ɡ s p l i k a b l e s
<|SPA|>mostrará	m o s t ɾ a ɾ a
<|SPA|>robre	r o b ɾ e
<|SPA|>procurares	p ɾ o k u ɾ a ɾ e s
<|SPA|>respiras	r e s p i ɾ a s
<|SPA|>extraacadémica	e ɡ s t ɾ a a k a d e m i k a
<|SPA|>liberta	l i b e ɾ t a
<|SPA|>troglodítica	t ɾ o ɡ l o d i t i k a
<|SPA|>pastito	p a s t i t o
<|SPA|>dihueñe	d i w e ɲ e
<|SPA|>trasliteradas	t ɾ a s l i t e ɾ a d a s
<|SPA|>sugestionable	s u x e s t j o n a b l e
<|SPA|>decretadas	d e k ɾ e t a d a s
<|SPA|>reverberaréis	r e b e ɾ b e ɾ a ɾ e i s
<|SPA|>limada	l i m a d a
<|SPA|>siútico	s j u t i k o
<|SPA|>anglocatólica	a n ɡ l o k a t o l i k a
<|SPA|>bebería	b e b e ɾ i a
<|SPA|>bonificadas	b o n i f i k a d a s
<|SPA|>persistidas	p e ɾ s i s t i d a s
<|SPA|>connatural	k o n n a t u ɾ a l
<|SPA|>desvividas	d e s b i b i d a s
<|SPA|>psicosomático	s i k o s o m a t i k o
<|SPA|>donas	d o n a s
<|SPA|>indivisibilidad	i n d i b i s i b i l i d a d
<|SPA|>trebolito	t ɾ e b o l i t o
<|SPA|>abrevadero	a b ɾ e b a d e ɾ o
<|SPA|>aquilón	a k i l o n
<|SPA|>palladiano	p a ʝ a d j a n o
<|SPA|>hubiese	u b j e s e
<|SPA|>cajón	k a x o n
<|SPA|>humita	u m i t a
<|SPA|>disuadida	d i s w a d i d a
<|SPA|>actitudinal	a ɡ t i t u d i n a l
<|SPA|>astragalinos	a s t ɾ a ɡ a l i n o s
<|SPA|>indisimulada	i n d i s i m u l a d a
<|SPA|>recurvadas	r e k u ɾ b a d a s
<|SPA|>égloga	e ɡ l o ɡ a
<|SPA|>debámosla	d e b a m o s l a
<|SPA|>polígloto	p o l i ɡ l o t o
<|SPA|>respiré	r e s p i ɾ e
<|SPA|>bregue	b ɾ e ɡ e
<|SPA|>bohrio	b o ɾ j o
<|SPA|>michoacanos	m i t͡ʃ o a k a n o s
<|SPA|>fonsadera	f o n s a d e ɾ a
<|SPA|>cantándoles	k a n t a n d o l e s
<|SPA|>amariconado	a m a ɾ i k o n a d o
<|SPA|>alumbre	a l u m b ɾ e
<|SPA|>general	x e n e ɾ a l
<|SPA|>régimen	r e x i m e n
<|SPA|>carintia	k a ɾ i n t j a
<|SPA|>vestido	b e s t i d o
<|SPA|>contestatario	k o n t e s t a t a ɾ j o
<|SPA|>cromatográficos	k ɾ o m a t o ɡ ɾ a f i k o s
<|SPA|>inaudible	i n a u d i b l e
<|SPA|>escudriñadores	e s k u d ɾ i ɲ a d o ɾ e s
<|SPA|>prístinas	p ɾ i s t i n a s
<|SPA|>subsumido	s u b s u m i d o
<|SPA|>hasta	a s t a
<|SPA|>germanísticos	x e ɾ m a n i s t i k o s
<|SPA|>Lisandro	l i s a n d ɾ o
<|SPA|>arlequinado	a ɾ l e k i n a d o
<|SPA|>seríamos	s e ɾ i a m o s
<|SPA|>oviraptorosaurio	o b i ɾ a b t o ɾ o s a u ɾ j o
<|SPA|>transcurrido	t ɾ a n s k u r i d o
<|SPA|>abjurando	a b x u ɾ a n d o
<|SPA|>eufemísticas	e u f e m i s t i k a s
<|SPA|>laudo	l a u d o
<|SPA|>falafel	f a l a f e l
<|SPA|>acunados	a k u n a d o s
<|SPA|>pornificar	p o ɾ n i f i k a ɾ
<|SPA|>Tarso	t a ɾ s o
<|SPA|>fichados	f i t͡ʃ a d o s
<|SPA|>Merino	m e ɾ i n o
<|SPA|>Inesita	i n e s i t a
<|SPA|>admire	a d m i ɾ e
<|SPA|>carteadas	k a ɾ t e a d a s
<|SPA|>incorpóreos	i n k o ɾ p o ɾ e o s
<|SPA|>titiriteadlo	t i t i ɾ i t e a d l o
<|SPA|>consellera	k o n s e ʝ e ɾ a
<|SPA|>acatados	a k a t a d o s
<|SPA|>inventes	i m b e n t e s
<|SPA|>quimioterápico	k i m j o t e ɾ a p i k o
<|SPA|>profanidad	p ɾ o f a n i d a d
<|SPA|>torturadas	t o ɾ t u ɾ a d a s
<|SPA|>paniaguado	p a n j a ɡ w a d o
<|SPA|>pinillos	p i n i ʝ o s
<|SPA|>charquito	t͡ʃ a ɾ k i t o
<|SPA|>cloroalquino	k l o ɾ o a l k i n o
<|SPA|>quitadas	k i t a d a s
<|SPA|>virareis	b i ɾ a ɾ e i s
<|SPA|>pulcros	p u l k ɾ o s
<|SPA|>fiques	f i k e s
<|SPA|>avíape	a b i a p e
<|SPA|>consejera	k o n s e x e ɾ a
<|SPA|>nefríticos	n e f ɾ i t i k o s
<|SPA|>dominiquesa	d o m i n i k e s a
<|SPA|>descarboxiladas	d e s k a ɾ b o ɡ s i l a d a s
<|SPA|>alienante	a l j e n a n t e
<|SPA|>colegida	k o l e x i d a
<|SPA|>flan	f l a n
<|SPA|>habiéndoos	a b j e n d o o s
<|SPA|>tirrena	t i r e n a
<|SPA|>punibilidad	p u n i b i l i d a d
<|SPA|>esteparia	e s t e p a ɾ j a
<|SPA|>junte	x u n t e
<|SPA|>asperjados	a s p e ɾ x a d o s
<|SPA|>fagosoma	f a ɡ o s o m a
<|SPA|>acompañada	a k o m p a ɲ a d a
<|SPA|>respuesta	r e s p w e s t a
<|SPA|>evitar	e b i t a ɾ
<|SPA|>naturalidad	n a t u ɾ a l i d a d
<|SPA|>encharcado	e n t͡ʃ a ɾ k a d o
<|SPA|>seamos	s e a m o s
<|SPA|>ricos	r i k o s
<|SPA|>aplicable	a p l i k a b l e
<|SPA|>hiperpotasemias	i p e ɾ p o t a s e m j a s
<|SPA|>abreviadas	a b ɾ e b j a d a s
<|SPA|>carpetana	k a ɾ p e t a n a
<|SPA|>vagues	b a ɡ e s
<|SPA|>vallada	b a ʝ a d a
<|SPA|>mefistofélico	m e f i s t o f e l i k o
<|SPA|>tartamudeada	t a ɾ t a m u d e a d a
<|SPA|>gerontología	x e ɾ o n t o l o x i a
<|SPA|>nefarias	n e f a ɾ j a s
<|SPA|>unir	u n i ɾ
<|SPA|>develado	d e b e l a d o
<|SPA|>antiindustrial	a n t i i n d u s t ɾ j a l
<|SPA|>adiabático	a d j a b a t i k o
<|SPA|>mediodía	m e d j o d i a
<|SPA|>medallita	m e d a ʝ i t a
<|SPA|>aditividad	a d i t i b i d a d
<|SPA|>pterodactiloide	t e ɾ o d a ɡ t i l o i d e
<|SPA|>empoderante	e m p o d e ɾ a n t e
<|SPA|>recua	r e k w a
<|SPA|>desintegrativos	d e s i n t e ɡ ɾ a t i b o s
<|SPA|>escoltada	e s k o l t a d a
<|SPA|>despeinado	d e s p e i n a d o
<|SPA|>proamericanas	p ɾ o a m e ɾ i k a n a s
<|SPA|>acojonada	a k o x o n a d a
<|SPA|>Turín	t u ɾ i n
<|SPA|>resguardo	r e s ɡ w a ɾ d o
<|SPA|>horado	o ɾ a d o
<|SPA|>lamelar	l a m e l a ɾ
<|SPA|>fincares	f i n k a ɾ e s
<|SPA|>gotita	ɡ o t i t a
<|SPA|>banquetear	b a n k e t e a ɾ
<|SPA|>íncola	i n k o l a
<|SPA|>cronométrico	k ɾ o n o m e t ɾ i k o
<|SPA|>banco	b a n k o
<|SPA|>endospora	e n d o s p o ɾ a
<|SPA|>solarás	s o l a ɾ a s
<|SPA|>acabás	a k a b a s
<|SPA|>chapoteados	t͡ʃ a p o t e a d o s
<|SPA|>hablémoslos	a b l e m o s l o s
<|SPA|>pentavalente	p e n t a b a l e n t e
<|SPA|>ser	s e ɾ
<|SPA|>tristura	t ɾ i s t u ɾ a
<|SPA|>genuino	x e n w i n o
<|SPA|>guíes	ɡ i e s
<|SPA|>tuiteados	t w i t e a d o s
<|SPA|>alfaque	a l f a k e
<|SPA|>bisemanal	b i s e m a n a l
<|SPA|>despeñados	d e s p e ɲ a d o s
<|SPA|>despistado	d e s p i s t a d o
<|SPA|>puerquita	p w e ɾ k i t a
<|SPA|>sincopar	s i n k o p a ɾ
<|SPA|>Gamba	ɡ a m b a
<|SPA|>xerofítico	s e ɾ o f i t i k o
<|SPA|>peraltadas	p e ɾ a l t a d a s
<|SPA|>bailotear	b a i l o t e a ɾ
<|SPA|>amillaráremos	a m i ʝ a ɾ a ɾ e m o s
<|SPA|>comámosles	k o m a m o s l e s
<|SPA|>santaneco	s a n t a n e k o
<|SPA|>sufragados	s u f ɾ a ɡ a d o s
<|SPA|>machadiana	m a t͡ʃ a d j a n a
<|SPA|>lechuguero	l e t͡ʃ u ɡ e ɾ o
<|SPA|>sí	s i
<|SPA|>derribo	d e r i b o
<|SPA|>marinado	m a ɾ i n a d o
<|SPA|>frustres	f ɾ u s t ɾ e s
<|SPA|>encasquillada	e n k a s k i ʝ a d a
<|SPA|>partido	p a ɾ t i d o
<|SPA|>cromosoma	k ɾ o m o s o m a
<|SPA|>incoar	i n k o a ɾ
<|SPA|>moribunda	m o ɾ i b u n d a
<|SPA|>auditivos	a u d i t i b o s
<|SPA|>cabás	k a b a s
<|SPA|>urbano	u ɾ b a n o
<|SPA|>avarienta	a b a ɾ j e n t a
<|SPA|>multidispositivo	m u l t i d i s p o s i t i b o
<|SPA|>chapó	t͡ʃ a p o
<|SPA|>catecúmena	k a t e k u m e n a
<|SPA|>autoalimentados	a u t o a l i m e n t a d o s
<|SPA|>amnésica	a m n e s i k a
<|SPA|>retractados	r e t ɾ a ɡ t a d o s
<|SPA|>patriótico	p a t ɾ j o t i k o
<|SPA|>panal	p a n a l
<|SPA|>sobrerrepresentaría	s o b ɾ e r e p ɾ e s e n t a ɾ i a
<|SPA|>segurados	s e ɡ u ɾ a d o s
<|SPA|>prevaricadoras	p ɾ e b a ɾ i k a d o ɾ a s
<|SPA|>jamelga	x a m e l ɡ a
<|SPA|>compensaras	k o m p e n s a ɾ a s
<|SPA|>sajado	s a x a d o
<|SPA|>birminghense	b i ɾ m i n ɡ e n s e
<|SPA|>fotografiado	f o t o ɡ ɾ a f j a d o
<|SPA|>boyero	b o ʝ e ɾ o
<|SPA|>arponados	a ɾ p o n a d o s
<|SPA|>desaprovechada	d e s a p ɾ o b e t͡ʃ a d a
<|SPA|>seriaremos	s e ɾ j a ɾ e m o s
<|SPA|>inconcreto	i n k o n k ɾ e t o
<|SPA|>irritadas	i r i t a d a s
<|SPA|>cuidando	k w i d a n d o
<|SPA|>premiaríamos	p ɾ e m j a ɾ i a m o s
<|SPA|>diabólicos	d j a b o l i k o s
<|SPA|>fermentaríamos	f e ɾ m e n t a ɾ i a m o s
<|SPA|>sangría	s a n ɡ ɾ i a
<|SPA|>empleador	e m p l e a d o ɾ
<|SPA|>rescatadas	r e s k a t a d a s
<|SPA|>conejillo	k o n e x i ʝ o
<|SPA|>conmutados	k o m m u t a d o s
<|SPA|>barda	b a ɾ d a
<|SPA|>androide	a n d ɾ o i d e
<|SPA|>acopiada	a k o p j a d a
<|SPA|>enología	e n o l o x i a
<|SPA|>galés	ɡ a l e s
<|SPA|>viudita	b j u d i t a
<|SPA|>desinteresado	d e s i n t e ɾ e s a d o
<|SPA|>védate	b e d a t e
<|SPA|>pituco	p i t u k o
<|SPA|>opaca	o p a k a
<|SPA|>eslabonamiento	e s l a b o n a m j e n t o
<|SPA|>transparentada	t ɾ a n s p a ɾ e n t a d a
<|SPA|>fincados	f i n k a d o s
<|SPA|>estrechas	e s t ɾ e t͡ʃ a s
<|SPA|>agremiados	a ɡ ɾ e m j a d o s
<|SPA|>ubérrimos	u b e r i m o s
<|SPA|>termine	t e ɾ m i n e
<|SPA|>chompa	t͡ʃ o m p a
<|SPA|>tacleado	t a k l e a d o
<|SPA|>desatendidas	d e s a t e n d i d a s
<|SPA|>sobrevalorados	s o b ɾ e b a l o ɾ a d o s
<|SPA|>obsequiada	o b s e k j a d a
<|SPA|>cagarse	k a ɡ a ɾ s e
<|SPA|>decano	d e k a n o
<|SPA|>henchida	e n t͡ʃ i d a
<|SPA|>sarga	s a ɾ ɡ a
<|SPA|>estarles	e s t a ɾ l e s
<|SPA|>verija	b e ɾ i x a
<|SPA|>destupir	d e s t u p i ɾ
<|SPA|>seísmo	s e i s m o
<|SPA|>arará	a ɾ a ɾ a
<|SPA|>chinchilla	t͡ʃ i n t͡ʃ i ʝ a
<|SPA|>Espinal	e s p i n a l
<|SPA|>ubérrimo	u b e r i m o
<|SPA|>catán	k a t a n
<|SPA|>alcaide	a l k a i d e
<|SPA|>rabel	r a b e l
<|SPA|>pesquise	p e s k i s e
<|SPA|>extensas	e ɡ s t e n s a s
<|SPA|>bastir	b a s t i ɾ
<|SPA|>resaltar	r e s a l t a ɾ
<|SPA|>trancares	t ɾ a n k a ɾ e s
<|SPA|>contenidos	k o n t e n i d o s
<|SPA|>envidioso	e m b i d j o s o
<|SPA|>dividimos	d i b i d i m o s
<|SPA|>prosterná	p ɾ o s t e ɾ n a
<|SPA|>nativa	n a t i b a
<|SPA|>paulino	p a u l i n o
<|SPA|>polimorfa	p o l i m o ɾ f a
<|SPA|>redescubierto	r e d e s k u b j e ɾ t o
<|SPA|>prendidos	p ɾ e n d i d o s
<|SPA|>chasqueado	t͡ʃ a s k e a d o
<|SPA|>rasgueado	r a s ɡ e a d o
<|SPA|>secretada	s e k ɾ e t a d a
<|SPA|>ska	s k a
<|SPA|>cosmovisión	k o s m o b i s j o n
<|SPA|>tituláramos	t i t u l a ɾ a m o s
<|SPA|>marchadas	m a ɾ t͡ʃ a d a s
<|SPA|>ola	o l a
<|SPA|>pop	p o p
<|SPA|>asamblea	a s a m b l e a
<|SPA|>abstuvieren	a b s t u b j e ɾ e n
<|SPA|>quintacolumnista	k i n t a k o l u m n i s t a
<|SPA|>aclimata	a k l i m a t a
<|SPA|>obliterareis	o b l i t e ɾ a ɾ e i s
<|SPA|>babeado	b a b e a d o
<|SPA|>estereotípicos	e s t e ɾ e o t i p i k o s
<|SPA|>otosclerosis	o t o s k l e ɾ o s i s
<|SPA|>váyanla	b a ʝ a n l a
<|SPA|>lentificado	l e n t i f i k a d o
<|SPA|>perpetua	p e ɾ p e t w a
<|SPA|>Kosovo	k o s o b o
<|SPA|>enfangados	e n f a n ɡ a d o s
<|SPA|>administraste	a d m i n i s t ɾ a s t e
<|SPA|>autenticadas	a u t e n t i k a d a s
<|SPA|>tetradimensionales	t e t ɾ a d i m e n s j o n a l e s
<|SPA|>austera	a u s t e ɾ a
<|SPA|>soleada	s o l e a d a
<|SPA|>ruteo	r u t e o
<|SPA|>maquinistas	m a k i n i s t a s
<|SPA|>usuaria	u s w a ɾ j a
<|SPA|>rogará	r o ɡ a ɾ a
<|SPA|>casto	k a s t o
<|SPA|>definimos	d e f i n i m o s
<|SPA|>pernoctar	p e ɾ n o ɡ t a ɾ
<|SPA|>fauna	f a u n a
<|SPA|>interétnicos	i n t e ɾ e d n i k o s
<|SPA|>eufemísticos	e u f e m i s t i k o s
<|SPA|>Septuaginta	s e b t w a x i n t a
<|SPA|>cuatrimestral	k w a t ɾ i m e s t ɾ a l
<|SPA|>honrilla	o n r i ʝ a
<|SPA|>ambivalente	a m b i b a l e n t e
<|SPA|>motilón	m o t i l o n
<|SPA|>reverendo	r e b e ɾ e n d o
<|SPA|>legalidad	l e ɡ a l i d a d
<|SPA|>gernikarra	x e ɾ n i k a r a
<|SPA|>inesperado	i n e s p e ɾ a d o
<|SPA|>acabémosla	a k a b e m o s l a
<|SPA|>catadióptrico	k a t a d j o b t ɾ i k o
<|SPA|>anatomía	a n a t o m i a
<|SPA|>estenos	e s t e n o s
<|SPA|>suegra	s w e ɡ ɾ a
<|SPA|>esgrimidor	e s ɡ ɾ i m i d o ɾ
<|SPA|>comidilla	k o m i d i ʝ a
<|SPA|>pseudohistoria	s e u d o i s t o ɾ j a
<|SPA|>cantante	k a n t a n t e
<|SPA|>emisión	e m i s j o n
<|SPA|>musicología	m u s i k o l o x i a
<|SPA|>purgado	p u ɾ ɡ a d o
<|SPA|>romboide	r o m b o i d e
<|SPA|>modelando	m o d e l a n d o
<|SPA|>ambientadores	a m b j e n t a d o ɾ e s
<|SPA|>piquito	p i k i t o
<|SPA|>rebobinar	r e b o b i n a ɾ
<|SPA|>quebradita	k e b ɾ a d i t a
<|SPA|>autonomista	a u t o n o m i s t a
<|SPA|>abastardé	a b a s t a ɾ d e
<|SPA|>orlará	o ɾ l a ɾ a
<|SPA|>golpismo	ɡ o l p i s m o
<|SPA|>ostión	o s t j o n
<|SPA|>hidroeléctrico	i d ɾ o e l e ɡ t ɾ i k o
<|SPA|>augurada	a u ɡ u ɾ a d a
<|SPA|>crie	k ɾ j e
<|SPA|>agotado	a ɡ o t a d o
<|SPA|>lechoso	l e t͡ʃ o s o
<|SPA|>trombina	t ɾ o m b i n a
<|SPA|>bolardo	b o l a ɾ d o
<|SPA|>imantadas	i m a n t a d a s
<|SPA|>vetaste	b e t a s t e
<|SPA|>contractualista	k o n t ɾ a ɡ t w a l i s t a
<|SPA|>periné	p e ɾ i n e
<|SPA|>toltecas	t o l t e k a s
<|SPA|>cleriguito	k l e ɾ i ɡ i t o
<|SPA|>meditareis	m e d i t a ɾ e i s
<|SPA|>suélenla	s w e l e n l a
<|SPA|>tonificadas	t o n i f i k a d a s
<|SPA|>fermentaras	f e ɾ m e n t a ɾ a s
<|SPA|>anuario	a n w a ɾ j o
<|SPA|>bastitanas	b a s t i t a n a s
<|SPA|>xerografiados	s e ɾ o ɡ ɾ a f j a d o s
<|SPA|>baremados	b a ɾ e m a d o s
<|SPA|>rabanito	r a b a n i t o
<|SPA|>oliente	o l j e n t e
<|SPA|>temeos	t e m e o s
<|SPA|>diseminar	d i s e m i n a ɾ
<|SPA|>discrepadas	d i s k ɾ e p a d a s
<|SPA|>reposados	r e p o s a d o s
<|SPA|>empinemos	e m p i n e m o s
<|SPA|>posromántico	p o s r o m a n t i k o
<|SPA|>ladrones	l a d ɾ o n e s
<|SPA|>guadaña	ɡ w a d a ɲ a
<|SPA|>cunques	k u n k e s
<|SPA|>desajustada	d e s a x u s t a d a
<|SPA|>Valdemar	b a l d e m a ɾ
<|SPA|>hervida	e ɾ b i d a
<|SPA|>vidriadas	b i d ɾ j a d a s
<|SPA|>apuntillado	a p u n t i ʝ a d o
<|SPA|>afecta	a f e ɡ t a
<|SPA|>ternero	t e ɾ n e ɾ o
<|SPA|>comprensible	k o m p ɾ e n s i b l e
<|SPA|>granada	ɡ ɾ a n a d a
<|SPA|>humilladero	u m i ʝ a d e ɾ o
<|SPA|>sobrepujaremos	s o b ɾ e p u x a ɾ e m o s
<|SPA|>Mantua	m a n t w a
<|SPA|>pretendida	p ɾ e t e n d i d a
<|SPA|>escuincle	e s k w i n k l e
<|SPA|>declarares	d e k l a ɾ a ɾ e s
<|SPA|>cohetón	k o e t o n
<|SPA|>fomentémoste	f o m e n t e m o s t e
<|SPA|>distintiva	d i s t i n t i b a
<|SPA|>vituperar	b i t u p e ɾ a ɾ
<|SPA|>chufado	t͡ʃ u f a d o
<|SPA|>reconfiguradas	r e k o n f i ɡ u ɾ a d a s
<|SPA|>lalada	l a l a d a
<|SPA|>reparas	r e p a ɾ a s
<|SPA|>encasquetado	e n k a s k e t a d o
<|SPA|>mostraste	m o s t ɾ a s t e
<|SPA|>ecología	e k o l o x i a
<|SPA|>vetustense	b e t u s t e n s e
<|SPA|>jalapeño	x a l a p e ɲ o
<|SPA|>membranoproliferativo	m e m b ɾ a n o p ɾ o l i f e ɾ a t i b o
<|SPA|>actividades	a ɡ t i b i d a d e s
<|SPA|>agolpado	a ɡ o l p a d o
<|SPA|>tumor	t u m o ɾ
<|SPA|>jimia	x i m j a
<|SPA|>capirote	k a p i ɾ o t e
<|SPA|>resanar	r e s a n a ɾ
<|SPA|>suinos	s w i n o s
<|SPA|>derrochador	d e r o t͡ʃ a d o ɾ
<|SPA|>escamocha	e s k a m o t͡ʃ a
<|SPA|>autótrofo	a u t o t ɾ o f o
<|SPA|>absuelto	a b s w e l t o
<|SPA|>caben	k a b e n
<|SPA|>extracapilares	e ɡ s t ɾ a k a p i l a ɾ e s
<|SPA|>autodestruidas	a u t o d e s t ɾ w i d a s
<|SPA|>emulsionada	e m u l s j o n a d a
<|SPA|>aparo	a p a ɾ o
<|SPA|>partamos	p a ɾ t a m o s
<|SPA|>reintensificada	r e i n t e n s i f i k a d a
<|SPA|>ofrenda	o f ɾ e n d a
<|SPA|>husmeada	u s m e a d a
<|SPA|>tirará	t i ɾ a ɾ a
<|SPA|>domareis	d o m a ɾ e i s
<|SPA|>duche	d u t͡ʃ e
<|SPA|>jauría	x a u ɾ i a
<|SPA|>arquitecto	a ɾ k i t e ɡ t o
<|SPA|>onagro	o n a ɡ ɾ o
<|SPA|>reprochamos	r e p ɾ o t͡ʃ a m o s
<|SPA|>languor	l a n ɡ w o ɾ
<|SPA|>columbradas	k o l u m b ɾ a d a s
<|SPA|>esponjosos	e s p o n x o s o s
<|SPA|>premedita	p ɾ e m e d i t a
<|SPA|>herbolarias	e ɾ b o l a ɾ j a s
<|SPA|>pisón	p i s o n
<|SPA|>desproveyera	d e s p ɾ o b e ʝ e ɾ a
<|SPA|>organismo	o ɾ ɡ a n i s m o
<|SPA|>autolesionada	a u t o l e s j o n a d a
<|SPA|>colicorto	k o l i k o ɾ t o
<|SPA|>parador	p a ɾ a d o ɾ
<|SPA|>frecuentadora	f ɾ e k w e n t a d o ɾ a
<|SPA|>voleada	b o l e a d a
<|SPA|>guineoecuatorial	ɡ i n e o e k w a t o ɾ j a l
<|SPA|>desensillar	d e s e n s i ʝ a ɾ
<|SPA|>desprestigiado	d e s p ɾ e s t i x j a d o
<|SPA|>dentudo	d e n t u d o
<|SPA|>cofre	k o f ɾ e
<|SPA|>guapo	ɡ w a p o
<|SPA|>superpremiado	s u p e ɾ p ɾ e m j a d o
<|SPA|>comilonas	k o m i l o n a s
<|SPA|>asará	a s a ɾ a
<|SPA|>soláis	s o l a i s
<|SPA|>oaxaqueño	w̝ a x a k e ɲ o
<|SPA|>prevaricadora	p ɾ e b a ɾ i k a d o ɾ a
<|SPA|>seguradas	s e ɡ u ɾ a d a s
<|SPA|>lloriqueados	ʝ o ɾ i k e a d o s
<|SPA|>pellín	p e ʝ i n
<|SPA|>apocopa	a p o k o p a
<|SPA|>balleneras	b a ʝ e n e ɾ a s
<|SPA|>fosforilaremos	f o s f o ɾ i l a ɾ e m o s
<|SPA|>aguará	a ɡ w a ɾ a
<|SPA|>becuadro	b e k w a d ɾ o
<|SPA|>tolina	t o l i n a
<|SPA|>resoluto	r e s o l u t o
<|SPA|>profundamente	p ɾ o ˌf u n d a m e n t e
<|SPA|>inmunocomprometidos	i m m u n o k o m p ɾ o m e t i d o s
<|SPA|>hablándome	a b l a n d o m e
<|SPA|>atrofiará	a t ɾ o f j a ɾ a
<|SPA|>Piamonte	p j a m o n t e
<|SPA|>veámoslos	b e a m o s l o s
<|SPA|>colorada	k o l o ɾ a d a
<|SPA|>hierosolimitano	ʝ e ɾ o s o l i m i t a n o
<|SPA|>acompañamiento	a k o m p a ɲ a m j e n t o
<|SPA|>calda	k a l d a
<|SPA|>trilineal	t ɾ i l i n e a l
<|SPA|>et	e t
<|SPA|>abajadlo	a b a x a d l o
<|SPA|>remunerativo	r e m u n e ɾ a t i b o
<|SPA|>atas	a t a s
<|SPA|>desencadenador	d e s e n k a d e n a d o ɾ
<|SPA|>acuitados	a k w i t a d o s
<|SPA|>tírenla	t i ɾ e n l a
<|SPA|>estacados	e s t a k a d o s
<|SPA|>crac	k ɾ a k
<|SPA|>postulas	p o s t u l a s
<|SPA|>acuminadas	a k u m i n a d a s
<|SPA|>amistado	a m i s t a d o
<|SPA|>trasmontados	t ɾ a s m o n t a d o s
<|SPA|>putadita	p u t a d i t a
<|SPA|>gerontóloga	x e ɾ o n t o l o ɡ a
<|SPA|>diptongada	d i b t o n ɡ a d a
<|SPA|>bayuca	b a ʝ u k a
<|SPA|>horroroso	o r o ɾ o s o
<|SPA|>mansega	m a n s e ɡ a
<|SPA|>mandamiento	m a n d a m j e n t o
<|SPA|>puritanas	p u ɾ i t a n a s
<|SPA|>arbustiva	a ɾ b u s t i b a
<|SPA|>ningunos	n i n ɡ u n o s
<|SPA|>jadeados	x a d e a d o s
<|SPA|>joderla	x o d e ɾ l a
<|SPA|>sensatas	s e n s a t a s
<|SPA|>deteriorante	d e t e ɾ j o ɾ a n t e
<|SPA|>semiconductor	s e m i k o n d u ɡ t o ɾ
<|SPA|>discreteadas	d i s k ɾ e t e a d a s
<|SPA|>Cantórbery	k a n t o ɾ b e ɾ i
<|SPA|>restados	r e s t a d o s
<|SPA|>lubrifico	l u b ɾ i f i k o
<|SPA|>plebeyo	p l e b e ʝ o
<|SPA|>leoninas	l e o n i n a s
<|SPA|>definitivas	d e f i n i t i b a s
<|SPA|>cafeico	k a f e i k o
<|SPA|>polbero	p o l b e ɾ o
<|SPA|>desarbolar	d e s a ɾ b o l a ɾ
<|SPA|>apetitosa	a p e t i t o s a
<|SPA|>morfea	m o ɾ f e a
<|SPA|>fabrica	f a b ɾ i k a
<|SPA|>calumniosa	k a l u m n j o s a
<|SPA|>enrabietados	e n r a b j e t a d o s
<|SPA|>huno	u n o
<|SPA|>cascajo	k a s k a x o
<|SPA|>anteanoche	a n t e a n o t͡ʃ e
<|SPA|>bruñido	b ɾ u ɲ i d o
<|SPA|>vetaríamos	b e t a ɾ i a m o s
<|SPA|>mericarpio	m e ɾ i k a ɾ p j o
<|SPA|>convergidos	k o m b e ɾ x i d o s
<|SPA|>esculturales	e s k u l t u ɾ a l e s
<|SPA|>Angulo	a n ɡ u l o
<|SPA|>juglaresco	x u ɡ l a ɾ e s k o
<|SPA|>chulunca	t͡ʃ u l u n k a
<|SPA|>Marroquín	m a r o k i n
<|SPA|>precavidas	p ɾ e k a b i d a s
<|SPA|>recolectadas	r e k o l e ɡ t a d a s
<|SPA|>intuir	i n t w i ɾ
<|SPA|>cantarlas	k a n t a ɾ l a s
<|SPA|>vial	b j a l
<|SPA|>codesarrollado	k o d e s a r o ʝ a d o
<|SPA|>heparina	e p a ɾ i n a
<|SPA|>artesano	a ɾ t e s a n o
<|SPA|>fructífero	f ɾ u ɡ t i f e ɾ o
<|SPA|>columnela	k o l u m n e l a
<|SPA|>contestar	k o n t e s t a ɾ
<|SPA|>deputemos	d e p u t e m o s
<|SPA|>entesitis	e n t e s i t i s
<|SPA|>disyuntor	d i s ʝ u n t o ɾ
<|SPA|>funcar	f u n k a ɾ
<|SPA|>reputados	r e p u t a d o s
<|SPA|>gentilhombre	x e n t i l o m b ɾ e
<|SPA|>catinona	k a t i n o n a
<|SPA|>autotrófico	a u t o t ɾ o f i k o
<|SPA|>abastos	a b a s t o s
<|SPA|>epigástrico	e p i ɡ a s t ɾ i k o
<|SPA|>piquigualdo	p i k i ɡ w a l d o
<|SPA|>almodovarianos	a l m o d o b a ɾ j a n o s
<|SPA|>ruinado	r w i n a d o
<|SPA|>quemador	k e m a d o ɾ
<|SPA|>calabriadas	k a l a b ɾ j a d a s
<|SPA|>vapeadas	b a p e a d a s
<|SPA|>rácano	r a k a n o
<|SPA|>alojativo	a l o x a t i b o
<|SPA|>endotérmicos	e n d o t e ɾ m i k o s
<|SPA|>trasquilado	t ɾ a s k i l a d o
<|SPA|>estuvieses	e s t u b j e s e s
<|SPA|>clamadas	k l a m a d a s
<|SPA|>escarbador	e s k a ɾ b a d o ɾ
<|SPA|>indico	i n d i k o
<|SPA|>data	d a t a
<|SPA|>desdeñar	d e s d e ɲ a ɾ
<|SPA|>sacramento	s a k ɾ a m e n t o
<|RUM|>abatem	a b a t e m
<|RUM|>abile	a b i l e
<|RUM|>absurd	a b s u r d
<|RUM|>accept	a k t͡ʃ e p t
<|RUM|>această	a t͡ʃ e̯ a s t ə
<|RUM|>acei	a t͡ʃ e j
<|RUM|>acel	a t ʃ e l
<|RUM|>aceleași	a t͡ʃ e l e̯ a ʃʲ
<|RUM|>acest	a t͡ʃ e s t
<|RUM|>aceste	a t͡ʃ e s t e
<|RUM|>acestor	a t͡ʃ e s t o r
<|RUM|>acestui	a t͡ʃ e s t u j
<|RUM|>achiziție	a k i z i t͡s i e
<|RUM|>acolo	a k o l o
<|RUM|>acoperi	a k o p e r i
<|RUM|>activ	a k t i v
<|RUM|>acu	a k u
<|RUM|>acum	a k u m
<|RUM|>adesea	a d e s e̯ a
<|RUM|>administrat	a d m i n i s t r a t
<|RUM|>administrativ	a d m i n i s t r a t i v
<|RUM|>adopta	a d o p t a
<|RUM|>afișa	a f i ʃ a
<|RUM|>afla	a f l a
<|RUM|>afli	a f l i
<|RUM|>africa	a f r i k a
<|RUM|>agricol	a ɡ r i k o l
<|RUM|>aia	a j a
<|RUM|>aiurea	a j u r e̯ a
<|RUM|>ajuns	a ʒ u n s
<|RUM|>ajutor	a ʒ u t o r
<|RUM|>alb	a l b
<|RUM|>alba	a l b a
<|RUM|>ale	a l e
<|RUM|>alea	a l e̯ a
<|RUM|>alexandru	a l e k s a n d r u
<|RUM|>alina	a l i n a
<|RUM|>altceva	a l t t͡ʃ e v a
<|RUM|>alte	a l t e
<|RUM|>alterat	a l t e r a t
<|RUM|>altundeva	a l t u n d e v a
<|RUM|>altă	a l t ə
<|RUM|>am	a m
<|RUM|>amar	a m a r
<|RUM|>american	a m e r i k a n
<|RUM|>americani	a m e r i k a nʲ
<|RUM|>amic	a m i k
<|RUM|>amintească	a m i n t e̯ a s k ə
<|RUM|>amintesc	a m i n t e s k
<|RUM|>amintire	a m i n t i r e
<|RUM|>analizam	a n a l i z a m
<|RUM|>analizat	a n a l i z a t
<|RUM|>anexa	a n e k s a
<|RUM|>anormalitate	a n o r m a l i t a t e
<|RUM|>anotimp	a n o t i m p
<|RUM|>antic	a n t i k
<|RUM|>antonescu	a n t o n e s k u
<|RUM|>apa	a p a
<|RUM|>apartament	a p a r t a m e n t
<|RUM|>apei	a p e j
<|RUM|>apele	a p e l e
<|RUM|>apelor	a p e l o r
<|RUM|>aplicat	a p l i k a t
<|RUM|>apropie	a p r o p j e
<|RUM|>ar	a r
<|RUM|>arate	a r a t e
<|RUM|>arau	a r a w
<|RUM|>argint	a r d͡ʒ i n t
<|RUM|>arme	a r m e
<|RUM|>asupra	a s u p r a
<|RUM|>atac	a t a k
<|RUM|>ataca	a t a k a
<|RUM|>atacam	a t a k a m
<|RUM|>atacat	a t a k a t
<|RUM|>atent	a t e n t
<|RUM|>atinge	a t i n d͡ʒ e
<|RUM|>aur	a w r
<|RUM|>autobuz	a w t o b u z
<|RUM|>aviatoare	a v i a t o̯ a r e
<|RUM|>baba	b a b a
<|RUM|>baco	b a k o
<|RUM|>bag	b a ɡ
<|RUM|>baia	b a j a
<|RUM|>baie	b a j e
<|RUM|>balcanic	b a l k a n i k
<|RUM|>banda	b a n d a
<|RUM|>bate	b a t e
<|RUM|>batem	b a t e m
<|RUM|>benzi	b e n zʲ
<|RUM|>benzina	b e n z i n a
<|RUM|>bicicleta	b i t͡ʃ i k l e t a
<|RUM|>bidon	b i d o n
<|RUM|>bilet	b i l e t
<|RUM|>bine	b i n e
<|RUM|>biologic	b i o l o d͡ʒ i k
<|RUM|>bloc	b l o k
<|RUM|>blond	b l o n d
<|RUM|>boem	b o e m
<|RUM|>bogdan	b o ɡ d a n
<|RUM|>boli	b o lʲ
<|RUM|>bombe	b o m b e
<|RUM|>brazilia	b r a z i l i a
<|RUM|>brusc	b r u s k
<|RUM|>buc	b u k
<|RUM|>bucată	b u k a t ə
<|RUM|>bulgaria	b u l ɡ a r j a
<|RUM|>bun	b u n
<|RUM|>buni	b u nʲ
<|RUM|>bunic	b u n i k
<|RUM|>burlac	b u r l a k
<|RUM|>buze	b u z e
<|RUM|>buzunar	b u z u n a r
<|RUM|>bărbat	b ə r b a t
<|RUM|>caci	k a t͡ʃʲ
<|RUM|>cal	k a l
<|RUM|>calce	k a l t͡ʃ e
<|RUM|>calcul	k a l k u l
<|RUM|>canal	k a n a l
<|RUM|>canale	k a n a l e
<|RUM|>cap	k a p
<|RUM|>capete	k a p e t e
<|RUM|>capitală	k a p i t a l ə
<|RUM|>caracter	k a r a k t e r
<|RUM|>caracteristici	k a r a k t e r i s t i t͡ʃʲ
<|RUM|>care	k a r e
<|RUM|>cea	t͡ʃ e̯ a
<|RUM|>ceapa	t͡ʃ e̯ a p a
<|RUM|>ceara	t͡ʃ e̯ a r a
<|RUM|>ceară	t͡ʃ e̯ a r ə
<|RUM|>celebra	t͡ʃ e l e b ɾ a
<|RUM|>celebru	t͡ʃ e l e b r u
<|RUM|>cenzurat	t͡ʃ e n z u r a t
<|RUM|>cerc	t͡ʃ e r k
<|RUM|>cercetător	t͡ʃ e r t͡ʃ e t ə t o r
<|RUM|>cercuri	t͡ʃ e r k u rʲ
<|RUM|>cerere	t͡ʃ e r e r e
<|RUM|>cert	t͡ʃ e r t
<|RUM|>ceva	t͡ʃ e v a
<|RUM|>cheia	k e j a
<|RUM|>chiar	k j a r
<|RUM|>chinezi	k i n e zʲ
<|RUM|>chineză	c i n e z ə
<|RUM|>chior	k j o r
<|RUM|>ci	t͡ʃ i
<|RUM|>cincilea	t͡ʃ i n t͡ʃ i l e̯ a
<|RUM|>cincime	t͡ʃ i n t͡ʃ i m e
<|RUM|>cineva	t͡ʃ i n e v a
<|RUM|>citi	t ʃ i t i
<|RUM|>citind	t ʃ i t i n d
<|RUM|>ciudat	t͡ʃ u d a t
<|RUM|>clar	k l a r
<|RUM|>clare	k l a r e
<|RUM|>clasă	k l a s ə
<|RUM|>clipe	k l i p e
<|RUM|>coada	k o̯ a d a
<|RUM|>coapse	k o̯ a p s e
<|RUM|>coci	k o t͡ʃʲ
<|RUM|>colaborator	k o l a b o r a t o r
<|RUM|>colinde	k o l i n d e
<|RUM|>combatem	k o m b a t e m
<|RUM|>comit	k o m i t
<|RUM|>comparație	k o m p a r a t͡s i e
<|RUM|>competiție	k o m p e t i t͡s i e
<|RUM|>complex	k o m p l e k s
<|RUM|>compuse	k o m p u s e
<|RUM|>comun	k o m u n
<|RUM|>comuna	k o m u n a
<|RUM|>comunicat	k o m u n i k a t
<|RUM|>comunitate	k o m u n i t a t e
<|RUM|>conduce	k o n d u t͡ʃ e
<|RUM|>consider	k o n s i d e r
<|RUM|>consideram	k o n s i d e r a m
<|RUM|>considerat	k o n s i d e r a t
<|RUM|>consolidat	k o n s o l i d a t
<|RUM|>contagios	k o n t a d͡ʒ i o s
<|RUM|>contat	k o n t a t
<|RUM|>continuat	k o n t i n w a t
<|RUM|>continui	k o n t i n u j
<|RUM|>controverse	k o n t r o v e r s e
<|RUM|>conștiință	k o n ʃ t i i̯ n t͡s ə
<|RUM|>copii	k o p i j
<|RUM|>copil	k o p i l
<|RUM|>copilului	k o p i l u l u j
<|RUM|>corect	k o r e k t
<|RUM|>coreea	k o r e j a
<|RUM|>coronavirus	k o r o n a v i r u s
<|RUM|>cost	k o s t
<|RUM|>costat	k o s t a t
<|RUM|>crapi	k r a pʲ
<|RUM|>crea	k r e a
<|RUM|>cream	k r e a m
<|RUM|>cred	k r e d
<|RUM|>crede	k r e d e
<|RUM|>credință	k r e d i n t͡s ə
<|RUM|>creier	k r e j e r
<|RUM|>criminal	k r i m i n a l
<|RUM|>criză	k r i z ə
<|RUM|>cu	k u
<|RUM|>culorile	k u l o r i l e
<|RUM|>cultura	k u l t u r a
<|RUM|>culturi	k u l t u rʲ
<|RUM|>culturii	k u l t u r iː
<|RUM|>cum	k u m
<|RUM|>cunoscut	k u n o s k u t
<|RUM|>cur	k u r
<|RUM|>curat	k u r a t
<|RUM|>cursei	k u r s e j
<|RUM|>cuvinte	k u v i n t e
<|RUM|>cuvintele	k u v i n t e l e
<|RUM|>cuvintelor	k u v i n t e l o r
<|RUM|>câine	k ɨ j n e
<|RUM|>cântăreața	k ɨ n t ə r e̯ a t͡s a
<|RUM|>câte	k ɨ t e
<|RUM|>dar	d a r
<|RUM|>datorită	d a t o r i t ə
<|RUM|>dau	d a w
<|RUM|>dea	d e̯ a
<|RUM|>decedat	d e t͡ʃ e d a t
<|RUM|>declarație	d e k l a r a t͡s i e
<|RUM|>deja	d e ʒ a
<|RUM|>delicios	d e l i t͡ʃ j o s
<|RUM|>delirant	d e l i r a n t
<|RUM|>demnitate	d e m n i t a t e
<|RUM|>deranja	d e r a n ʒ a
<|RUM|>deranjat	d e r a n ʒ a t
<|RUM|>descrie	d e s k r i j e
<|RUM|>descriere	d e s k r i e r e
<|RUM|>desene	d e s e n e
<|RUM|>desigur	d e s i ɡ u r
<|RUM|>despre	d e s p r e
<|RUM|>determine	d e t e r m i n e
<|RUM|>deveni	d e v e n i
<|RUM|>devii	d e v i j
<|RUM|>devin	d e v i n
<|RUM|>devine	d e v i n e
<|RUM|>diamant	d i a m a n t
<|RUM|>dictatura	d i k t a t u r a
<|RUM|>diferit	d i f e r i t
<|RUM|>dificil	d i f i t͡ʃ i l
<|RUM|>dimineața	d i m i n e̯ a t͡s a
<|RUM|>dimineață	d i m i n e̯ a t s ə
<|RUM|>din	d i n
<|RUM|>dincolo	d i n k o l o
<|RUM|>dintre	d i n t r e
<|RUM|>discute	d i s k u t e
<|RUM|>discuție	d i s k u t͡s i e
<|RUM|>dispare	d i s p a r e
<|RUM|>disponibilitate	d i s p o n i b i l i t a t e
<|RUM|>distanță	d i s t a n t͡s ə
<|RUM|>divin	d i v i n
<|RUM|>doar	d o̯ a r
<|RUM|>doare	d o̯ a r e
<|RUM|>doctor	d o k t o r
<|RUM|>documentat	d o k u m e n t a t
<|RUM|>documentez	d o k u m e n t e z
<|RUM|>domestici	d o m e s t i t͡ʃ i
<|RUM|>domine	d o m i n e
<|RUM|>donat	d o n a t
<|RUM|>dorin	d o r i n
<|RUM|>dorit	d o r i t
<|RUM|>dormi	d o r m i
<|RUM|>drag	d r a ɡ
<|RUM|>dragostea	d r a ɡ o s t e̯ a
<|RUM|>drumuri	d r u m u rʲ
<|RUM|>duce	d u t͡ʃ e
<|RUM|>duci	d u t͡ʃʲ
<|RUM|>duminica	d u m i n i k a
<|RUM|>duminică	d u m i n i k ə
<|RUM|>dumnealui	d u m n e̯ a l u j
<|RUM|>dumnezeu	d u m n e z e w
<|RUM|>dungi	d u n d͡ʒʲ
<|RUM|>dureros	d u r e r o s
<|RUM|>dărâma	d ə r ɨ m a
<|RUM|>echilibru	e k i l i b r u
<|RUM|>economic	e k o n o m i k
<|RUM|>ecuadorian	e k u a d o r i a n
<|RUM|>editorial	e d i t o r j a l
<|RUM|>egal	e ɡ a l
<|RUM|>electorat	e l e k t o r a t
<|RUM|>electric	e l e k t r i k
<|RUM|>elevi	e l e vʲ
<|RUM|>elimina	e l i m i n a
<|RUM|>eliminat	e l i m i n a t
<|RUM|>erai	j e r a j
<|RUM|>eram	j e r a m
<|RUM|>estimat	e s t i m a t
<|RUM|>exact	e ɡ z a k t
<|RUM|>examen	e ɡ z a m e n
<|RUM|>exclude	e k s k l u d e
<|RUM|>exclusivitate	e k s k l u s i v i t a t e
<|RUM|>exist	e ɡ z i s t
<|RUM|>exista	e ɡ z i s t a
<|RUM|>expirat	e k s p i r a t
<|RUM|>expresie	e k s p r e s i e
<|RUM|>exprime	e k s p r i m e
<|RUM|>expune	e k s p u n e
<|RUM|>extern	e k s t e r n
<|RUM|>extraordinar	e k s t r a o r d i n a r
<|RUM|>fabric	f a b r i k
<|RUM|>fabricii	f a b r i t͡ʃ i j
<|RUM|>fac	f a k
<|RUM|>face	f a t͡ʃ e
<|RUM|>faci	f a t͡ʃʲ
<|RUM|>falca	f a l k a
<|RUM|>fals	f a l s
<|RUM|>familie	f a m i l i e
<|RUM|>fanteziei	f a n t e z i e j
<|RUM|>faza	f a z a
<|RUM|>federație	f e d e r a t͡s i e
<|RUM|>femei	f e m e j
<|RUM|>femeia	f e m e j a
<|RUM|>feminin	f e m i n i n
<|RUM|>fericit	f e r i t͡ʃ i t
<|RUM|>ferma	f e r m a
<|RUM|>fermeca	f e r m e k a
<|RUM|>fete	f e t e
<|RUM|>fi	f i
<|RUM|>fie	f i e
<|RUM|>fiecare	f i e k a r e
<|RUM|>fier	f j e r
<|RUM|>figura	f i ɡ u r a
<|RUM|>fii	f iː
<|RUM|>fim	f i m
<|RUM|>firească	f i r e̯ a s k ə
<|RUM|>firesc	f i r e s k
<|RUM|>fixat	f i k s a t
<|RUM|>fizic	f i z i k
<|RUM|>flutur	f l u t u r
<|RUM|>foc	f o k
<|RUM|>folosea	f o l o s e̯ a
<|RUM|>foloseau	f o l o s e̯ a w
<|RUM|>folosesc	f o l o s e s k
<|RUM|>folosim	f o l o s i m
<|RUM|>folosind	f o l o s i n d
<|RUM|>folosit	f o l o s i t
<|RUM|>folosite	f o l o s i t e
<|RUM|>formată	f o r m a t ə
<|RUM|>forme	f o r m e
<|RUM|>formele	f o r m e l e
<|RUM|>formeze	f o r m e z e
<|RUM|>formula	f o r m u l a
<|RUM|>foste	f o s t e
<|RUM|>fotografii	f o t o ɡ r a f i j
<|RUM|>franc	f r a ŋ k
<|RUM|>franci	f r a n t͡ʃʲ
<|RUM|>frate	f r a t e
<|RUM|>frica	f r i k a
<|RUM|>frumos	f r u m o s
<|RUM|>frunza	f r u n z a
<|RUM|>fugi	f u d͡ʒ i
<|RUM|>fulgi	f u l d͡ʒʲ
<|RUM|>fundamentale	f u n d a m e n t a l e
<|RUM|>furam	f u r a m
<|RUM|>furat	f u r a t
<|RUM|>furtuna	f u r t u n a
<|RUM|>fusese	f u s e s e
<|RUM|>fusta	f u s t a
<|RUM|>galben	ɡ a l b e n
<|RUM|>gard	ɡ a r d
<|RUM|>gata	ɡ a t a
<|RUM|>generali	d͡ʒ e n e r a lʲ
<|RUM|>german	d͡ʒ e r m a n
<|RUM|>gestiona	d͡ʒ e s t i o n a
<|RUM|>ghid	ɡ i d
<|RUM|>glonț	ɡ l o n t͡s
<|RUM|>gospodar	ɡ o s p o d a r
<|RUM|>gospodărești	ɡ o s p o d ə r e ʃ tʲ
<|RUM|>grabo	ɡ r a b o
<|RUM|>gratis	ɡ r a t i s
<|RUM|>grav	ɡ r a v
<|RUM|>grație	ɡ r a t͡s i e
<|RUM|>grinda	ɡ r i n d a
<|RUM|>gripa	ɡ r i p a
<|RUM|>gripei	ɡ r i p e j
<|RUM|>grota	ɡ r o t a
<|RUM|>gura	ɡ u r a
<|RUM|>gust	ɡ u s t
<|RUM|>gustat	ɡ u s t a t
<|RUM|>gând	ɡ ɨ n d
<|RUM|>halate	h a l a t e
<|RUM|>hectare	h e k t a r e
<|RUM|>hârtie	h ɨ r t i j e
<|RUM|>ia	j a
<|RUM|>ianuarie	j a n w a r i j e
<|RUM|>ieftin	j e f t i n
<|RUM|>ierburi	j e r b u rʲ
<|RUM|>ilegal	i l e ɡ a l
<|RUM|>imaginație	i m a d͡ʒ i n a t͡s i e
<|RUM|>include	i n k l u d e
<|RUM|>indiferent	i n d i f e r e n t
<|RUM|>indiscreta	i n d i s k r e t a
<|RUM|>inferior	i n f e r i o r
<|RUM|>inflație	i n f l a t͡s i e
<|RUM|>informat	i n f o r m a t
<|RUM|>informatici	i n f o r m a t i t͡ʃʲ
<|RUM|>ins	i n s
<|RUM|>insomnia	i n s o m n i a
<|RUM|>inspector	i n s p e k t o r
<|RUM|>instantaneu	i n s t a n t a n e w
<|RUM|>instrumente	i n s t r u m e n t e
<|RUM|>insula	i n s u l a
<|RUM|>insult	i n s u l t
<|RUM|>intelectual	i n t e l e k t u a l
<|RUM|>intens	i n t e n s
<|RUM|>intenție	i n t e n t͡s i e
<|RUM|>intervine	i n t e r v i n e
<|RUM|>interzis	i n t e r z i s
<|RUM|>intre	i n t r e
<|RUM|>introduc	i n t r o d u k
<|RUM|>introduce	i n t r o d u t͡ʃ e
<|RUM|>inundație	i n u n d a t͡s i e
<|RUM|>ironic	i r o n i k
<|RUM|>israel	i s r a e l
<|RUM|>istoria	i s t o r i a
<|RUM|>istoric	i s t o r i k
<|RUM|>italia	i t a l i a
<|RUM|>iubesc	j u b e s k
<|RUM|>iubiri	j u b i rʲ
<|RUM|>iubit	j u b i t
<|RUM|>iulie	j u l i j e
<|RUM|>iute	j u t e
<|RUM|>izolat	i z o l a t
<|RUM|>izvor	i z v o r
<|RUM|>japonez	ʒ a p o n e z
<|RUM|>joc	ʒ o k
<|RUM|>joi	ʒ o j
<|RUM|>judecată	ʒ u d e k a t ə
<|RUM|>la	l a
<|RUM|>lase	l a s e
<|RUM|>laude	l a u d e
<|RUM|>lavandă	l a v a n d ə
<|RUM|>legam	l e ɡ a m
<|RUM|>lege	l e d͡ʒ e
<|RUM|>legea	l e d͡ʒ e̯ a
<|RUM|>legi	l e d͡ʒʲ
<|RUM|>lei	l e j
<|RUM|>lemnos	l e m n o s
<|RUM|>liber	l i b e r
<|RUM|>lichid	l i c i d
<|RUM|>limbii	l i m b iː
<|RUM|>limita	l i m i t a
<|RUM|>limitat	l i m i t a t
<|RUM|>lingura	l i ŋ ɡ u r a
<|RUM|>linguri	l i ŋ ɡ u rʲ
<|RUM|>lipseai	l i p s e̯ a j
<|RUM|>lituania	l i t u a n i a
<|RUM|>localitate	l o k a l i t a t e
<|RUM|>locație	l o k a t͡s i e
<|RUM|>locui	l o k u i
<|RUM|>luați	l u a t͡sʲ
<|RUM|>lucia	l u t ʃ j a
<|RUM|>lucian	l u t͡ʃ j a n
<|RUM|>lucrez	l u k r e z
<|RUM|>lucreze	l u k r e z e
<|RUM|>lucru	l u k r u
<|RUM|>lucrului	l u k r u l u j
<|RUM|>lucruri	l u k r u rʲ
<|RUM|>lucrurilor	l u k r u r i l o r
<|RUM|>lui	l u j
<|RUM|>lung	l u ŋ ɡ
<|RUM|>lupt	l u p t
<|RUM|>lăsat	l ə s a t
<|RUM|>macabra	m a k a b r a
<|RUM|>madalina	m a d a l i n a
<|RUM|>mai	m a j
<|RUM|>majoritate	m a ʒ o r i t a t e
<|RUM|>mamă	m a m ə
<|RUM|>mangan	m a n ɡ a n
<|RUM|>marcat	m a r k a t
<|RUM|>mare	m a r e
<|RUM|>marfă	m a r f ə
<|RUM|>martie	m a r t i j e
<|RUM|>marți	m a r t͡sʲ
<|RUM|>masculin	m a s k u l i n
<|RUM|>masă	m a s ə
<|RUM|>maturitate	m a t u r i t a t e
<|RUM|>mașină	m a ʃ i n ə
<|RUM|>mea	m e̯ a
<|RUM|>medic	m e d i k
<|RUM|>medici	m e d i t͡ʃʲ
<|RUM|>medie	m e d i e
<|RUM|>mediu	m e d j u
<|RUM|>mei	m e j
<|RUM|>memorie	m e m o r i e
<|RUM|>merit	m e r i t
<|RUM|>meritam	m e r i t a m
<|RUM|>meu	m e w
<|RUM|>mica	m i k a
<|RUM|>mici	m i t͡ʃʲ
<|RUM|>mie	m i e
<|RUM|>mine	m i n e
<|RUM|>mint	m i n t
<|RUM|>minte	m i n t e
<|RUM|>moartea	m o̯ a r t e̯ a
<|RUM|>mobil	m o b i l
<|RUM|>model	m o d e l
<|RUM|>motiv	m o t i v
<|RUM|>munte	m u n t ɛ
<|RUM|>muntenia	m u n t e n i a
<|RUM|>muzeu	m u z e w
<|RUM|>mărar	m ə r a r
<|RUM|>neașteptat	n e a ʃ t e p t a t
<|RUM|>necesitate	n e t͡ʃ e s i t a t e
<|RUM|>negociat	n e ɡ o t͡ʃ i a t
<|RUM|>nici	n i t ʃʲ
<|RUM|>niciun	n i t͡ʃʲ u n
<|RUM|>ninge	n i n d ʒ e
<|RUM|>niște	n i ʃ t e
<|RUM|>noapte	n o̯ a p t e
<|RUM|>noaptea	n o̯ a p t e̯ a
<|RUM|>noi	n o j
<|RUM|>nori	n o rʲ
<|RUM|>nostalgic	n o s t a l d͡ʒ i k
<|RUM|>nostru	n o s t r u
<|RUM|>nou	n o w
<|RUM|>noștri	n o ʃ t r i
<|RUM|>numit	n u m i t
<|RUM|>numite	n u m i t e
<|RUM|>născut	n ə s k u t
<|RUM|>obligat	o b l i ɡ a t
<|RUM|>obscen	o b s t͡ʃ e n
<|RUM|>observa	o b s e r v a
<|RUM|>observat	o b s e r v a t
<|RUM|>obținere	o b t͡s i n e r e
<|RUM|>occident	o k t͡ʃ i d e n t
<|RUM|>octombrie	o k t o m b r i j e
<|RUM|>ocupa	o k u p a
<|RUM|>oferim	o f e r i m
<|RUM|>omenesc	o m e n e s k
<|RUM|>operație	o p e r a t͡s i e
<|RUM|>oprea	o p r e̯ a
<|RUM|>opta	o p t a
<|RUM|>optimist	o p t i m i s t
<|RUM|>opus	o p u s
<|RUM|>organizam	o r ɡ a n i z a m
<|RUM|>organizat	o r ɡ a n i z a t
<|RUM|>organizatori	o r ɡ a n i z a t o rʲ
<|RUM|>ori	o rʲ
<|RUM|>oricine	o rʲ t͡ʃ i n e
<|RUM|>orientat	o r i e n t a t
<|RUM|>ou	o w
<|RUM|>ouă	o w ə
<|RUM|>pa	p a
<|RUM|>pachete	p a k e t e
<|RUM|>pacient	p a t͡ʃ i e n t
<|RUM|>palma	p a l m a
<|RUM|>palme	p a l m e
<|RUM|>parca	p a r k a
<|RUM|>pas	p a s
<|RUM|>patru	p a t r u
<|RUM|>patruzeci	p a t r u z e t͡ʃʲ
<|RUM|>pașnic	p a ʃ n i k
<|RUM|>perfect	p e r f e k t
<|RUM|>peste	p e s t e
<|RUM|>pianist	p i a n i s t
<|RUM|>picioare	p i t͡ʃ o̯ a r e
<|RUM|>pictor	p i k t o r
<|RUM|>pierde	p j e r d e
<|RUM|>pierdut	p j e r d u t
<|RUM|>pisat	p i s a t
<|RUM|>plat	p l a t
<|RUM|>plece	p l e t͡ʃ e
<|RUM|>pleci	p l e t͡ʃʲ
<|RUM|>plin	p l i n
<|RUM|>plânge	p l ɨ n d ʒ e
<|RUM|>poliție	p o l i t͡s i e
<|RUM|>popescu	p o p e s k u
<|RUM|>populație	p o p u l a t͡s i e
<|RUM|>porneam	p o r n e̯ a m
<|RUM|>porni	p o r n i
<|RUM|>pornind	p o r n i n d
<|RUM|>pornit	p o r n i t
<|RUM|>potabil	p o t a b i l
<|RUM|>potabile	p o t a b i l e
<|RUM|>prea	p r e̯ a
<|RUM|>precis	p r e t͡ʃ i s
<|RUM|>precum	p r e k u m
<|RUM|>prefera	p r e f e r a
<|RUM|>prelungit	p r e l u n d͡ʒ i t
<|RUM|>prescrie	p r e s k r i e
<|RUM|>pretutindeni	p r e t u t i n d e nʲ
<|RUM|>prevede	p r e v e d e
<|RUM|>prezenta	p r e z e n t a
<|RUM|>prezentare	p r e z e n t a r e
<|RUM|>prezervative	p r e z e r v a t i v e
<|RUM|>prieten	p r i e t e n
<|RUM|>prietenii	p r i e t e n iː
<|RUM|>prietenilor	p r i e t e n i l o r
<|RUM|>prietenului	p r i e t e n u l u j
<|RUM|>prima	p r i m a
<|RUM|>primar	p r i m a r
<|RUM|>prime	p r i m e
<|RUM|>primea	p r i m j a
<|RUM|>primeau	p r i m j a w
<|RUM|>primesc	p r i m e s k
<|RUM|>primii	p r i m iː
<|RUM|>primita	p r i m i t a
<|RUM|>primul	p r i m u l
<|RUM|>primăvară	p r i m ə v a r ə
<|RUM|>prioritate	p r i j o r i t a t e
<|RUM|>produce	p r o d u t ʃ e
<|RUM|>producători	p r o d u k ə t o rʲ
<|RUM|>producție	p r o d u k t͡s i e
<|RUM|>promisiuni	p r o m i s i u nʲ
<|RUM|>promitem	p r o m i t e m
<|RUM|>prosti	p r o s t i
<|RUM|>protejeze	p r o t e ʒ e z e
<|RUM|>provincie	p r o v i n t͡ʃ i e
<|RUM|>prânz	p r ɨ n z
<|RUM|>psiholog	p s i h o l o ɡ
<|RUM|>pupam	p u p a m
<|RUM|>puternic	p u t e r n i k
<|RUM|>pârâu	p ɨ r ɨ w
<|RUM|>rac	r a k
<|RUM|>rad	r a d
<|RUM|>rai	r a j
<|RUM|>raluca	r a l u k a
<|RUM|>rapid	r a p i d
<|RUM|>rar	r a r
<|RUM|>rațional	r a t͡s i o n a l
<|RUM|>reale	r e a l e
<|RUM|>recunoscut	r e k u n o s k u t
<|RUM|>reduc	r e d u k
<|RUM|>redus	r e d u s
<|RUM|>regele	r e d͡ʒ e l e
<|RUM|>regi	r e d͡ʒʲ
<|RUM|>regina	r e d͡ʒ i n a
<|RUM|>reglat	r e ɡ l a t
<|RUM|>reparat	r e p a r a t
<|RUM|>repare	r e p a r e
<|RUM|>reprezenta	r e p r e z e n t a
<|RUM|>republica	r e p u b l i k a
<|RUM|>respingi	r e s p i n d͡ʒʲ
<|RUM|>rest	r e s t
<|RUM|>revin	r e v i n
<|RUM|>revista	r e v i s t a
<|RUM|>reviste	r e v i s t e
<|RUM|>rezulte	r e z u l t e
<|RUM|>reține	r e t͡s i n e
<|RUM|>ridic	r i d i k
<|RUM|>risca	r i s k a
<|RUM|>riscam	r i s k a m
<|RUM|>romane	r o m a n e
<|RUM|>român	r o m ɨ n
<|RUM|>româniei	r o m ɨ n i j e j
<|RUM|>roșu	r o ʃ u
<|RUM|>ruga	r u ɡ a
<|RUM|>ruj	r u ʒ
<|RUM|>rupea	r u p e̯ a
<|RUM|>rupta	r u p t a
<|RUM|>rupte	r u p t e
<|RUM|>rând	r ɨ n d
<|RUM|>rămas	r ə m a s
<|RUM|>sa	s a
<|RUM|>sacrifici	s a k r i f i t͡ʃʲ
<|RUM|>salam	s a l a m
<|RUM|>salutat	s a l u t a t
<|RUM|>sape	s a p e
<|RUM|>schimba	s k i m b a
<|RUM|>sclavi	s k l a vʲ
<|RUM|>scoli	s k o lʲ
<|RUM|>scrie	s k r i e
<|RUM|>scriem	s k r i e m
<|RUM|>scrisoare	s k r i s o̯ a r e
<|RUM|>scurt	s k u r t
<|RUM|>seara	s e̯ a r a
<|RUM|>secret	s e k r e t
<|RUM|>senin	s e n i n
<|RUM|>simpla	s i m p l a
<|RUM|>simplu	s i m p l u
<|RUM|>simulare	s i m u l a r e
<|RUM|>sine	s i n e
<|RUM|>sinistru	s i n i s t r u
<|RUM|>sirop	s i r o p
<|RUM|>sistem	s i s t e m
<|RUM|>slab	s l a b
<|RUM|>soare	s o̯ a r e
<|RUM|>soarele	s o̯ a r e l e
<|RUM|>social	s o t͡ʃ i a l
<|RUM|>soldat	s o l d a t
<|RUM|>spania	s p a n j a
<|RUM|>spaniol	s p a n i o l
<|RUM|>spanioli	s p a n i o lʲ
<|RUM|>spaniolă	s p a n i o l ə
<|RUM|>spate	s p a t e
<|RUM|>sper	s p e r
<|RUM|>spera	s p e r a
<|RUM|>spirit	s p i r i t
<|RUM|>spiritual	s p i r i t u a l
<|RUM|>spital	s p i t a l
<|RUM|>sprijini	s p r i ʒ i n i
<|RUM|>spui	s p u j
<|RUM|>spun	s p u n
<|RUM|>spune	s p u n e
<|RUM|>spălare	s p ə l a r e
<|RUM|>stat	s t a t
<|RUM|>stea	s t e̯ a
<|RUM|>stele	s t e l e
<|RUM|>stetoscop	s t e t o s k o p
<|RUM|>strălucitor	s t r ə l u t͡ʃ i t o r
<|RUM|>stupid	s t u p i d
<|RUM|>subțire	s u b t͡s i r e
<|RUM|>suedez	s u e d e z
<|RUM|>sufletele	s u f l e t e l e
<|RUM|>suntem	s u n t e m
<|RUM|>supere	s u p e r e
<|RUM|>surori	s u r o rʲ
<|RUM|>surprinzător	s u r p r i n z ə t o r
<|RUM|>sute	s u t e
<|RUM|>său	s ə w
<|RUM|>tace	t a t͡ʃ e
<|RUM|>tale	t a l e
<|RUM|>tari	t a rʲ
<|RUM|>tatuajele	t a t u a ʒ e l e
<|RUM|>te	t e
<|RUM|>tehnică	t e h n i k ə
<|RUM|>tehnologic	t e h n o l o d͡ʒ i k
<|RUM|>temniță	t e m n i t s ə
<|RUM|>temperatură	t e m p e r a t u r ə
<|RUM|>termen	t e r m e n
<|RUM|>termin	t e r m i n
<|RUM|>terminam	t e r m i n a m
<|RUM|>termine	t e r m i n e
<|RUM|>timpuri	t i m p u rʲ
<|RUM|>tind	t i n d
<|RUM|>tipar	t i p a r
<|RUM|>titan	t i t a n
<|RUM|>topit	t o p i t
<|RUM|>tot	t o t
<|RUM|>totalitate	t o t a l i t a t e
<|RUM|>totuși	t o t u ʃʲ
<|RUM|>traduceri	t r a d u t ʃ e rʲ
<|RUM|>trandafir	t r a n d a f i r
<|RUM|>trebui	t r e b u i
<|RUM|>trei	t r e j
<|RUM|>treia	t r e j a
<|RUM|>treilea	t r e j l e̯ a
<|RUM|>trăsnit	t r ə s n i t
<|RUM|>tu	t u
<|RUM|>tub	t u b
<|RUM|>tuns	t u n s
<|RUM|>turcescu	t u r t͡ʃ e s k u
<|RUM|>tăcut	t ə k u t
<|RUM|>tău	t ə w
<|RUM|>uite	u j t e
<|RUM|>ultim	u l t i m
<|RUM|>umble	u m b l e
<|RUM|>umed	u m e d
<|RUM|>umple	u m p l e
<|RUM|>undeva	u n d e v a
<|RUM|>undă	u n d ə
<|RUM|>unei	u n e j
<|RUM|>ungur	u ŋ ɡ u r
<|RUM|>ungurești	u ŋ ɡ u r e ʃ tʲ
<|RUM|>unor	u n o r
<|RUM|>unu	u n u
<|RUM|>uram	u r a m
<|RUM|>urca	u r k a
<|RUM|>urcat	u r k a t
<|RUM|>urez	u r e z
<|RUM|>util	u t i l
<|RUM|>ușor	u ʃ o r
<|RUM|>vai	v a j
<|RUM|>vara	v a r a
<|RUM|>veni	v e n i
<|RUM|>venise	v e n i s e
<|RUM|>verde	v e r d e
<|RUM|>viitor	v i i t o r
<|RUM|>vine	v i n e
<|RUM|>vino	v i n o
<|RUM|>violent	v i o l e n t
<|RUM|>virus	v i r u s
<|RUM|>vizibilitate	v i z i b i l i t a t e
<|RUM|>voință	v o i n t͡s ə
<|RUM|>vor	v o r
<|RUM|>vostru	v o s t r u
<|RUM|>vrea	v r e̯ a
<|RUM|>vrednic	v r e d n i k
<|RUM|>vrei	v r e j
<|RUM|>vrut	v r u t
<|RUM|>vă	v ə
<|RUM|>văzuți	v ə z u t͡sʲ
<|RUM|>zdravăn	z d r a v ə n
<|RUM|>zece	z e t͡ʃ e
<|RUM|>zecea	z e t͡ʃ e̯ a
<|RUM|>zero	z e r o
<|RUM|>zone	z o n e
<|RUM|>zonele	z o n e l e
<|RUM|>îmbolnăvi	ɨ m b o l n ə v i
<|RUM|>început	ɨ n t͡ʃ e p u t
<|RUM|>încercare	ɨ n t͡ʃ e r k a r e
<|RUM|>închisoare	ɨ n k i s o̯ a r e
<|RUM|>îndoială	ɨ n d o j a l ə
<|RUM|>întinsă	ɨ n t i n s ə
<|RUM|>între	ɨ n t r e
<|RUM|>ăia	ə j a
<|RUM|>șaptelea	ʃ a p t e l e̯ a
<|RUM|>țigan	t͡s i ɡ a n
<|RUM|>ține	t͡s i n e
<|RUM|>țărănești	t͡s ə r ə n e ʃ tʲ
