<|ARA|>عميق	ʕ a m iː q
<|ARA|>منبه	m u n a b b i h
<|ARA|>حورس	ħ uː r u s
<|ARA|>محول	m u ħ a w w i l
<|ARA|>بلغم	b a l ɣ a m
<|ARA|>متسامح	m u t a s aː m i ħ
<|ARA|>كتابة	k i t aː b a
<|ARA|>مجري	m a d͡ʒ a r i j j
<|ARA|>سجين	s a d͡ʒ iː n
<|ARA|>تذكار	t a ð k aː r
<|ARA|>خرزة	x u r z a
<|ARA|>ترصد	t a r a sˤ sˤ a d a
<|ARA|>طنجيرة	tˤ a n d͡ʒ iː r a
<|ARA|>محمد	m a ħ m a d
<|ARA|>رونق	r a w n a q
<|ARA|>حيوان	ħ a j a w aː n
<|ARA|>عفيف	ʕ a f iː f
<|ARA|>إقالة	ʔ i q aː l a
<|ARA|>كادس	k aː d i s
<|ARA|>شحاذة	ʃ i ħ aː ð a
<|ARA|>جرذ	d͡ʒ u r a ð
<|ARA|>سار	s aː r r
<|ARA|>أقرع	ʔ a q r a ʕ
<|ARA|>إكليل	ʔ i k l iː l
<|ARA|>ذروة	ð u r w a
<|ARA|>استثمار	i s t i θ m aː r
<|ARA|>حلتيث	ħ i l t iː θ
<|ARA|>خلاعي	x a l aː ʕ i j j
<|ARA|>تعليق	t a ʕ l iː q
<|ARA|>مرادف	m u r aː d i f
<|ARA|>بلغاري	b u l ɣ aː r i j j
<|ARA|>أرسطوطاليس	ʔ a r i s tˤ uː tˤ aː l iː s
<|ARA|>قبج	q a b a d͡ʒ
<|ARA|>محن	m i ħ a n
<|ARA|>وطني	w a tˤ a n i j j
<|ARA|>خصوص	x u sˤ uː sˤ
<|ARA|>مثنان	m a θ n aː n
<|ARA|>تقدم	t a q a d d a m a
<|ARA|>لوياثان	l a w i j aː θ aː n
<|ARA|>أصطرك	ʔ a sˤ tˤ a r a k
<|ARA|>نفقة	n a f a q a
<|ARA|>مكسور	m a k s uː r
<|ARA|>إناء	ʔ i n aː ʔ
<|ARA|>عرنسية	ʕ a r a n s i j j a
<|ARA|>تباطأ	t a b aː tˤ a ʔ a
<|ARA|>ماعون	m aː ʕ uː n
<|ARA|>مذيع	m u ð iː ʕ
<|ARA|>قراءة	q i r aː ʔ a
<|ARA|>حسناء	ħ a s n aː ʔ
<|ARA|>شاهلوج	ʃ aː h a l uː d͡ʒ
<|ARA|>وسع	w a s i ʕ a
<|ARA|>موسكو	m uː s k uː
<|ARA|>لكمة	l a k m a
<|ARA|>عدمية	ʕ a d a m i j j a
<|ARA|>جنسية	d͡ʒ i n s i j j a
<|ARA|>كعك	k a ʕ k
<|ARA|>عظم	ʕ a ðˤ m
<|ARA|>أخدر	ʔ a x d a r
<|ARA|>أمان	ʔ a m aː n
<|ARA|>عناب	ʕ u n n aː b
<|ARA|>لاسلطوي	l aː s u l tˤ a w i j j
<|ARA|>برشيد	b a r ʃ iː d
<|ARA|>إشبينة	ʔ i ʃ b iː n a
<|ARA|>اليسع	a l j a s a ʕ
<|ARA|>ساء	s aː ʔ a
<|ARA|>كانون	k aː n uː n
<|ARA|>عمى	ʕ a m m aː
<|ARA|>نادل	n aː d i l
<|ARA|>اختل	i x t a l l a
<|ARA|>عاصف	ʕ aː sˤ i f
<|ARA|>وقود	w a q uː d
<|ARA|>عنيف	ʕ a n iː f
<|ARA|>زعتر	z a ʕ t a r
<|ARA|>مروحة	m i r w a ħ a
<|ARA|>سرخس	s a r x a s
<|ARA|>مظهر	m a ðˤ h a r
<|ARA|>نبذة	n u b ð a
<|ARA|>مقدونس	m a q d uː n i s
<|ARA|>إهليلج	ʔ i h l iː l a d͡ʒ
<|ARA|>حوب	ħ uː b
<|ARA|>جاذبية	d͡ʒ aː ð i b i j j a
<|ARA|>مكتب	m a k t a b
<|ARA|>سلح	s a l a ħ a
<|ARA|>أيهقان	ʔ a j h a q aː n
<|ARA|>كويكب	k u w a j k i b
<|ARA|>شبح	ʃ a b a ħ
<|ARA|>برقوق	b a r q uː q
<|ARA|>داعش	d aː ʕ i ʃ
<|ARA|>وراط	w i r aː tˤ
<|ARA|>غالبية	ɣ aː l i b i j j a
<|ARA|>هجوم	h u d͡ʒ uː m
<|ARA|>فسيفساء	f u s a j f i s aː ʔ
<|ARA|>نخاع	n u x aː ʕ
<|ARA|>جزدان	d͡ʒ i z d aː n
<|ARA|>أذاع	ʔ a ð aː ʕ a
<|ARA|>استيقظ	i s t a j q a ðˤ a
<|ARA|>عربيزي	ʕ a r a b iː z i j j
<|ARA|>إسكتلندي	ʔ i s k u t l a n d i j j
<|ARA|>زوم	z uː m
<|ARA|>ذئبة	ð i ʔ b a
<|ARA|>طعام	tˤ a ʕ aː m
<|ARA|>فاسد	f aː s i d
<|ARA|>الصربية	a sˤ sˤ i r b i j j a
<|ARA|>لكنة	l u k n a
<|ARA|>ذرة	ð a r r a
<|ARA|>عباءة	ʕ a b aː ʔ a
<|ARA|>مقاص	m a q aː sˤ sˤ
<|ARA|>تعطى	t a ʕ a tˤ tˤ aː
<|ARA|>قطيفة	q a tˤ iː f a
<|ARA|>رخخة	r i x a x a
<|ARA|>أصبح	ʔ a sˤ b a ħ
<|ARA|>تصادم	t a sˤ aː d a m a
<|ARA|>قندهار	q u n d u h aː r
<|ARA|>أموي	ʔ u m a w i j j
<|ARA|>أعرن	ʔ a ʕ r a n a
<|ARA|>الآن	a l ʔ aː n a
<|ARA|>رطانة	r a tˤ aː n a
<|ARA|>هدس	h a d a s
<|ARA|>الحبشة	a l ħ a b a ʃ a
<|ARA|>أتاح	ʔ a t aː ħ a
<|ARA|>صنارة	sˤ i n aː r a
<|ARA|>صلابة	sˤ a l aː b a
<|ARA|>كشتبان	k u ʃ t u b aː n
<|ARA|>تدريج	t a d r iː d͡ʒ
<|ARA|>أولياء	ʔ a w l i j aː ʔ
<|ARA|>مناعة	m a n aː ʕ a
<|ARA|>تجربة	t a d͡ʒ r i b a
<|ARA|>مسافة	m a s aː f a
<|ARA|>حنيف	ħ a n iː f
<|ARA|>أعتاب	ʔ a ʕ t aː b
<|ARA|>أرز	ʔ a r a z z a
<|ARA|>بأس	b a ʔ s
<|ARA|>نائم	n aː ʔ i m
<|ARA|>حاسم	ħ aː s i m
<|ARA|>قلية	q i l l i j j a
<|ARA|>أسس	ʔ a s s a s a
<|ARA|>فريسة	f a r iː s a
<|ARA|>نصراني	n a sˤ r aː n i j j
<|ARA|>عيدية	ʕ iː d i j j a
<|ARA|>مرصبان	m a r sˤ a b aː n
<|ARA|>نعناع	n a ʕ n aː ʕ
<|ARA|>عجرفة	ʕ a d͡ʒ r a f a
<|ARA|>قاعة	q aː ʕ a
<|ARA|>يونس	j uː n u s
<|ARA|>مشرك	m u ʃ r i k
<|ARA|>أعصر	ʔ a ʕ sˤ a r a
<|ARA|>قاف	q aː f
<|ARA|>شذر	ʃ a ð r
<|ARA|>صدغ	sˤ a d ɣ
<|ARA|>ثقبة	θ u q b a
<|ARA|>صاخة	sˤ aː x x a
<|ARA|>مصبنة	m a sˤ b a n a
<|ARA|>مذكرة	m u ð a k k a r a
<|ARA|>رتيلة	r u t a j l a
<|ARA|>إبليز	ʔ i b l iː z
<|ARA|>فرقاطة	f i r q aː tˤ a
<|ARA|>آخر	ʔ aː x a r
<|ARA|>ميانمار	m i j aː n m aː r
<|ARA|>صربيا	sˤ i r b i j aː
<|ARA|>وريد	w a r iː d
<|ARA|>معزف	m i ʕ z a f
<|ARA|>أباخس	ʔ a b aː x i s u
<|ARA|>فنجنكشت	f a n d͡ʒ a n k u ʃ t
<|ARA|>السفن	a s s u f u n
<|ARA|>منبر	m i n b a r
<|ARA|>أشوس	ʔ a ʃ w a s
<|ARA|>ساط	s aː tˤ a
<|ARA|>أتوم	ʔ a t uː m
<|ARA|>مكمل	m u k a m m a l
<|ARA|>صفع	sˤ a f a ʕ a
<|ARA|>انتهى	i n t a h aː
<|ARA|>نانخواة	n aː n a x w aː h
<|ARA|>منور	m a n w a r
<|ARA|>حصان	ħ i sˤ aː n
<|ARA|>مدام	m u d aː m
<|ARA|>رئاسة	r i ʔ aː s a
<|ARA|>صربي	sˤ i r b i j j
<|ARA|>رغيفة	r a ɣ iː f a
<|ARA|>أسياخ	ʔ a s j aː x
<|ARA|>هدار	h a d d aː r
<|ARA|>مليء	m a l iː ʔ
<|ARA|>دبلجة	d a b l a d͡ʒ a
<|ARA|>براغ	b r aː ɣ
<|ARA|>حيث	ħ a j θ u
<|ARA|>ضوى	dˤ a w aː
<|ARA|>إحسان	ʔ i ħ s aː n
<|ARA|>ماجد	m aː d͡ʒ i d
<|ARA|>السودان	a s s uː d aː n
<|ARA|>مكالمة	m u k aː l a m a
<|ARA|>بناية	b i n aː j a
<|ARA|>إسناد	ʔ i s n aː d
<|ARA|>جزمازق	d͡ʒ a z m aː z a q
<|ARA|>بوذي	b uː ð i j j
<|ARA|>تسعمائة	t i s ʕ u m i ʔ a
<|ARA|>وثيقة	w a θ iː q a
<|ARA|>بارز	b aː r a z a
<|ARA|>نزهة	n u z h a
<|ARA|>بلاذر	b a l aː ð i r
<|ARA|>خلنجان	x a l a n d͡ʒ aː n
<|ARA|>الجمعة	a l d͡ʒ u m a ʕ a
<|ARA|>أبريل	ʔ a b r iː l
<|ARA|>مرفوع	m a r f uː ʕ
<|ARA|>تكميلي	t a k m iː l i j j
<|ARA|>فركس	f i r k i s
<|ARA|>عبادة	ʕ i b aː d a
<|ARA|>لوز	l a w z
<|ARA|>طرق	tˤ a r a q a
<|ARA|>عائلة	ʕ aː ʔ i l a
<|ARA|>سئم	s a ʔ i m a
<|ARA|>السنغال	a s s i n i ɣ aː l
<|ARA|>أوقف	ʔ a w q a f a
<|ARA|>بلعوم	b u l ʕ uː m
<|ARA|>متماد	m u t a m aː d d
<|ARA|>أترج	ʔ u t r u d͡ʒ d͡ʒ
<|ARA|>تربية	t a r b i j a
<|ARA|>ملوخيا	m u l uː x i j j aː
<|ARA|>تحسس	t a ħ a s s a s a
<|ARA|>ناضج	n aː dˤ i d͡ʒ
<|ARA|>مداد	m i d aː d
<|ARA|>انتبه	i n t a b a h a
<|ARA|>أنزل	ʔ a n z a l a
<|ARA|>مغن	m u ɣ a n n i n
<|ARA|>إبادة	ʔ i b aː d a
<|ARA|>عقال	ʕ i q aː l
<|ARA|>أهدى	ʔ a h d aː
<|ARA|>ضال	dˤ aː l l
<|ARA|>أباسخيرون	ʔ a b aː s x iː r uː n
<|ARA|>دمغة	d a m ɣ a
<|ARA|>سؤدد	s u ʔ d a d
<|ARA|>ترميم	t a r m iː m
<|ARA|>مستعرب	m u s t a ʕ r i b
<|ARA|>أشيب	ʔ a ʃ j a b
<|ARA|>سليلى	s u l a j l aː
<|ARA|>تركمانستان	t u r k u m aː n i s t aː n
<|ARA|>تقليدي	t a q l iː d i j j
<|ARA|>أصغى	ʔ a sˤ ɣ aː
<|ARA|>سلاح	s i l aː ħ
<|ARA|>طباق	tˤ a b b aː q
<|ARA|>بنفسجي	b a n a f s a d͡ʒ i j j
<|ARA|>ارتعش	i r t a ʕ a ʃ a
<|ARA|>فيجن	f a j d͡ʒ a n
<|ARA|>رقيق	r a q iː q
<|ARA|>اندمل	i n d a m a l a
<|ARA|>مشعر	m a ʃ ʕ a r
<|ARA|>جريد	d͡ʒ a r iː d
<|ARA|>غافت	ɣ aː f a t
<|ARA|>شونيز	ʃ uː n iː z
<|ARA|>بحاح	b u ħ aː ħ
<|ARA|>ابتلال	i b t i l aː l
<|ARA|>براشوت	b a r aː ʃ uː t
<|ARA|>وفاء	w a f aː ʔ
<|ARA|>نصاب	n a sˤ sˤ aː b
<|ARA|>قراسيا	q a r aː s i j aː
<|ARA|>بعثة	b a ʕ θ a
<|ARA|>انسل	i n s a l l a
<|ARA|>صورة	sˤ uː r a
<|ARA|>قاووش	q aː w uː ʃ
<|ARA|>شيعة	ʃ iː ʕ a
<|ARA|>عيادة	ʕ i j aː d a
<|ARA|>طائر	tˤ aː ʔ i r
<|ARA|>الأرجنتين	a l ʔ a r d͡ʒ a n t iː n
<|ARA|>سلباح	s i l b aː ħ
<|ARA|>توظيف	t a w ðˤ iː f
<|ARA|>أيقن	ʔ a j q a n a
<|ARA|>مستطيلات	m u s t tˤ iː l aː t
<|ARA|>خمسة	x a m s a
<|ARA|>رفائيل	r u f aː ʔ iː l
<|ARA|>بطروخ	b a tˤ r uː x
<|ARA|>ملا	m u l l aː
<|ARA|>لتوانيا	l i t u w aː n i j aː
<|ARA|>باب	b aː b
<|ARA|>استثنائي	i s t i θ n aː ʔ i j j
<|ARA|>دلب	d u l b
<|ARA|>عربية	ʕ a r a b i j j a
<|ARA|>معاونة	m u ʕ aː w a n a
<|ARA|>اخترق	i x t a r a q a
<|ARA|>رساطون	r a s aː tˤ uː n
<|ARA|>تقرر	t a q a r r a r a
<|ARA|>قداد	q a d aː d
<|ARA|>هدف	h a d a f
<|ARA|>إقامة	ʔ i q aː m a
<|ARA|>استفرغ	i s t a f r a ɣ a
<|ARA|>أرضي	ʔ a r dˤ i j j
<|ARA|>اشتباك	i ʃ t i b aː k
<|ARA|>إمضاء	ʔ i m dˤ aː ʔ
<|ARA|>أشنان	ʔ u ʃ n aː n
<|ARA|>تلفاف	t i l f aː f
<|ARA|>بذرقطونا	b a ð a r q a tˤ uː n aː
<|ARA|>كمء	k a m ʔ
<|ARA|>قوقعة	q a w q a ʕ a
<|ARA|>جين	d͡ʒ iː n
<|ARA|>استفز	i s t a f a z z a
<|ARA|>نادلة	n aː d i l a
<|ARA|>قاد	q aː d a
<|ARA|>القنيطرة	a l q u n a j tˤ i r a
<|ARA|>أكل	ʔ a k a l a
<|ARA|>شفاف	ʃ a f f aː f
<|ARA|>جارة	d͡ʒ aː r a
<|ARA|>حجر	ħ a d͡ʒ a r
<|ARA|>امتعض	i m t a ʕ a dˤ a
<|ARA|>صخد	sˤ a x a d a
<|ARA|>ليرة	l a j r a
<|ARA|>بنفسج	b a n a f s a d͡ʒ
<|ARA|>كرفس	k a r a f s
<|ARA|>تخدير	t a x d iː r
<|ARA|>صعوبة	sˤ u ʕ uː b a
<|ARA|>شلة	ʃ a l l a
<|ARA|>مجسمة	m u d͡ʒ a s s a m a
<|ARA|>كستبان	k u s t u b aː n
<|ARA|>ضاجع	dˤ aː d͡ʒ a ʕ a
<|ARA|>أزأم	ʔ a z ʔ a m a
<|ARA|>علة	ʕ i l l a
<|ARA|>مكون	m u k a w w i n
<|ARA|>شكارة	ʃ i k aː r a
<|ARA|>مغناطيسية	m a ɣ n aː tˤ iː s i j j a
<|ARA|>فضول	f dˤ uː l
<|ARA|>مقعدة	m a q ʕ a d a
<|ARA|>برشام	b i r ʃ aː m
<|ARA|>عفريت	ʕ a f r iː t
<|ARA|>مضرب	m i dˤ r a b
<|ARA|>ثوب	θ a w b
<|ARA|>خرنق	x i r n i q
<|ARA|>ضيون	dˤ a j w a n
<|ARA|>فور	f a w r
<|ARA|>دواسة	d a w w aː s a
<|ARA|>عائشة	ʕ aː ʔ i ʃ a
<|ARA|>جنائي	d͡ʒ i n aː ʔ i j j
<|ARA|>حصرم	ħ a sˤ r a m
<|ARA|>زنبوع	z a n b uː ʕ
<|ARA|>فتش	f a t t a ʃ a
<|ARA|>غلقة	ɣ a l q a
<|ARA|>الأشهل	a l ʔ a ʃ h a l
<|ARA|>بضع	b i dˤ ʕ
<|ARA|>شاورما	ʃ aː w a r m aː
<|ARA|>هنالك	h u n aː l i k a
<|ARA|>غضاضة	ɣ a dˤ aː dˤ a
<|ARA|>رشفة	r a ʃ f a
<|ARA|>رغوة	r a ɣ w a
<|ARA|>شاكر	ʃ aː k i r
<|ARA|>تفاجأ	t a f aː d͡ʒ a ʔ a
<|ARA|>صحصح	sˤ a ħ sˤ a ħ
<|ARA|>ارتفع	i r t a f a ʕ a
<|ARA|>دنر	d a n n a r a
<|ARA|>خصية	x i sˤ j a
<|ARA|>بركري	b a r k a r i j j
<|ARA|>باراغواي	b aː r aː ɣ u w aː j
<|ARA|>قرمزي	q i r m i z i j j
<|ARA|>غريبة	ɣ a r iː b a
<|ARA|>تشويق	t a ʃ w iː q
<|ARA|>تجاوزات	t a d͡ʒ aː w u z aː t
<|ARA|>زريبة	z a r iː b a
<|ARA|>غريغوريوس	ɣ i r iː ɣ uː r i j uː s
<|ARA|>صحاف	sˤ a ħ ħ aː f
<|ARA|>افترى	i f t a r aː
<|ARA|>شعرى	ʃ a ʕ r aː
<|ARA|>سيكران	s a j k a r aː n
<|ARA|>بيعة	b a j ʕ a
<|ARA|>ملبس	m a l b a s
<|ARA|>فتاة	f a t aː h
<|ARA|>قرطاس	q i r tˤ aː s
<|ARA|>أسمرة	ʔ a s m a r a
<|ARA|>نرجيل	n a r d͡ʒ iː l
<|ARA|>سمعي	s a m ʕ i j j
<|ARA|>جزئي	d͡ʒ u z ʔ i j j
<|ARA|>اتسع	i t t a s a ʕ a
<|ARA|>غرفة	ɣ u r f a
<|ARA|>قناع	q i n aː ʕ
<|ARA|>فرجون	f i r d͡ʒ a w n
<|ARA|>ذاق	ð aː q a
<|ARA|>مصباح	m i sˤ b aː ħ
<|ARA|>سكرجة	s u k r u d͡ʒ a
<|ARA|>بارزد	b aː r z a d
<|ARA|>شبشب	ʃ i b ʃ i b
<|ARA|>انعدى	i n ʕ a d aː
<|ARA|>أسارون	ʔ a s aː r uː n
<|ARA|>قلما	q a l l a m aː
<|ARA|>عنق	ʕ a n a q
<|ARA|>أنسون	ʔ a n s uː n
<|ARA|>فعل	f a ʕ a l a
<|ARA|>فأر	f a ʔ r
<|ARA|>قولنج	q a w l a n d͡ʒ
<|ARA|>باصور	b aː sˤ uː r
<|ARA|>أسلوب	ʔ u s l uː b
<|ARA|>كودن	k a w d a n
<|ARA|>مأدبة	m a ʔ d u b a
<|ARA|>كوسا	k uː s aː
<|ARA|>عدالة	ʕ a d aː l a
<|ARA|>استحضر	i s t a ħ dˤ a r a
<|ARA|>طمأن	tˤ a m ʔ a n a
<|ARA|>مقارنة	m u q aː r a n a
<|ARA|>زخات	z a x x aː t
<|ARA|>اكتسى	i k t a s aː
<|ARA|>مثلجات	m u θ a l l a d͡ʒ aː t
<|ARA|>رذاذ	r a ð aː ð
<|ARA|>جمانة	d͡ʒ u m aː n a
<|ARA|>باقلاء	b aː q i l aː ʔ
<|ARA|>إيثار	ʔ iː θ aː r
<|ARA|>أحاط	ʔ a ħ aː tˤ a
<|ARA|>بطانة	b i tˤ aː n a
<|ARA|>إصبع	ʔ i sˤ b a ʕ
<|ARA|>مؤسسة	m u ʔ a s s a s a
<|ARA|>بقية	b a q i j j a
<|ARA|>سلطوي	s u l tˤ a w i j j
<|ARA|>سعيد	s a ʕ iː d
<|ARA|>تقدس	t a q a d d a s a
<|ARA|>أمس	ʔ a m a s s a
<|ARA|>مطحنة	m a tˤ ħ a n a
<|ARA|>تقوض	t a q a w w a dˤ a
<|ARA|>شربوش	ʃ a r b uː ʃ
<|ARA|>حنظلة	ħ a n ðˤ a l a
<|ARA|>مطفأة	m i tˤ f a ʔ a
<|ARA|>فانوس	f aː n uː s
<|ARA|>جنينة	d͡ʒ u n a j n a
<|ARA|>إزعاج	ʔ i z ʕ aː d͡ʒ
<|ARA|>لئلا	l i ʔ a l l aː
<|ARA|>عيد	ʕ a j j a d a
<|ARA|>إنموذج	ʔ i n m uː ð a d͡ʒ
<|ARA|>أنفحة	ʔ a n f i ħ a
<|ARA|>فوضوي	f a w dˤ a w i j j
<|ARA|>لصف	l a sˤ a f
<|ARA|>مدلجة	m i d l a d͡ʒ a
<|ARA|>جنازة	d͡ʒ a n aː z a
<|ARA|>معتزلة	m u ʕ t a z i l a
<|ARA|>حنجرة	ħ a n d͡ʒ a r a
<|ARA|>مجاور	m u d͡ʒ aː w i r
<|ARA|>لجين	l u d͡ʒ a j n
<|ARA|>رجلة	r u d͡ʒ l a
<|ARA|>مسد	m a s a d a
<|ARA|>جمع	d͡ʒ a m a ʕ a
<|ARA|>سفيه	s a f iː h
<|ARA|>آبيس	ʔ aː b iː s
<|ARA|>دستور	d u s t uː r
<|ARA|>زرشك	z a r r a ʃ k
<|ARA|>صعيد	sˤ a ʕ iː d
<|ARA|>شمال	ʃ a m aː l
<|ARA|>حديد	ħ a d iː d
<|ARA|>مجن	m i d͡ʒ a n n
<|ARA|>أطفال	ʔ a tˤ f aː l
<|ARA|>إفريقية	ʔ i f r iː q i j a
<|ARA|>نموذجي	n a m uː ð a d͡ʒ i j j
<|ARA|>إحصائي	ʔ i ħ sˤ aː ʔ i j j
<|ARA|>ماسح	m aː s i ħ
<|ARA|>تجرد	t a d͡ʒ a r r a d a
<|ARA|>انصرف	i n sˤ a r a f a
<|ARA|>أمريكي	ʔ a m r iː k i j j
<|ARA|>زحف	z a ħ a f a
<|ARA|>علقة	ʕ a l a q a
<|ARA|>أندر	ʔ a n d a r
<|ARA|>سينمائي	s i j n a m aː ʔ i j j
<|ARA|>اعتمد	i ʕ t a m a d a
<|ARA|>قابيل	q aː b iː l
<|ARA|>أيل	ʔ a j j a l
<|ARA|>أعلى	ʔ a ʕ l aː
<|ARA|>كبير	k a b iː r
<|ARA|>ختان	x i t aː n
<|ARA|>تدثر	t a d a θ θ a r a
<|ARA|>حاء	ħ aː ʔ
<|ARA|>فداحة	f a d aː ħ a
<|ARA|>غامق	ɣ aː m i q
<|ARA|>فحشاء	f a ħ ʃ aː ʔ
<|ARA|>جني	d͡ʒ i n n i j j
<|ARA|>طنبور	tˤ u n b uː r
<|ARA|>شلنبر	ʃ u l u n b a r
<|ARA|>مورد	m a w r i d
<|ARA|>إبداعي	ʔ i b d aː ʕ i j j
<|ARA|>تيغار	t a j ɣ aː r
<|ARA|>حامول	ħ aː m uː l
<|ARA|>دكان	d u k k aː n
<|ARA|>سائمة	s aː ʔ i m a
<|ARA|>متشكر	m u t a ʃ a k k i r
<|ARA|>لكم	l a k a m a
<|ARA|>صهريج	sˤ a h r iː d͡ʒ
<|ARA|>مبارزة	m u b aː r a z a
<|ARA|>ضوء	dˤ a w ʔ
<|ARA|>خربش	x a r b a ʃ a
<|ARA|>صحة	sˤ i ħ ħ a
<|ARA|>أزلي	ʔ a z a l i j j
<|ARA|>ديس	d iː s
<|ARA|>حربث	ħ u r b u θ
<|ARA|>عجلة	ʕ a d͡ʒ a l a
<|ARA|>أحمق	ʔ a ħ m a q
<|ARA|>بعلبك	b a ʕ l a b a k k
<|ARA|>قوس	q a w i s a
<|ARA|>سندس	s u n d u s
<|ARA|>وجدة	w a d͡ʒ d a
<|ARA|>حراري	ħ a r aː r i j j
<|ARA|>نسى	n a s s aː
<|ARA|>مخاض	m a x aː dˤ
<|ARA|>خراء	x i r aː ʔ
<|ARA|>مريلة	m i r j a l a
<|ARA|>جدد	d͡ʒ a d a d
<|ARA|>خفج	x a f a d͡ʒ
<|ARA|>دهليز	d i h l iː z
<|ARA|>ناسك	n aː s i k
<|ARA|>مبرة	m a b a r r a
<|ARA|>منقرض	m u n q a r i dˤ
<|ARA|>مويزج	m a w iː z a d͡ʒ
<|ARA|>فلو	f a l u w w
<|ARA|>استصبر	i s t a sˤ b a r a
<|ARA|>أعمى	ʔ a ʕ m aː
<|ARA|>فالودج	f aː l uː d a d͡ʒ
<|ARA|>مسطح	m u s a tˤ tˤ a ħ
<|ARA|>رضائع	r a dˤ aː ʔ i ʕ
<|ARA|>الإسكندرية	a l ʔ i s k a n d a r i j j a
<|ARA|>اتهام	i t t i h aː m
<|ARA|>مماثلة	m u m aː θ a l a
<|ARA|>فراسيون	f a r aː s i j uː n
<|ARA|>نجي	n a d͡ʒ i j j
<|ARA|>بنان	b a n aː n
<|ARA|>أهلي	ʔ a h l i j j
<|ARA|>تواقف	t a w aː q a f a
<|ARA|>قسوة	q a s w a
<|ARA|>دفاع	d i f aː ʕ
<|ARA|>وجب	w a d͡ʒ a b a
<|ARA|>أرخبيل	ʔ a r x a b iː l
<|ARA|>لكن	l aː k i n
<|ARA|>أباس	ʔ u b aː s
<|ARA|>محموم	m a ħ m uː m
<|ARA|>طبشورة	tˤ a b ʃ uː r a
<|ARA|>أنا	ʔ a n aː
<|ARA|>كوز	k uː z
<|ARA|>بتاتا	b a t aː t aː
<|ARA|>ريشة	r iː ʃ a
<|ARA|>فراطة	f u r aː tˤ a
<|ARA|>أباجور	ʔ a b aː d͡ʒ uː r
<|ARA|>صراخة	sˤ a r r aː x a
<|ARA|>معدات	m u ʕ a d d aː t
<|ARA|>فاء	f aː ʔ
<|ARA|>استئمارة	i s t i ʔ m aː r a
<|ARA|>انكمش	i n k a m a ʃ a
<|ARA|>مقبرة	m a q b a r a
<|ARA|>حميم	ħ a m iː m
<|ARA|>إسكندراني	ʔ i s k a n d a r aː n i j j
<|ARA|>احتقر	i ħ t a q a r a
<|ARA|>تلفت	t a l a f f a t a
<|ARA|>مكة	m a k k a
<|ARA|>ارتاع	i r t aː ʕ a
<|ARA|>تحرير	t a ħ r iː r
<|ARA|>سلبي	s a l b i j j
<|ARA|>راود	r aː w a d a
<|ARA|>باذنجان	b aː ð i n d͡ʒ aː n
<|ARA|>سكنجبين	s i k a n d͡ʒ a b iː n
<|ARA|>غارة	ɣ aː r a
<|ARA|>يناير	j a n aː j i r
<|ARA|>لبن	l a b a n
<|ARA|>معمل	m a ʕ m a l
<|ARA|>فوتنج	f uː t a n a d͡ʒ
<|ARA|>موز	m a w z
<|ARA|>حاسوب	ħ aː s uː b
<|ARA|>سابق	s aː b i q
<|ARA|>لحاق	l a ħ aː q
<|ARA|>مسمار	m i s m aː r
<|ARA|>طبيبة	tˤ a b iː b a
<|ARA|>ولكن	w a l aː k i n
<|ARA|>أسفنيك	ʔ a s f a n iː k
<|ARA|>بسمة	b a s m a
<|ARA|>قلقاس	q u l q aː s
<|ARA|>قاقلة	q aː q i l l a
<|ARA|>لؤلؤة	l u ʔ l u ʔ a
<|ARA|>نجاة	n a d͡ʒ aː h
<|ARA|>صقر	sˤ a q r
<|ARA|>طما	tˤ a m aː
<|ARA|>باخوم	b aː x uː m
<|ARA|>فصيل	f a sˤ iː l
<|ARA|>أشترغار	ʔ u ʃ t u r ɣ aː r
<|ARA|>مبكر	m u b a k k i r
<|ARA|>أفلاطون	ʔ a f l aː tˤ uː n
<|ARA|>صوت	sˤ a w t
<|ARA|>صغار	sˤ i ɣ aː r
<|ARA|>سميذ	s a m iː ð
<|ARA|>مكسرات	m u k a s s a r aː t
<|ARA|>هندباء	h i n d i b aː ʔ
<|ARA|>نحال	n a ħ ħ aː l
<|ARA|>أساسي	ʔ a s aː s i j j
<|ARA|>خنق	x a n a q a
<|ARA|>برق	b a r a q a
<|ARA|>الخميس	a l x a m iː s
<|ARA|>كلح	k a l a ħ a
<|ARA|>خزان	x a z z aː n
<|ARA|>جعفر	d͡ʒ a ʕ f a r
<|ARA|>مربوط	m a r b uː tˤ
<|ARA|>دخل	d a x a l
<|ARA|>بليز	b a l iː z
<|ARA|>آيسلندا	ʔ aː j i s l a n d aː
<|ARA|>زأم	z a ʔ a m a
<|ARA|>جيم	d͡ʒ iː m
<|ARA|>مشقة	m a ʃ a q q a
<|ARA|>سيف	s a j f
<|ARA|>فادي	f aː d iː
<|ARA|>لفف	l a f f a f a
<|ARA|>جحا	d͡ʒ u ħ aː
<|ARA|>شهدانج	ʃ a h d aː n a d͡ʒ
<|ARA|>شرسوف	ʃ u r s uː f
<|ARA|>إمالة	ʔ i m aː l a
<|ARA|>مشنة	m i ʃ a n n a
<|ARA|>شتاء	ʃ i t aː ʔ
<|ARA|>ابتلى	i b t a l aː
<|ARA|>أيقظ	ʔ a j q a ðˤ a
<|ARA|>تلفاز	t i l f aː z
<|ARA|>أدحية	ʔ u d ħ i j a
<|ARA|>استل	i s t a l l a
<|ARA|>ديان	d a j j aː n
<|ARA|>كسيح	k a s iː ħ
<|ARA|>باستا	b aː s t aː
<|ARA|>دونمة	d uː n m a
<|ARA|>كذينق	k u ð iː n a q
<|ARA|>أنتما	ʔ a n t u m aː
<|ARA|>شوبك	ʃ a w b a k
<|ARA|>حجن	ħ a d͡ʒ a n a
<|ARA|>لحظتذاك	l a ħ ðˤ a t a ð aː k a
<|ARA|>تقرير	t a q r iː r
<|ARA|>فيل	f iː l
<|ARA|>مصدوم	m a sˤ d uː m
<|ARA|>ألية	ʔ a l j a
<|ARA|>ذمم	ð i m a m
<|ARA|>اليرموك	a l j a r m uː k
<|ARA|>مكان	m a k aː n
<|ARA|>ألقى	ʔ a l q aː
<|ARA|>تطفل	t a tˤ a f f a l a
<|ARA|>ناسفة	n aː s i f a
<|ARA|>شيرج	ʃ a j r a d͡ʒ
<|ARA|>لعنة	l a ʕ n a
<|ARA|>فاصوليا	f aː sˤ uː l i j aː
<|ARA|>اجتماعي	i d͡ʒ t i m aː ʕ i j j
<|ARA|>بنجنكشت	b a n d͡ʒ a n k u ʃ t
<|ARA|>لاذ	l aː ð a
<|ARA|>مايو	m aː j uː
<|ARA|>مغسلة	m a ɣ s a l a
<|ARA|>استمنى	i s t a m n aː
<|ARA|>أعقد	ʔ a ʕ q a d
<|ARA|>بواب	b a w w aː b
<|ARA|>أبيدجان	ʔ a b iː d d͡ʒ aː n
<|ARA|>مرآة	m i r ʔ aː h
<|ARA|>جوهري	d͡ʒ a w h a r i j j
<|ARA|>تصدير	t a sˤ d iː r
<|ARA|>دستوري	d u s t uː r i j j
<|ARA|>سرنديب	s a r a n d iː b
<|ARA|>خادم	x aː d i m
<|ARA|>مستقبلي	m u s t a q b a l i j j
<|ARA|>عانى	ʕ aː n aː
<|ARA|>كلب	k a l b
<|ARA|>شحن	ʃ a ħ a n a
<|ARA|>شامخ	ʃ aː m i x
<|ARA|>قونية	q uː n i j a
<|ARA|>زرقطونا	z a r q a tˤ uː n aː
<|ARA|>متكبر	m u t a k a b b i r
<|ARA|>هندس	h a n d a s a
<|ARA|>صيدلة	sˤ a j d a l a
<|ARA|>اعتزام	i ʕ t i z aː m
<|ARA|>جعفيل	d͡ʒ a ʕ f iː l
<|ARA|>واحة	w aː ħ a
<|ARA|>رمم	r a m m a m a
<|ARA|>مرشد	m u r ʃ i d
<|ARA|>رضوخ	r u dˤ uː x
<|ARA|>إنقاض	ʔ i n q aː dˤ
<|ARA|>ببنودة	b a b n uː d a
<|ARA|>تايوان	t aː j w aː n
<|ARA|>ترنح	t a r a n n a ħ a
<|ARA|>بورتسودان	b uː r t s uː d aː n
<|ARA|>لهي	l a h i j a
<|ARA|>مرو	m a r w
<|ARA|>عصب	ʕ a sˤ a b a
<|ARA|>صأكة	sˤ a ʔ k a
<|ARA|>حيران	ħ a j r aː n
<|ARA|>قدم	q a d a m
<|ARA|>ضبط	dˤ a b a tˤ a
<|ARA|>بقرة	b a q a r a
<|ARA|>روض	r a w w a dˤ a
<|ARA|>باحث	b aː ħ a θ a
<|ARA|>فالوذق	f aː l uː ð a q
<|ARA|>أغلب	ʔ a ɣ l a b
<|ARA|>تفاح	t u f f aː ħ
<|ARA|>توزيع	t a w z iː ʕ
<|ARA|>دارفلفل	d aː r f i l f i l
<|ARA|>فهم	f a h h a m a
<|ARA|>قبرة	q u b b a r a
<|ARA|>استنفد	i s t a n f a d a
<|ARA|>أنضب	ʔ a n dˤ a b a
<|ARA|>سعي	s a ʕ j
<|ARA|>سلجم	s a l d͡ʒ a m
<|ARA|>أنواع	ʔ a n w aː ʕ
<|ARA|>تسعون	t a s ʕ a w n a
<|ARA|>مفاجأة	m u f aː d͡ʒ a ʔ a
<|ARA|>رحيل	r a ħ iː l
<|ARA|>صرب	sˤ a r a b a
<|ARA|>حافة	ħ aː f a
<|ARA|>أنواط	ʔ a n w aː tˤ
<|ARA|>صاع	sˤ aː ʕ
<|ARA|>مازريون	m aː z a r i j uː n
<|ARA|>دهنج	d a h n a d͡ʒ
<|ARA|>منذ	m u n ð u
<|ARA|>فقس	f a q a s a
<|ARA|>عجاوة	ʕ u d͡ʒ aː w a
<|ARA|>أجرب	ʔ a d͡ʒ r a b
<|ARA|>نقطة	n u q tˤ a
<|ARA|>خرطال	x a r tˤ aː l
<|ARA|>كذين	k u ð iː n
<|ARA|>إطراء	ʔ i tˤ r aː ʔ
<|ARA|>القاهرة	a l q aː h i r a
<|ARA|>بحر	b a ħ a r
<|ARA|>احتضن	i ħ t a dˤ a n a
<|ARA|>طيرة	tˤ a j r a
<|ARA|>أسطوري	ʔ u s tˤ uː r i j j
<|ARA|>أوحل	ʔ a w ħ a l a
<|ARA|>زوفا	z uː f aː
<|ARA|>ساحلي	s aː ħ i l i j j
<|ARA|>أسترالي	ʔ u s t u r aː l i j j
<|ARA|>جعضيض	d͡ʒ a ʕ dˤ iː dˤ
<|ARA|>حصل	ħ a sˤ a l
<|ARA|>عنقاد	ʕ i n q aː d
<|ARA|>ترنيم	t a r n iː m
<|ARA|>مسيح	m a s iː ħ
<|ARA|>مطب	m a tˤ a b b
<|ARA|>مرجان	m a r d͡ʒ aː n
<|ARA|>المغرب	a l m a ɣ r i b
<|ARA|>مراوغة	m u r aː w a ɣ a
<|ARA|>بولاد	b uː l aː d
<|ARA|>ردد	r a d d a d a
<|ARA|>مقلق	m u q l i q
<|ARA|>اشتهى	i ʃ t a h aː
<|ARA|>قرد	q a r d
<|ARA|>زائر	z aː ʔ i r
<|ARA|>تجارة	t i d͡ʒ aː r a
<|ARA|>معجزات	m u ʕ d͡ʒ i z aː t
<|ARA|>إدحية	ʔ i d ħ i j a
<|ARA|>وصيد	w a sˤ iː d
<|ARA|>أشل	ʔ a ʃ a l l
<|ARA|>حبارى	ħ u b aː r aː
<|ARA|>نحن	n a ħ n i
<|ARA|>غرب	ɣ a r a b
<|ARA|>تذكرة	t a ð k i r a
<|ARA|>بواليع	b a w aː l iː ʕ
<|ARA|>ياسين	j aː s iː n
<|ARA|>ميعاد	m iː ʕ aː d
<|ARA|>شاء	ʃ aː ʔ
<|ARA|>هرولة	h a r w a l a
<|ARA|>رهبانية	r a h b aː n i j j a
<|ARA|>طائفة	tˤ aː ʔ i f a
<|ARA|>أنهك	ʔ a n h a k a
<|ARA|>قاوق	q aː w u q
<|ARA|>دولاب	d a w l aː b
<|ARA|>صرق	sˤ a r a q
<|ARA|>مظلة	m a ðˤ a l l a
<|ARA|>جائز	d͡ʒ aː ʔ i z
<|ARA|>كارة	k aː r a
<|ARA|>استمات	i s t a m aː t a
<|ARA|>أسف	ʔ a s a f f a
<|ARA|>كسرة	k a s r a
<|ARA|>حنان	ħ a n aː n
<|ARA|>أثث	ʔ a θ θ a θ a
<|ARA|>راجل	r aː d͡ʒ i l
<|ARA|>اعتل	i ʕ t a l l a
<|ARA|>صابورة	sˤ aː b uː r a
<|ARA|>غضة	ɣ a dˤ dˤ a
<|ARA|>سريان	s a r a j aː n
<|ARA|>فتخاء	f a t x aː ʔ
<|ARA|>حظيرة	ħ a ðˤ iː r a
<|ARA|>استجاب	i s t a d͡ʒ aː b a
<|ARA|>فاكرة	f aː k i r a
<|ARA|>لهجة	l a h d͡ʒ a
<|ARA|>نرويجية	n u r w iː d͡ʒ i j j a
<|ARA|>صتع	sˤ a t a ʕ a
<|ARA|>شليل	ʃ a l iː l
<|ARA|>سمن	s a m i n a
<|ARA|>توجه	t a w a d͡ʒ d͡ʒ a h a
<|ARA|>شلال	ʃ a l l aː l
<|ARA|>ظهر	ðˤ a h a r a
<|ARA|>إهداء	ʔ i h d aː ʔ
<|ARA|>بندق	b u n d u q
<|ARA|>صحل	sˤ a ħ i l a
<|ARA|>استوقف	i s t a w q a f a
<|ARA|>قروش	q u r uː ʃ
<|ARA|>كاعب	k aː ʕ i b
<|ARA|>أعيا	ʔ a ʕ j aː
<|ARA|>جخى	d͡ʒ a x x aː
<|ARA|>رأي	r a ʔ j
<|ARA|>مباراة	m u b aː r aː h
<|ARA|>نملة	n a m l a
<|ARA|>فتح	f a t a ħ a
<|ARA|>سيكولوجي	s a j k uː l uː d͡ʒ i j j
<|ARA|>ورشنوفة	w a r ʃ a n uː f a
<|ARA|>احترق	i ħ t a r a q a
<|ARA|>ساحة	s aː ħ a
<|ARA|>المريخ	a l m i r r iː x
<|ARA|>غمود	ɣ u m uː d
<|ARA|>قاوون	q aː w uː n
<|ARA|>اتسم	i t t a s a m a
<|ARA|>تراب	t u r aː b
<|ARA|>أبهج	ʔ a b h a d͡ʒ a
<|ARA|>بلور	b i l l a w r
<|ARA|>أرغان	ʔ a r ɣ aː n
<|ARA|>شنع	ʃ a n n a ʕ a
<|ARA|>أرثوذكسي	ʔ u r θ uː ð u k s i j j
<|ARA|>جبيز	d͡ʒ a b iː z
<|ARA|>ذهب	ð a h a b
<|ARA|>وقت	w a q a t
<|ARA|>شهادة	ʃ a h aː d a
<|ARA|>وقع	w a q a ʕ a
<|ARA|>دراسي	d i r aː s i j j
<|ARA|>ندم	n a d a m
<|FAS|>دلیل	d a l i l
<|FAS|>گلو	ɡ a l oː
<|FAS|>دگرجنس‌گرا	d e ɡ a ɾ d͡ʒ e n s ɡ a ɾ ɑː
<|FAS|>مرند	m a ɾ a n d
<|FAS|>حمام	h a m m ɑː m
<|FAS|>کتاب	k e t ɑː b
<|FAS|>اعضا	a ʔ z ɑː
<|FAS|>پیچیدن	p e t͡ʃ i d a
<|FAS|>برادر	b a ɾ ɑː d a ɾ
<|FAS|>رفتار	ɾ a f t ɑː ɾ
<|FAS|>شور	ʃ oː ɾ
<|FAS|>بوی	b oː j
<|FAS|>چطور	t͡ʃ e t o v ɾ
<|FAS|>بنیادگرا	b o n j ɑː d ɡ a ɾ ɑː
<|FAS|>رأی	ɾ a ʔ j
<|FAS|>غافت	ɢ ɑː f e t
<|FAS|>هشت	h a ʃ t
<|FAS|>پاکستانی	p ɑː k i s t ɑː n iː
<|FAS|>ذهن	z e h n
<|FAS|>بهشت	b e h e ʃ t
<|FAS|>رباعی	ɾ o b ɑː ʔ iː
<|FAS|>فهرست	f e h ɾ e s t
<|FAS|>دراییدن	d a ɾ ɑː j iː d a n
<|FAS|>کس	k a s
<|FAS|>بختر	b e x t a ɾ
<|FAS|>شعب	ʃ o ʔ a b
<|FAS|>آهنگ	ɑː h a n ɡ
<|FAS|>چاشنی	t ʃ ɑː ʃ n iː
<|FAS|>بز	b o z
<|FAS|>صورتی	s uː ɾ a t iː
<|FAS|>هی	h e j
<|FAS|>سلیمان	s o l e j m ɑː n
<|FAS|>اجازه	e d͡ʒ ɑː z e
<|FAS|>پوشیدن	p oː ʃ iː d a n
<|FAS|>قسمت	ɢ i s m a t
<|FAS|>پختن	p o x t a n
<|FAS|>برخوردار	b a ɾ x o ɾ d ɑː ɾ
<|FAS|>بامداد	b ɑː m d ɑː n
<|FAS|>کهکشان‌ها	k a h k a ʃ ɑː n h ɑː
<|FAS|>دچار	d o t͡ʃ ɑː ɾ
<|FAS|>سرودن	s o ɾ uː d a n
<|FAS|>ژامبون	ʒ ɑː m b o n
<|FAS|>پتک	p o t k
<|FAS|>آینده	ɑː j a n d a
<|FAS|>حساب	h e s ɑː b
<|FAS|>هفده	h a b d a h
<|FAS|>آبدست	ɑː b d a s t
<|FAS|>گیان	ɡ o j ɑː n
<|FAS|>هنر	h o n a ɾ
<|FAS|>زورخانه	z oː ɾ x ɑː n a
<|FAS|>گواه	ɡ o v ɑː h
<|FAS|>سردار	s a ɾ d ɑː ɾ
<|FAS|>مهم	m o h e m m
<|FAS|>اسپرزه	e s p a ɾ z e
<|FAS|>گی	a ɡ iː
<|FAS|>نسخه	n o s x e
<|FAS|>مردها	m a ɾ d h ɑː
<|FAS|>مؤسسه	m o ʔ a s s a s e
<|FAS|>کیمیا	k iː m i j ɑː
<|FAS|>کاروان	k ɑː ɾ v ɑː n
<|FAS|>مهربانی	m e h ɾ a b ɑː n iː
<|FAS|>فضا	f a z ɑː
<|FAS|>تقسیم	t a ɢ s i m
<|FAS|>زیرزمین	z iː ɾ z a m iː n
<|FAS|>پناهنده	p a n ɑː h a n d e
<|FAS|>سده	s a d a
<|FAS|>ترازو	t a ɾ ɑː z uː
<|FAS|>باب	b ɑː b
<|FAS|>ذبح	z e b h
<|FAS|>دادار	d ɑː d ɑː r
<|FAS|>آلرژی	ɑː l i ɾ ʒ iː
<|FAS|>زین	z i n
<|FAS|>دزد	d o z d
<|FAS|>ذکر	z a k a ɾ
<|FAS|>مسافت	m a s ɑː f a t
<|FAS|>کندن	k a n d a n
<|FAS|>کنفرانس	k o n f e ɾ ɑː n s
<|FAS|>میغ	m e ɢ
<|FAS|>جنسی	d͡ʒ e n s iː
<|FAS|>بیش	b e ʃ
<|FAS|>آستانه‌ای	ɑː s t ɑː n a iː
<|FAS|>گلابی	ɡ o l ɑː b iː
<|FAS|>زیاد	z i j ɑː d
<|FAS|>تکیدن	t a k i d a n
<|FAS|>بهتان	b o h t u n
<|FAS|>جایگاه	d͡ʒ ɑː j ɡ ɑː h
<|FAS|>زیست‌شناس	z iː s t ʃ e n ɑː s
<|FAS|>ایدون	e d u n
<|FAS|>بابل	b ɑː b i l
<|FAS|>مربوط	m a ɾ b u t
<|FAS|>غور	ɢ o v ɾ
<|FAS|>پاداش	p ɑː d ɑː ʃ
<|FAS|>بیمار	b e m ɑː ɾ
<|FAS|>لثه	l a s e
<|FAS|>البرز	ʔ a l b o ɾ z
<|FAS|>هدیه	h a d i j a
<|FAS|>ملاقات	m o l ɑː ɢ ɑː t
<|FAS|>فریدون	f e ɾ e i d uː n
<|FAS|>مجازات	m o d ʒ ɑː z ɑː t
<|FAS|>شوره	ʃ oː ɾ e
<|FAS|>ویر	v i ɾ
<|FAS|>چمیدن	t͡ʃ a m i d a n
<|FAS|>کالبد	k ɑː l b u d
<|FAS|>سرپرستی	s a ɾ p a ɾ a s t iː
<|FAS|>یخچال	j a x t͡ʃ ɑː l
<|FAS|>ادغام	e d ɢ ɑː m
<|FAS|>آنغوزه	ɑː n ɢ u z a
<|FAS|>پردیس	p a ɾ d e s
<|FAS|>هنوز	h a n oː z
<|FAS|>گراز	ɡ o ɾ ɑː z
<|FAS|>قهرمان	ɢ a h ɾ a m ɑː n
<|FAS|>ترش	t o ɾ ʃ
<|FAS|>بیمناک	b i n m ɑː k
<|FAS|>ژولیدن	ʒ uː l iː d a n
<|FAS|>واش	v ɑ ʃ
<|FAS|>می‌خواهم	m iː x ɑː h a m
<|FAS|>پرندگان	p a ɾ a n d a ɡ ɑː n
<|FAS|>سورپرایز	s u r p e ɾ ɑ j z
<|FAS|>دماغ	d a m ɑː ɢ
<|FAS|>خاکستری	x ɑː k i s t a ɾ iː
<|FAS|>ژرفا	ʒ a ɾ f ɑː
<|FAS|>زرناپا	z u r n ɑː p ɑː
<|FAS|>دین‌داری	d i n d ɑː ɾ iː
<|FAS|>بلعیدن	b a l ʔ iː d a n
<|FAS|>ذات	z ɑː t
<|FAS|>چیش	t ʃ i ʃ
<|FAS|>همیشه	h a m e ʃ a
<|FAS|>مرغ	m o ɾ ɢ
<|FAS|>فصل	f a s l
<|FAS|>یافتن	j ɑː f t a n
<|FAS|>بلور	b i l oː ɾ
<|FAS|>بنگاه	b o n ɡ ɑː h
<|FAS|>دعا	d o ʔ ɑː
<|FAS|>پاپ	p ɑː p
<|FAS|>آمار	ɑː m ɑː ɾ
<|FAS|>ایستادن	i s t ɑː d a n
<|FAS|>پزشک	p e z e ʃ k
<|FAS|>خورشید	x o ɾ ʃ iː d
<|FAS|>سیاست	s i j ɑː s a t
<|FAS|>پرچم	p a ɾ t͡ʃ a m
<|FAS|>بخاطر	b a x ɑː t i ɾ i
<|FAS|>گروه	ɡ o ɾ uː h
<|FAS|>علاوه	a l ɑː v a
<|FAS|>خط	x a t
<|FAS|>به‌آفرید	b e h ɑː f a ɾ iː d
<|FAS|>گو	ɡ o v
<|FAS|>یراق	j a ɾ ɑː ɢ
<|FAS|>نویسه‌گردانی	n e v iː s e ɡ a ɾ d ɑː n iː
<|FAS|>مردانه	m a ɾ d ɑː n a
<|FAS|>پنیر	p a n i ɾ
<|FAS|>اشکال	a ʃ k ɑː l
<|FAS|>صنم	s a n a m
<|FAS|>سمند	s a m a n d
<|FAS|>تار	t ɑː ɾ
<|FAS|>سنان	s e n ɑː n
<|FAS|>ژرفی	ʒ a ɾ f iː
<|FAS|>حکومت	h o k uː m a t
<|FAS|>گون	ɡ oː n
<|FAS|>درودن	d o ɾ uː d a n
<|FAS|>سفینه	s a f i n a
<|FAS|>آشفته	ɑː ʃ u f t a
<|FAS|>صورتى	s u ɾ a t iː
<|FAS|>اصفهانی	e s f a h ɑː n iː
<|FAS|>شمعدان	ʃ a m ʔ d ɑː n
<|FAS|>قفس	ɢ a f a s
<|FAS|>پرواز	p a ɾ v ɑː z
<|FAS|>رسانیدن	ɾ a s ɑː n iː d a n
<|FAS|>اً	t a n v i n
<|FAS|>گشادی	ɡ o ʃ ɑː d iː
<|FAS|>میهن‌پرست	m i h a n p a ɾ a s t
<|FAS|>باغبان	b ɑː ɢ b ɑː n
<|FAS|>افرنگ	a f ɾ a n ɡ
<|FAS|>دستگاه	d a s t ɡ ɑː h
<|FAS|>اندیشیدن	a n d e ʃ i d a n
<|FAS|>مریض	m a ɾ i z
<|FAS|>خاک	x ɑː k
<|FAS|>دوغ	d oː ɢ
<|FAS|>نیازها	n iː j ɑː z h ɑː
<|FAS|>صادق	s ɑː d i ɢ
<|FAS|>تقریبا	t a ɢ ɾ iː b a n
<|FAS|>بعل	b a ʔ l
<|FAS|>ران	ɾ ɑː n
<|FAS|>نسرین	n a s ɾ iː n
<|FAS|>تازگی	t ɑː z a ɡ iː
<|FAS|>نوک	n v a k
<|FAS|>مجرد	m o d͡ʒ a ɾ ɾ a d
<|FAS|>حکم	h o k m
<|FAS|>وهم	v a h m
<|FAS|>میلادی	m iː l ɑː d iː
<|FAS|>تحقیق	t a h ɢ i ɢ
<|FAS|>موم	m uː m
<|FAS|>نتیجه	n a t i d͡ʒ a
<|FAS|>دیگر	d i ɡ a ɾ
<|FAS|>پور	p u ɾ
<|FAS|>زرشک	z e ɾ e ʃ k
<|FAS|>قیمت	ɢ a j m a t
<|FAS|>شاهد	ʃ ɑː h i d
<|FAS|>چکمه	t͡ʃ a k m a
<|FAS|>ابرش	a b ɾ a ʃ
<|FAS|>قند	ɢ a n d
<|FAS|>وزن	v a z n
<|FAS|>وظیفه	v a z i f a
<|FAS|>مناسبت	m o n ɑː s e b a t
<|FAS|>بخار	b o x ɑː ɾ
<|FAS|>زان	z ɑː n
<|FAS|>مدرسه	m a d ɾ a s a
<|FAS|>باروت	b ɑː ɾ uː t
<|FAS|>حشیش	h a ʃ i ʃ
<|FAS|>آغیل	ɑː ɢ iː l
<|FAS|>پستان	p e s t ɑː n
<|FAS|>شاهانشاه	ʃ ɑː h ɑː n ʃ ɑː h
<|FAS|>آمرزیدن	ɑː m u ɾ z iː d a n
<|FAS|>الموت	ʔ a l a m uː t
<|FAS|>شراب	ʃ a ɾ ɑː b
<|FAS|>شکافتن	ʃ e k ɑː f t a n
<|FAS|>خاده	x ɑː d a
<|FAS|>کبریت	k e b ɾ iː t
<|FAS|>نوروز	n a v ɾ s z
<|FAS|>جستن	d͡ʒ a s t a n
<|FAS|>فضازمان	f a z ɑː z a m ɑː n
<|FAS|>پیامک	p a j ɑː m a k
<|FAS|>اخترمار	a x t a ɾ m ɑː ɾ
<|FAS|>لوز	l a v z
<|FAS|>عقرب	ʔ a ɢ ɾ a b
<|FAS|>مردانگی	m a ɾ d ɑː n a ɡ iː
<|FAS|>لات	l ɑː t
<|FAS|>طعم	t a ʔ m
<|FAS|>خسیس	x a s i s
<|FAS|>فاصله	f ɑː s i l a
<|FAS|>بابا	b ɑː b ɑː
<|FAS|>گنجشک	ɡ o n d͡ʒ e ʃ k
<|FAS|>پشمین	p a ʃ m iː n
<|FAS|>زنانه	z a n ɑː n a
<|FAS|>آلت	ɑː l a t
<|FAS|>شهود	ʃ o h uː d
<|FAS|>مراسم	m a ɾ ɑː s i m
<|FAS|>سختن	s o x t a n
<|FAS|>ریشه‌شناسی	ɾ e ʃ a ʃ i n ɑː s iː
<|FAS|>ادبیات	a d a b i j ɑː t
<|FAS|>شاهکار	ʃ ɑː h k ɑː ɾ
<|FAS|>افسوس	a f s oː s
<|FAS|>شعبه	ʃ o ʔ b e
<|FAS|>قدیمی	ɢ a d i m iː
<|FAS|>بارود	b ɑː ɾ uː d
<|FAS|>میان	m i j ɑː n
<|FAS|>قرمز	ɢ i ɾ m i z
<|FAS|>دانشمند	d ɑː n i ʃ m a n d
<|FAS|>پرسش	p o ɾ s e ʃ
<|FAS|>گوهر	ɡ a v h a ɾ
<|FAS|>خز	x a z
<|FAS|>شخص	ʃ a x s
<|FAS|>سجستان	s a d͡ʒ a s t ɑː n
<|FAS|>مشرک	m o ʃ ɾ e k
<|FAS|>پرنده	p a ɾ a n d a
<|FAS|>اندیشه	a n d e ʃ a
<|FAS|>نشان	n e ʃ ɑː n
<|FAS|>شهر	ʃ a h ɾ
<|FAS|>در	d a ɾ
<|FAS|>لهذا	l e h ɑː z ɑː
<|FAS|>زراوند	z a ɾ ɑː v a n d
<|FAS|>بشقاب	b o ʃ ɢ ɑː b
<|FAS|>صاعقه	s ɑː ʔ i ɢ a
<|FAS|>دربان	d a ɾ b ɑː n
<|FAS|>ژاپنی	ʒ ɑː p u n iː
<|FAS|>دهستان	d e h e s t ɑː n
<|FAS|>تعریف	t a ʔ ɾ i f
<|FAS|>دارم	d ɑː ɾ a m
<|FAS|>اتصال	e t t e s ɑː l
<|FAS|>ستاره‌شناس	s e t ɑː ɾ e ʃ e n ɑː s
<|FAS|>متفاوت	m o t a f ɑː v e t
<|FAS|>تودری	t u d a ɾ iː
<|FAS|>فک	f a k
<|FAS|>ارزیدن	a ɾ z i d a n
<|FAS|>نریمان	n a ɾ e m ɑː n
<|FAS|>شیرین‌ترین	ʃ iː ɾ iː n t a ɾ iː n
<|FAS|>آمیزش	ɑː m iː z e ʃ
<|FAS|>دانشگاه	d ɑː n i ʃ ɡ ɑː h
<|FAS|>کوچک‌تر	k uː t ʃ e k t a ɾ
<|FAS|>ختم	x a t m
<|FAS|>سفید	s a f e d
<|FAS|>تشریح	t a ʃ ɾ e h
<|FAS|>کارورزی	k ɑː ɾ v a ɾ z iː
<|FAS|>خاموش	x ɑː m oː ʃ
<|FAS|>ترک	t a ɾ k
<|FAS|>بوزه	b oː z a
<|FAS|>گسترده	ɡ o s t a ɾ d e
<|FAS|>پشت	p o ʃ t e
<|FAS|>پوزخند	p uː z x a n d
<|FAS|>بیچاره	b e t͡ʃ ɑː ɾ a
<|FAS|>سقف	s a ɢ f
<|FAS|>همساده	h o m s ɑː d e
<|FAS|>دلگیر	d e l ɡ iː ɾ
<|FAS|>وضوح	v o z uː h
<|FAS|>زورمند	z oː ɾ m a n d
<|FAS|>مسافرت	m o s ɑː f e ɾ a t
<|FAS|>باریک‌تر	b ɑː ɾ iː k t a ɾ
<|FAS|>اذان	a z ɑː n
<|FAS|>حدادی	h a d ɑː d iː
<|FAS|>ازگیل	a z ɡ i l
<|FAS|>پیوسیدن	p a j oː s iː d a n
<|FAS|>ابد	a b a d
<|FAS|>الله‌قلی	a l l ɑː h ɢ u l iː
<|FAS|>سالگی	s ɑː l a ɡ iː
<|FAS|>جواری	d͡ʒ o v ɑː ɾ iː
<|FAS|>دروغ‌ها	d o ɾ uː ɢ h ɑː
<|FAS|>دیوان	d e v ɑː n
<|FAS|>چغندر	t͡ʃ o ɢ o n d a ɾ
<|FAS|>مالی	m ɑː l iː
<|FAS|>سوز	s oː z
<|FAS|>گم	ɡ o m
<|FAS|>خسروانی	x o s ɾ a v ɑː n iː
<|FAS|>پنبه	p a m b e
<|FAS|>انار	a n ɑː ɾ
<|FAS|>روزگار	ɾ oː z i ɡ ɑː ɾ
<|FAS|>طبقه	t a b a ɢ a
<|FAS|>مادرانه	m ɑː d a ɾ ɑː n a
<|FAS|>منفی	m a n f iː
<|FAS|>خوک	x uː k
<|FAS|>مشکی	m e ʃ k iː
<|FAS|>گرم	ɡ a ɾ m
<|FAS|>نیرومند	n iː ɾ uː m a n d
<|FAS|>آسمان	ɑː s i m ɑː n
<|FAS|>بلی	b a l e
<|FAS|>دل	d e l
<|FAS|>بین	b a j n
<|FAS|>اسپریس	ʔ e s p a ɾ e s
<|FAS|>ختنه‌گاه	x a t n a ɡ ɑː h
<|FAS|>زشت	z e ʃ t
<|FAS|>بعدا	b a ʔ d a n
<|FAS|>اتراق	o t ɾ ɑː ɢ
<|FAS|>مردم‌شناس	m a ɾ d u m ʃ i n ɑː s
<|FAS|>زندانی	z e n d ɑː n iː
<|FAS|>گستردن	ɡ o s t a ɾ d a n
<|FAS|>فسیل	f o s iː l
<|FAS|>بعد	b a ʔ d
<|FAS|>ساختمان	s ɑː x t i m ɑː n
<|FAS|>خون	x u n
<|FAS|>استعداد	e s t e ʔ d ɑː d
<|FAS|>فرازمینی	f a ɾ ɑː z a m iː n iː
<|FAS|>کرشن	k ɾ i ʃ n
<|FAS|>تمام	t a m ɑː m
<|FAS|>پل	p o l
<|FAS|>بحث	b a h s
<|FAS|>جهان	d͡ʒ a h ɑː n
<|FAS|>القاعده	a l ɢ ɑː ʔ i d a
<|FAS|>رهبر	ɾ a h b a ɾ
<|FAS|>هنگ	h a n ɡ
<|FAS|>آرپا	ɑː ɾ p ɑː
<|FAS|>محبوب	m a h b u b
<|FAS|>ابلیس	e b l iː s
<|FAS|>فرمانده	f a ɾ m ɑː n d i h
<|FAS|>افسانه	a f s ɑː n a
<|FAS|>زبان‌ها	z a b ɑː n h ɑː
<|FAS|>بیضه	b a j z a
<|FAS|>اجتماع	e d͡ʒ t e m ɑː ʔ
<|FAS|>مس	m e s
<|FAS|>دوره	d a v ɾ a
<|FAS|>کلفخشنگ	k a l a f a x ʃ a n ɡ
<|FAS|>فهم	f a h m
<|FAS|>شهرزاد	ʃ a h ɾ z ɑː d
<|FAS|>تازه‌تر	t ɑː z e t a ɾ
<|FAS|>تیز	t e z
<|FAS|>خربوزه	x a ɾ b u z a
<|FAS|>البته	a l b a t t a
<|FAS|>خنده	x a n d a
<|FAS|>آوازه	ɑː v ɑː z a
<|FAS|>آجر	ɑː d͡ʒ u ɾ
<|FAS|>کار	k ɑː ɾ
<|FAS|>رندیدن	ɾ a n d i d a n
<|FAS|>امسال	e m s ɑː l
<|FAS|>اردو	o ɾ d uː
<|FAS|>مغازه	m a ɢ ɑː z a
<|FAS|>سرجوخه	s a ɾ d͡ʒ u x a
<|FAS|>مجموعه	m a d͡ʒ m u ʔ a
<|FAS|>صنعتی	s a n ʔ a t iː
<|FAS|>زیویدن	z iː v iː d a n
<|FAS|>راهب	ɾ ɑː h i b
<|FAS|>کرس	k e ɾ s
<|FAS|>معروف	m a ʔ ɾ u f
<|FAS|>اسب	a s b
<|FAS|>پیرتر	p iː ɾ t a ɾ
<|FAS|>خواستار	x ɑː s t ɑː ɾ
<|FAS|>شیراز	ʃ e ɾ ɑː z
<|FAS|>کم‌مایه	k a m m ɑː j a
<|FAS|>زنجبیل	z a n d͡ʒ a b iː l
<|FAS|>فوج	f a v d͡ʒ
<|FAS|>فائده	f ɑː ʔ e d e
<|FAS|>خوردن	x o ɾ d a n
<|FAS|>رخام	ɾ o x ɑː m
<|FAS|>اجاق	o d͡ʒ ɑː ɢ
<|FAS|>قهوه‌ای	ɢ a h v a ʔ iː
<|FAS|>مذهبی	m a z h a b iː
<|FAS|>آهار	ɑː h ɑː ɾ
<|FAS|>فارسی	f ɑː ɾ s iː
<|FAS|>رمضان	ɾ a m a z ɑː n
<|FAS|>ما	m ɑː
<|FAS|>بام	b ɑː m
<|FAS|>چنانکه	t͡ʃ o n ɑː n k e
<|FAS|>هواپیما	h a v ɑː p a j m ɑː
<|FAS|>آرامی	ɑː ɾ ɑː m iː
<|FAS|>پودنه	p u d i n a
<|FAS|>ده	d a h
<|FAS|>شپش‌ها	ʃ e p e ʃ h ɑː
<|FAS|>خاطره	x ɑː t i ɾ a
<|FAS|>نه	n o h
<|FAS|>مجسمه	m o d͡ʒ a s s a m e
<|FAS|>فغفور	f a ɢ f uː ɾ
<|FAS|>مثال	m e s ɑː l
<|FAS|>تعارف	t a ʔ ɑː ɾ u f
<|FAS|>خامه	x ɑː m a
<|FAS|>بسته	b a s t a
<|FAS|>نیست	n e s t
<|FAS|>ملا	m o l ɑː
<|FAS|>منع	m a n ʔ
<|FAS|>ایران	e ɾ ɑː n
<|FAS|>قاصدک	ɢ ɑː s i d a k
<|FAS|>افزودن	a f z u d a n
<|FAS|>هندو	h e n d uː
<|FAS|>مجبور	m a d͡ʒ b u ɾ
<|FAS|>ایرانیان	iː ɾ ɑː n i j ɑː n
<|FAS|>بامزه‌ترین	b ɑː m a z e t a ɾ iː n
<|FAS|>شیشه	ʃ i ʃ a
<|FAS|>کالیفرنیا	k ɑː l iː f o r n i j ɑː
<|FAS|>خیلی	x a j l e
<|FAS|>قفل	ɢ u f l
<|FAS|>فاحش	f ɑː h e ʃ
<|FAS|>ظرف	z a ɾ f
<|FAS|>سالار	s ɑː l ɑː ɾ
<|FAS|>شرکت	ʃ e ɾ k a t
<|FAS|>هرمز	h o ɾ m o z
<|FAS|>نغز	n a ɢ z
<|FAS|>کابل	k ɑː b u l
<|FAS|>نامور	n ɑː m v a ɾ
<|FAS|>خزاعی	x a z ɑː ʔ iː
<|FAS|>عسل	a s a l
<|FAS|>شلوار	ʃ a l v ɑː ɾ
<|FAS|>خروس	x o ɾ uː s
<|FAS|>پاشیدن	p ɑː ʃ iː d a n
<|FAS|>چاه‌کور	t͡ʃ ɑː h k a v ɾ
<|FAS|>هرزگی	h a ɾ z a ɡ iː
<|FAS|>نشلیدن	n e ʃ e l iː d a n
<|FAS|>جامعه‌شناس	d͡ʒ ɑː m i ʔ a ʃ i n ɑː s
<|FAS|>خاتون	x ɑː t uː n
<|FAS|>قبرستان	ɢ a b ɾ i s t ɑː n
<|FAS|>بهار	b a h ɑː ɾ
<|FAS|>کارزار	k ɑː ɾ z ɑː ɾ
<|FAS|>شام	ʃ ɑː m
<|FAS|>پلان	p e l ɑː n
<|FAS|>هندی	h e n d iː
<|FAS|>امشب	e m ʃ a b
<|FAS|>توصیه	t a v s i j a
<|FAS|>آشوب‌ها	ɑː ʃ uː b h ɑː
<|FAS|>ییلاق	j a j l ɑː ɢ
<|FAS|>تکرار	t a k ɾ ɑː ɾ
<|FAS|>وسیع	v a s e ʔ
<|FAS|>قالب	ɢ ɑː l i b
<|FAS|>خیس	x iː s
<|FAS|>امروز	e m ɾ uː z
<|FAS|>بسیار	b e s j ɑː ɾ
<|FAS|>دیگدان	d e ɡ d ɑː n
<|FAS|>میخی	m iː x iː
<|FAS|>اسپغول	e s p a ɢ uː l
<|FAS|>نوشیدنی	n u ʃ i d a n iː
<|FAS|>زره	z e ɾ e h
<|FAS|>عفو	ʔ a f v
<|FAS|>حرفه	h e ɾ f e
<|FAS|>گوز	ɡ a v z
<|FAS|>گزاردن	ɡ o z ɑː ɾ d a n
<|FAS|>ختنه	x a t n e
<|FAS|>بندر	b a n d a ɾ
<|FAS|>شغال	ʃ o ɢ ɑː l
<|FAS|>نکونام	n e k uː n ɑː m
<|FAS|>غالب	ɢ ɑː l e b
<|FAS|>تعظیم	t a ʔ z i m
<|FAS|>ناهید	n ɑː h iː d
<|FAS|>بهترین	b e h t a ɾ i n
<|FAS|>استیون	e s t iː v e n
<|FAS|>پیشانی	p e ʃ ɑː n iː
<|FAS|>ساحل	s ɑː h i l
<|FAS|>انسان	e n s ɑː n
<|FAS|>آذربایجان	ɑː z a ɾ b ɑː j d͡ʒ ɑː n
<|FAS|>بادبانی	b ɑː d b ɑː n iː
<|FAS|>فرودگاه	f o ɾ uː d ɡ ɑː h
<|FAS|>هفته‌ها	h a f t e h ɑː
<|FAS|>یپک	j e p a k
<|FAS|>اسپست	a s p i s t
<|FAS|>سنبوسه	s a m b oː s a
<|FAS|>حسن	h a s a n
<|FAS|>باف	b ɑː f
<|FAS|>تقویت	t a ɢ v i j a t
<|FAS|>خواستن	x ɑː s t a n
<|FAS|>پایگاه	p ɑː j i ɡ ɑː h
<|FAS|>تبدیل	t a b d i l
<|FAS|>غلامی	ɢ o l ɑː m iː
<|FAS|>شدنی	ʃ o d a n iː
<|FAS|>امتحان	e m t e h ɑː n
<|FAS|>خندان	x a n d ɑ n
<|FAS|>احتیاج	e h t i j ɑː d͡ʒ
<|FAS|>قیچی	ɢ a j t͡ʃ iː
<|FAS|>سوخ	s oː x
<|FAS|>اثبات	e s b ɑː t
<|FAS|>بایست	b ɑː j e s t
<|FAS|>متعلق	m o t a ʔ a l l e ɢ
<|FAS|>اتفاق	e t t e f ɑː ɢ
<|FAS|>نجس‌ترین	n a d ʒ a s t a ɾ iː n
<|FAS|>لجن	l a d͡ʒ a n
<|FAS|>گیک	ɡ iː k
<|FAS|>تجربی	t a d ʒ ɾ o b iː
<|FAS|>تقویم	t a ɢ v i m
<|FAS|>زیر	z e ɾ
<|FAS|>احمدی‌نژاد	a h m a d i n i ʒ ɑː d
<|FAS|>رعد	ɾ a ʔ d
<|FAS|>آذرخش	ɑː z a ɾ a x ʃ
<|FAS|>وزغ	v a z a ɢ
<|FAS|>تحفه	t o h f e
<|FAS|>مومیایی	m oː m i j ɑː j iː
<|FAS|>جزیره	d͡ʒ a z i ɾ a
<|FAS|>تهران	t a h ɾ ɑː n
<|FAS|>مردم	m a ɾ d u m
<|FAS|>آدم	ɑː d a m
<|FAS|>تعداد	t e ʔ d ɑː d
<|FAS|>گرزه	ɡ o ɾ z e
<|FAS|>کردی	k o ɾ d iː
<|FAS|>پاییز	p ɑː iː z
<|FAS|>نقطه	n o ɢ t e
<|FAS|>شنبه	ʃ a n b a
<|FAS|>خواجه	x ɑː d͡ʒ a
<|FAS|>ناقص	n ɑː ɢ i s
<|FAS|>هول	h a v l
<|FAS|>ارده	a ɾ d a
<|FAS|>وقتی	v a ɢ t e
<|FAS|>خودنویس	x o d n e v iː s
<|FAS|>چشمان	t ʃ e ʃ m ɑː
<|FAS|>مشارکت	m o ʃ ɑː ɾ e k a t
<|FAS|>خندیدن	x a n d i d a n
<|FAS|>قید	ɢ e j d
<|FAS|>عمر	o m a ɾ
<|FAS|>قاچاقچی	ɢ ɑː t͡ʃ ɑː ɢ t͡ʃ iː
<|FAS|>ماله	m ɑː l a
<|FAS|>بو	b oː
<|FAS|>طور	t a v ɾ
<|FAS|>مؤمن	m o ʔ m e n
<|FAS|>بی‌عرضه	b e u ɾ z a
<|FAS|>پریستان	p a ɾ i j i s t ɑː n
<|FAS|>سایه	s ɑː j a
<|FAS|>گوشواره	ɡ oː ʃ v ɑː ɾ a
<|FAS|>شیطانی	ʃ a j t ɑː n iː
<|FAS|>تصحیح	t a s h e h
<|FAS|>را	ɾ ɑː
<|FAS|>جانباز	d͡ʒ ɑː m b ɑː z
<|FAS|>مولانا	m o v l ɑː n ɑː
<|FAS|>كنج	k o n d͡ʒ
<|FAS|>سخت	s a x t
<|FAS|>آبشار	ɑː b ʃ ɑː ɾ
<|FAS|>گلپر	ɡ o l p a ɾ
<|FAS|>گندم	ɡ a n d u m
<|FAS|>شکلاتی	ʃ o k o l ɑ t i
<|FAS|>سیم	s e j o m
<|FAS|>ناپسند	n ɑː p a s a n d
<|FAS|>شکستنی	ʃ i k a s t a n iː
<|FAS|>رواق	ɾ e v ɑː ɢ
<|FAS|>گشادن	ɡ o ʃ ɑː d a n
<|FAS|>معدنی	m a ʔ d a n iː
<|FAS|>راجستان	ɾ ɑː d͡ʒ a s t a n
<|FAS|>رونق	ɾ a v n a ɢ
<|FAS|>سپندان	s e p a n d ɑː n
<|FAS|>چامه‌سرایی	t͡ʃ ɑː m a s a ɾ ɑː j iː
<|FAS|>گرا	ɡ a ɾ ɑː
<|FAS|>قاضی	ɢ ɑː z iː
<|FAS|>راحت	ɾ ɑː h a t
<|FAS|>ارزش	a ɾ z i ʃ
<|FAS|>خستگی	x a s t i ɡ iː
<|FAS|>ره	r a h
<|FAS|>انتقاد	e n t e ɢ ɑː d
<|FAS|>گاراژ	ɡ ɑː ɾ ɑː ʒ
<|FAS|>رابط	ɾ ɑː b i t
<|FAS|>نوشیدن	n oː ʃ iː d a n
<|FAS|>بلگ	b a l ɡ
<|FAS|>صلح	s u l h
<|FAS|>شیرین	ʃ i ɾ i n
<|FAS|>خارجی	x ɑː ɾ i d͡ʒ iː
<|FAS|>جدید	d͡ʒ a d i d
<|FAS|>عادی	ʔ ɑː d iː
<|FAS|>شکسته‌نستعلیق	ʃ e k a s t e n a s t a ʔ l iː ɢ
<|FAS|>پالایش	p ɑː l ɑː j i ʃ
<|FAS|>خوشگل	x o ʃ ɡ e l
<|FAS|>ژاژ	ʒ ɑː ʒ
<|FAS|>فروردین	f a ɾ v a ɾ d iː n
<|FAS|>اصل	a s l
<|FAS|>زوجیت	z a v d͡ʒ i j a t
<|FAS|>موز	m a v z
<|FAS|>سامانه	s ɑː m ɑː n a
<|FAS|>ین	e n
<|FAS|>نان	n ɑː n
<|FAS|>سلسله	s e l s e l e
<|FAS|>زوال	z a v ɑː l
<|FAS|>حتما	h a t m a n
<|FAS|>اخبار	a x b ɑː ɾ
<|FAS|>نعوظ	n o ʔ uː z
<|FAS|>آغاز	ɑː ɢ ɑː z
<|FAS|>استقبال	e s t e ɢ b ɑː l
<|FAS|>شیدا	ʃ e j d ɑː
<|FAS|>محبت	m a h a b b a t
<|FAS|>مارمولک	m ɑː ɾ m uː l a k
<|FAS|>پشیمان	p a ʃ iː m ɑː n
<|FAS|>کوتاه	k oː t ɑː h
<|FAS|>دستار	d a s t ɑː ɾ
<|FAS|>طب	t e b
<|FAS|>سنگ	s a n ɡ
<|FAS|>قطع	ɢ a t ʔ
<|FAS|>خواه	x ɑː h
<|FAS|>قسم	ɢ a s a m
<|FAS|>چاپگر	t͡ʃ ɑː p ɡ a ɾ
<|FAS|>سرای	s a ɾ ɑː j
<|FAS|>سفارشی	s e f ɑː ɾ e ʃ iː
<|FAS|>اخراج	e x ɾ ɑː d͡ʒ
<|FAS|>آمد	ɑː m a d
<|FAS|>رنگ	ɾ a n ɡ
<|FAS|>نفرین	n e f ɾ iː n
<|FAS|>خال	x ɑː l
<|FAS|>جوراب	d ʒ oː ɾ ɑː b
<|FAS|>همه	h a m e
<|FAS|>بینی	b i n iː
<|FAS|>فرشته	f a ɾ i ʃ t a
<|FAS|>سیماب	s i m ɑː b
<|FAS|>معده	m e ʔ d a
<|FAS|>قونیه	ɢ u n i j a
<|FAS|>منتقد	m o n t a ɢ e d
<|FAS|>اصطبل	e s t a b l
<|FAS|>یاساء	j ɑː s ɑː ʔ
<|FAS|>پشتون	p a ʃ t uː n
<|FAS|>کمک	k o m a k
<|FAS|>آشتی	ɑː ʃ t iː
<|FAS|>تقصیر	t a ɢ s iː ɾ
<|FAS|>بیجاده	b i d͡ʒ ɑː d i
<|FAS|>سه‌بعدی	s e b o ʔ d iː
<|FAS|>زنانگی	z a n ɑː n a ɡ iː
<|FAS|>کمانچه	k a m ɑː n t͡ʃ a
<|FAS|>آرزو	ɑː ɾ i z uː
<|FAS|>عفت	ʔ e f f a t
<|FAS|>کوزه	k u z a
<|FAS|>سیلاس	s iː l ɑː s
<|FAS|>شماره	ʃ o m ɑː ɾ e
<|FAS|>اهورامزدا	a h u ɾ ɑː m a z d ɑː
<|FAS|>پیغامبر	p a j ɢ ɑː m b a ɾ
<|FAS|>حق	h a ɢ ɢ
<|FAS|>مژده	m o ʒ d e
<|FAS|>رازی	ɾ ɑː z iː
<|FAS|>صنف	s a n f
<|FAS|>اخذ	ʔ a x z
<|FAS|>موتر	m oː t a ɾ
<|FAS|>وفات	v a f ɑː t
<|FAS|>نزدیک‌تر	n a z d iː k t a ɾ
<|FAS|>خدایی	x o d ɑː j iː
<|FAS|>نزدیک	n a z d i k
<|FAS|>وارد	v ɑː ɾ e d
<|FAS|>سرفراز	s a ɾ f a ɾ ɑː z
<|FAS|>وجودی	v o d͡ʒ uː d iː
<|FAS|>هلو	h o l uː
<|FAS|>مشکل‌ها	m o ʃ k e l h ɑː
<|FAS|>ژرف	ʒ a ɾ f
<|FAS|>پیشتاز	p e ʃ t ɑː z
<|FAS|>فرارود	f a ɾ ɑː ɾ uː d
<|FAS|>خشاب	x e ʃ ɑː b
<|FAS|>منیژه	m a n iː ʒ a
<|FAS|>رد	ɾ a d d
<|FAS|>چهار	t͡ʃ a h ɑː ɾ
<|FAS|>سوگند	s a v ɡ a n d
<|FAS|>شترغار	ʃ o t o ɾ ɢ ɑː ɾ
<|FAS|>شوربا	ʃ oː ɾ b ɑː
<|FAS|>خاقان	x ɑː ɢ ɑː n
<|FAS|>تشکیل	t a ʃ k i l
<|FAS|>سوی	s oː j
<|FAS|>اسپهسالار	ʔ e s p a h s ɑː l ɑː ɾ
<|FAS|>تزیین	t a z j i n
<|FAS|>مادر	m ɑː d a ɾ
<|FAS|>استقلال	e s t e ɢ l ɑː l
<|FAS|>کنجکاو	k o n d͡ʒ k ɑː v
<|FAS|>فراموشی	f a ɾ ɑː m oː ʃ iː
<|FAS|>پوشاک	p oː ʃ ɑː k
<|FAS|>اسلام‌گرا	e s l ɑː m ɡ a ɾ ɑː
<|FAS|>انگلیس	ʔ e n ɡ e l iː s
<|FAS|>خوانش	x ɑː n e ʃ
<|FAS|>خویش	x e ʃ
<|FAS|>رومی	ɾ oː m iː
<|FAS|>خواننده	x ɑː n a n d a
<|FAS|>سازش	s ɑː z i ʃ
<|FAS|>خزندگان	x a z a n d e ɡ ɑː n
<|FAS|>مصر	m e s ɾ
<|FAS|>تکیه	t a k j a
<|FAS|>خانواده	x ɑː n a v ɑː d a
<|FAS|>قبلا	ɢ a b l a n
<|FAS|>خون‌شناسی	x u n ʃ i n ɑː s iː
<|FAS|>سرمه	s a ɾ m a
<|FAS|>فلاخن	f a l ɑː x a n
<|FAS|>درفش	d a ɾ a f ʃ
<|FAS|>آلاله	ɑː l ɑː l a
<|FAS|>ترسیدن	t a ɾ s i d a n
<|FAS|>اذیت	a z i j a t
<|FAS|>خسران	x o s ɾ ɑː n
<|FAS|>یگانه	j a ɡ ɑː n a
<|FAS|>تعجب	t a ʔ a d d͡ʒ u b
<|FAS|>بیشه	b e ʃ a
<|FAS|>جشن	d͡ʒ a ʃ n
<|FAS|>خسته‌خانه	x a s t a x ɑː n a
<|FAS|>آدینه	ɑː d iː n a
<|FAS|>بیور	b e v a ɾ
<|FAS|>نازک	n ɑː z u k
<|FAS|>سرخ	s o ɾ x
<|FAS|>مرگ	m a ɾ ɡ
<|FAS|>رام	ɾ ɑː m
<|FAS|>آزمودن	ɑː z m uː d a n
<|FAS|>منزل	m a n z i l
<|FAS|>شهوت	ʃ a h v a t
<|FAS|>بی	b e
<|FAS|>ارتعاش	e ɾ t e ʔ ɑː ʃ
<|FAS|>انتشار	e n t e ʃ ɑː ɾ
<|FAS|>بزاق	b o z ɑː ɢ
<|FAS|>قیمتی	ɢ a j m a t iː
<|FAS|>بیمارتر	b iː m ɑː ɾ t a ɾ
<|FAS|>قطر	ɢ a t a ɾ
<|FAS|>تاجیکستان	t ɑː d͡ʒ iː k i s t ɑː n
<|FAS|>داروساز	d ɑː ɾ uː s ɑː z
<|FAS|>دنیدن	d a n iː d a n
<|FAS|>شغال‌ها	ʃ o ɢ ɑː l ɑː
<|FAS|>که	k e
<|FAS|>دانستن	d uː n e s t a n
<|FAS|>میزان	m i z ɑ n
<|FAS|>شترگاوپلنگ	ʃ o t o ɾ ɡ ɑː v p a l a n ɡ
<|FAS|>مورچه	m oː ɾ t͡ʃ a
<|FAS|>کاسب	k ɑː s i b
<|FAS|>دیدن	d i d a n
<|FAS|>گذشتن	ɡ o z a ʃ t a n
<|FAS|>مربا	m o r a b b ɑ
<|FAS|>رم	ɾ a m
<|FAS|>یار	j ɑː ɾ
<|FAS|>خشونت	x o ʃ uː n a t
<|FAS|>مقدماتی	m o ɢ a d d a m ɑː t iː
<|FAS|>تمثیل	t a m s i l
<|FAS|>دقت	d e ɢ ɢ a t
<|FAS|>پرندوش	p a ɾ a n d oː ʃ
<|FAS|>میدان	m a j d ɑː n
<|FAS|>صنوبر	s a n a v b a ɾ
<|FAS|>گلستان	ɡ o l e s t ɑː n
<|FAS|>آخوند	ɑː x uː n d
<|FAS|>میلاد	m e l ɑː d
<|FAS|>فرزندخوانده	f a ɾ z a n d x ɑː n d a
<|FAS|>آچار	ɑː t͡ʃ ɑː ɾ
<|FAS|>سالن	s ɑː l o n
<|FAS|>خوشبخت	x o ʃ b a x t
<|FAS|>مختلط	m o x t a l e t
<|FAS|>سفارش	s e f ɑː ɾ e ʃ
<|FAS|>مصدر	m a s d a ɾ
<|FAS|>نظر	n a z a ɾ
<|FAS|>ژرف‌تر	ʒ a ɾ f t a ɾ
<|FAS|>شاد	ʃ ɑː d
<|FAS|>خفگی	x a f i ɡ iː
<|FAS|>وعده	v a ʔ d a
<|FAS|>تدریج	t a d ɾ i d͡ʒ
<|FAS|>قلاوز	ɢ u l ɑː v u z
<|FAS|>مقدس	m o ɢ a d d a s
<|FAS|>ناراحت	n ɑː ɾ ɑː h a t
<|FAS|>غار	ɢ ɑː ɾ
<|FAS|>آسان	ɑː s ɑː n
<|FAS|>جوهر	d͡ʒ a v h a ɾ
<|FAS|>آرایش	ɑː ɾ ɑː j i ʃ
<|FAS|>بهبود	b e h b uː d
<|FAS|>سرور	s a ɾ v a ɾ
<|FAS|>اشتباه	e ʃ t e b ɑː h
<|FAS|>فرد	f a ɾ d
<|FAS|>گواشتن	ɡ o v ɑː ʃ t a n
<|FAS|>ویرایش	v i ɾ ɑː j i ʃ
<|FAS|>ول	v e l
<|FAS|>کلپ	k l a p
<|FAS|>گویش	ɡ oː j i ʃ
<|FAS|>انفجار	e n f e d͡ʒ ɑː ɾ
<|FAS|>روادید	r a v ɑː d iː d
<|FAS|>ارگ	o ɾ ɡ
<|FAS|>خزان	x a z ɑː n
<|FAS|>تفسیدن	t a f s i d a n
<|FAS|>گردن	ɡ a ɾ d a n
<|FAS|>نوکر	n a v k a r
<|FAS|>آدم‌ها	ɑː d a m h ɑː
<|FAS|>چوپ	t͡ʃ oː p
<|FAS|>پری	p a ɾ iː
<|FAS|>کلنگ	k o l o n ɡ
<|FAS|>ساده‌تر	s ɑː d e t a ɾ
<|FAS|>درباره	d a ɾ b ɑː ɾ a j i
<|FAS|>پنهان	p e n h uː n
<|FAS|>خلاف	x e l ɑː f
<|FAS|>قدر	ɢ a d a ɾ
<|FAS|>استخوان	o s t o x ɑː n
<|FAS|>شوق	ʃ a v ɢ
<|FAS|>پنجشیر	p a n d͡ʒ ʃ e ɾ
<|FAS|>اطمینان	e t m iː n ɑː n
<|FAS|>ساز	s ɑː z
<|FAS|>ناتوان	n ɑː t a v ɑː n
<|FAS|>نارنج	n ɑː ɾ a n d͡ʒ
<|FAS|>پذیرفتن	p a z i ɾ u f t a n
<|FAS|>گاز	ɡ ɑː z
<|UIG|>ئائىت	ʔ ɑ ʔ i t
<|UIG|>ئائىلە	ʔ ɑ ʔ i l ɛ
<|UIG|>ئابدال	ʔ ɑ b d ɑ l
<|UIG|>ئابدۇلئەھەد	ʔ ɑ b d u l ʔ ɛ h ɛ t
<|UIG|>ئابدۇلفەتتاھ	ʔ ɑ b d u l p ɛ t t ɑ h
<|UIG|>ئاتا	ʔ ɑ t ɑ
<|UIG|>ئاتلىقلار	ʔ ɑ t l i q l ɑ r
<|UIG|>ئاتىماق	ʔ ɑ t i m ɑ q
<|UIG|>ئاجىز	ʔ ɑ d͡ʒ i z
<|UIG|>ئاخىرەت	ʔ ɑ χ i r ɛ t
<|UIG|>ئادەت	ʔ ɑ d ɛ t
<|UIG|>ئادەتتە	ʔ ɑ d ɛ t t ɛ
<|UIG|>ئارزۇ	ʔ ɑ r z u
<|UIG|>ئارسىن	ʔ ɑ r s i n
<|UIG|>ئارىسىدا	ʔ ɑ r i s i d ɑ
<|UIG|>ئازات	ʔ ɑ z ɑ t
<|UIG|>ئازاپ	ʔ ɑ z ɑ p
<|UIG|>ئازوت	ʔ ɑ z o t
<|UIG|>ئاساس	ʔ ɑ s ɑ s
<|UIG|>ئاستاتىن	ʔ ɑ s t ɑ t i n
<|UIG|>ئاسفالت	ʔ ɑ s p ɑ l t
<|UIG|>ئاسماق	ʔ ɑ s m ɑ q
<|UIG|>ئاشقازان	ʔ ɑ ʃ q ɑ z ɑ n
<|UIG|>ئاشيان	ʔ ɑ ʃ j ɑ n
<|UIG|>ئاشپەز	ʔ ɑ ʃ p ɛ z
<|UIG|>ئافغان	ʔ ɑ p ʁ ɑ n
<|UIG|>ئاكا	ʔ ɑ k ɑ
<|UIG|>ئالامەت	ʔ ɑ l ɑ m ɛ t
<|UIG|>ئالاڭ	ʔ ɑ l ɑ ŋ
<|UIG|>ئالتۇن	ʔ ɑ l t u n
<|UIG|>ئالتە	ʔ ɑ l t ɛ
<|UIG|>ئالما	ʔ ɑ l m ɑ
<|UIG|>ئالماس	ʔ ɑ l m ɑ s
<|UIG|>ئالپ	ʔ ɑ l p
<|UIG|>ئامال	ʔ ɑ m ɑ l
<|UIG|>ئامانەت	ʔ ɑ m ɑ n ɛ t
<|UIG|>ئاياز	ʔ ɑ j ɑ z
<|UIG|>ئاياغلار	ʔ ɑ j ɑ ʁ l ɑ r
<|UIG|>ئاياقلار	ʔ ɑ j ɑ q l ɑ r
<|UIG|>ئايران	ʔ ɑ j r ɑ n
<|UIG|>ئايغىر	ʔ ɑ j ʁ i r
<|UIG|>ئايماق	ʔ ɑ j m ɑ q
<|UIG|>ئاپرېل	ʔ ɑ p r e l
<|UIG|>ئاپىرىن	ʔ ɑ p i r i n
<|UIG|>ئاپىيەت	ʔ ɑ p i j ɛ t
<|UIG|>ئاپېلسىن	ʔ ɑ p e l s i n
<|UIG|>ئاپەت	ʔ ɑ p ɛ t
<|UIG|>ئاچقۇچ	ʔ ɑ t͡ʃ q u t͡ʃ
<|UIG|>ئاچماق	ʔ ɑ t͡ʃ m ɑ q
<|UIG|>ئاھالە	ʔ ɑ h ɑ l ɛ
<|UIG|>ئاۋاز	ʔ ɑ w ɑ z
<|UIG|>ئاۋام	ʔ ɑ w ɑ m
<|UIG|>ئاۋىئاتسىيە	ʔ ɑ w i ʔ ɑ t s i j ɛ
<|UIG|>ئوتتۇز	ʔ o t t u z
<|UIG|>ئوتۇن	ʔ o t u n
<|UIG|>ئوخشىماق	ʔ o χ ʃ i m ɑ q
<|UIG|>ئورتاق	ʔ o r t ɑ q
<|UIG|>ئوغا	ʔ o ʁ ɑ
<|UIG|>ئوق	ʔ o q
<|UIG|>ئوقۇتقۇچى	ʔ o q u t q u t͡ʃ i
<|UIG|>ئومۇم	ʔ o m u m
<|UIG|>ئومۇمىي	ʔ o m u m i j
<|UIG|>ئومۇمىيەت	ʔ o m u m i j ɛ t
<|UIG|>ئونىنچى	ʔ o n i n t͡ʃ i
<|UIG|>ئىبادەتخانا	ʔ i b ɑ d ɛ t χ ɑ n ɑ
<|UIG|>ئىت	ʔ i t
<|UIG|>ئىتائەت	ʔ i t ɑ ʔ ɛ t
<|UIG|>ئىجات	ʔ i d͡ʒ ɑ t
<|UIG|>ئىجتىمائىي	ʔ i d͡ʒ t i m ɑ ʔ i j
<|UIG|>ئىجتىمائىيەت	ʔ i d͡ʒ t i m ɑ ʔ i j ɛ t
<|UIG|>ئىختىيار	ʔ i χ t i j ɑ r
<|UIG|>ئىخلاس	ʔ i χ l ɑ s
<|UIG|>ئىس	ʔ i s
<|UIG|>ئىستىراھەت	ʔ i s t i r ɑ h ɛ t
<|UIG|>ئىستىسنا	ʔ i s t i s n ɑ
<|UIG|>ئىستېمال	ʔ i s t e m ɑ l
<|UIG|>ئىستېپا	ʔ i s t e p ɑ
<|UIG|>ئىسراپ	ʔ i s r ɑ p
<|UIG|>ئىسلام	ʔ i s l ɑ m
<|UIG|>ئىسلاھات	ʔ i s l ɑ h ɑ t
<|UIG|>ئىسيانچى	ʔ i s j ɑ n t͡ʃ i
<|UIG|>ئىشغال	ʔ i ʃ ʁ ɑ l
<|UIG|>ئىشق	ʔ i ʃ q
<|UIG|>ئىشقىلىپ	ʔ i ʃ q i l i p
<|UIG|>ئىشىتمەك	ʔ i ʃ i t m ɛ k
<|UIG|>ئىشچى	ʔ i ʃ t͡ʃ i
<|UIG|>ئىشەك	ʔ i ʃ ɛ k
<|UIG|>ئىقلىم	ʔ i q l i m
<|UIG|>ئىلاھ	ʔ i l ɑ h
<|UIG|>ئىم	ʔ i m
<|UIG|>ئىمامەت	ʔ i m ɑ m ɛ t
<|UIG|>ئىمكان	ʔ i m k ɑ n
<|UIG|>ئىمكانىيەت	ʔ i m k ɑ n i j ɛ t
<|UIG|>ئىنسانىيەت	ʔ i n s ɑ n i j ɛ t
<|UIG|>ئىنشا	ʔ i n ʃ ɑ
<|UIG|>ئىنكار	ʔ i n k ɑ r
<|UIG|>ئىنى	ʔ i n i
<|UIG|>ئىنەك	ʔ i n ɛ k
<|UIG|>ئىيۇل	ʔ i j u l
<|UIG|>ئىيۇن	ʔ i j u n
<|UIG|>ئىپپەت	ʔ i p p ɛ t
<|UIG|>ئىگە	ʔ i ɡ ɛ
<|UIG|>ئىگەر	ʔ i ɡ ɛ r
<|UIG|>ئۆز	ʔ ø z
<|UIG|>ئۆستەڭ	ʔ ø s t ɛ ŋ
<|UIG|>ئۆكتەبر	ʔ ø k t ɛ b r
<|UIG|>ئۆپكە	ʔ ø p k ɛ
<|UIG|>ئۆچ	ʔ ø t͡ʃ
<|UIG|>ئۇتۇق	ʔ u t u q
<|UIG|>ئۇرۇش	ʔ u r u ʃ
<|UIG|>ئۇل	ʔ u l
<|UIG|>ئۇلار	ʔ u l ɑ r
<|UIG|>ئۇلۇغ	ʔ u l u ʁ
<|UIG|>ئۇنىۋېرسىتېت	ʔ u n i w e r s i t e t
<|UIG|>ئۇنۋان	ʔ u n w ɑ n
<|UIG|>ئۇي	ʔ u j
<|UIG|>ئۇيغۇرچە	ʔ u j ʁ u r t͡ʃ ɛ
<|UIG|>ئۇيقۇ	ʔ u j q u
<|UIG|>ئۇۋا	ʔ u w ɑ
<|UIG|>ئۇۋاق	ʔ u w ɑ q
<|UIG|>ئۈزۈك	ʔ y z y k
<|UIG|>ئۈزۈم	ʔ y z y m
<|UIG|>ئۈلپەت	ʔ y l p ɛ t
<|UIG|>ئۈچ	ʔ y t͡ʃ
<|UIG|>ئېتىراپ	ʔ e t i r ɑ p
<|UIG|>ئېتىۋار	ʔ e t i w ɑ r
<|UIG|>ئېربىي	ʔ e r b i j
<|UIG|>ئېرىمەك	ʔ e r i m ɛ k
<|UIG|>ئېكىن	ʔ e k i n
<|UIG|>ئېيىق	ʔ e j i q
<|UIG|>ئېھتىلام	ʔ e h t i l ɑ m
<|UIG|>ئەبەد	ʔ ɛ b ɛ t
<|UIG|>ئەتىر	ʔ ɛ t i r
<|UIG|>ئەجداد	ʔ ɛ d͡ʒ d ɑ t
<|UIG|>ئەجەب	ʔ ɛ d͡ʒ ɛ p
<|UIG|>ئەجەم	ʔ ɛ d͡ʒ ɛ m
<|UIG|>ئەخلاق	ʔ ɛ χ l ɑ q
<|UIG|>ئەخمەت	ʔ ɛ χ m ɛ t
<|UIG|>ئەدەپ	ʔ ɛ d ɛ p
<|UIG|>ئەردەم	ʔ ɛ r d ɛ m
<|UIG|>ئەرز	ʔ ɛ r z
<|UIG|>ئەرپە	ʔ ɛ r p ɛ
<|UIG|>ئەرۋاھ	ʔ ɛ r w ɑ h
<|UIG|>ئەرەب	ʔ ɛ r ɛ p
<|UIG|>ئەرەبچە	ʔ ɛ r ɛ b t͡ʃ ɛ
<|UIG|>ئەزا	ʔ ɛ z ɑ
<|UIG|>ئەسكى	ʔ ɛ s k i
<|UIG|>ئەسلى	ʔ ɛ s l i
<|UIG|>ئەسلىھە	ʔ ɛ s l i h ɛ
<|UIG|>ئەسىر	ʔ ɛ s i r
<|UIG|>ئەسەر	ʔ ɛ s ɛ r
<|UIG|>ئەقرىبا	ʔ ɛ q r i b ɑ
<|UIG|>ئەكس	ʔ ɛ k s
<|UIG|>ئەل	ʔ ɛ l
<|UIG|>ئەلا	ʔ ɛ l ɑ
<|UIG|>ئەلۋەتتە	ʔ ɛ l w ɛ t t ɛ
<|UIG|>ئەمما	ʔ ɛ m m ɑ
<|UIG|>ئەيب	ʔ ɛ j p
<|UIG|>ئەينەن	ʔ ɛ j n ɛ n
<|UIG|>ئەيىپ	ʔ ɛ j i p
<|UIG|>ئەپسانىۋىي	ʔ ɛ p s ɑ n i w i j
<|UIG|>ئەپسۇس	ʔ ɛ p s u s
<|UIG|>ئەپسۇن	ʔ ɛ p s u n
<|UIG|>ئەپيۈن	ʔ ɛ p j y n
<|UIG|>ئەھل	ʔ ɛ h l
<|UIG|>ئەھمىيەت	ʔ ɛ h m i j ɛ t
<|UIG|>ئەھەد	ʔ ɛ h ɛ t
<|UIG|>ئەۋقاپ	ʔ ɛ w q ɑ p
<|UIG|>باتارى	b ɑ t ɑ r i
<|UIG|>باتىل	b ɑ t i l
<|UIG|>باج	b ɑ d͡ʒ
<|UIG|>بادام	b ɑ d ɑ m
<|UIG|>بارىي	b ɑ r i j
<|UIG|>بازار	b ɑ z ɑ r
<|UIG|>باقىي	b ɑ q i j
<|UIG|>بانا	b ɑ n ɑ
<|UIG|>بانداژ	b ɑ n d ɑ ʒ
<|UIG|>بايانات	b ɑ j ɑ n ɑ t
<|UIG|>بايراق	b ɑ j r ɑ q
<|UIG|>بولۇو	b o l u o
<|UIG|>بولۇپ	b o l u p
<|UIG|>بويسۇندۇرماق	b o j s u n d u r m ɑ q
<|UIG|>بويۇن	b o j u n
<|UIG|>بىتون	b i t o n
<|UIG|>بىدئەت	b i d ʔ ɛ t
<|UIG|>بىسمۇت	b i s m u t
<|UIG|>بىلەن	b i l ɛ n
<|UIG|>بىڭگۇر	b i ŋ ɡ u r
<|UIG|>بۆشۈك	b ø ʃ y k
<|UIG|>بۆلمەك	b ø l m ɛ k
<|UIG|>بۆھران	b ø h r ɑ n
<|UIG|>بۇ	b u
<|UIG|>بۇت	b u t
<|UIG|>بۇتپەرەس	b u t p ɛ r ɛ s
<|UIG|>بۇدجېت	b u d d͡ʒ e t
<|UIG|>بۇرادەر	b u r ɑ d ɛ r
<|UIG|>بۇرۇت	b u r u t
<|UIG|>بۇغ	b u ʁ
<|UIG|>بۇقا	b u q ɑ
<|UIG|>بۇيرۇق	b u j r u q
<|UIG|>بېغىر	b e ʁ i r
<|UIG|>بېلوك	b e l o k
<|UIG|>بېلىقچى	b e l i q t͡ʃ i
<|UIG|>بېنزىن	b e n z i n
<|UIG|>بەختىيار	b ɛ χ t i j ɑ r
<|UIG|>بەخش	b ɛ χ ʃ
<|UIG|>بەدەل	b ɛ d ɛ l
<|UIG|>بەدەن	b ɛ d ɛ n
<|UIG|>بەرمەك	b ɛ r m ɛ k
<|UIG|>بەش	b ɛ ʃ
<|UIG|>بەلغەم	b ɛ l ʁ ɛ m
<|UIG|>بەلكى	b ɛ l k i
<|UIG|>بەنسىيۇەن	b ɛ n s i j u ɛ n
<|UIG|>بەنسىچۇ	b ɛ n s i t͡ʃ u
<|UIG|>بەياز	b ɛ j ɑ z
<|UIG|>تارازا	t ɑ r ɑ z ɑ
<|UIG|>تازى	t ɑ z i
<|UIG|>تاسادىپىي	t ɑ s ɑ d i p i j
<|UIG|>تاقەت	t ɑ q ɛ t
<|UIG|>تاكسى	t ɑ k s i
<|UIG|>تاللىي	t ɑ l l i j
<|UIG|>تام	t ɑ m
<|UIG|>تاما	t ɑ m ɑ
<|UIG|>تاملار	t ɑ m l ɑ r
<|UIG|>تاي	t ɑ j
<|UIG|>تاۋار	t ɑ w ɑ r
<|UIG|>تاۋۇز	t ɑ w u z
<|UIG|>تورۇق	t o r u q
<|UIG|>توشقان	t o ʃ q ɑ n
<|UIG|>توق	t o q
<|UIG|>توقسان	t o q s ɑ n
<|UIG|>توققۇز	t o q q u z
<|UIG|>تولۇق	t o l u q
<|UIG|>توننا	t o n n ɑ
<|UIG|>توپ	t o p
<|UIG|>توپلىماق	t o p l i m ɑ q
<|UIG|>توپچى	t o p t͡ʃ i
<|UIG|>تىبابەت	t i b ɑ b ɛ t
<|UIG|>تىجارەت	t i d͡ʒ ɑ r ɛ t
<|UIG|>تىرناق	t i r n ɑ q
<|UIG|>تىرىك	t i r i k
<|UIG|>تىز	t i z
<|UIG|>تىكەن	t i k ɛ n
<|UIG|>تىلاۋەت	t i l ɑ w ɛ t
<|UIG|>تىللار	t i l l ɑ r
<|UIG|>تىلەك	t i l ɛ k
<|UIG|>تىمساخ	t i m s ɑ χ
<|UIG|>تىياتىر	t i j ɑ t i r
<|UIG|>تۆش	t ø ʃ
<|UIG|>تۆمۈر	t ø m y r
<|UIG|>تۆھمەت	t ø h m ɛ t
<|UIG|>تۇت	t u t
<|UIG|>تۇخۇم	t u χ u m
<|UIG|>تۇز	t u z
<|UIG|>تۇزاق	t u z ɑ q
<|UIG|>تۇل	t u l
<|UIG|>تۈتۈن	t y t y n
<|UIG|>تۈر	t y r
<|UIG|>تۈمەن	t y m ɛ n
<|UIG|>تېتىك	t e t i k
<|UIG|>تېخنېتسىي	t e χ n e t s i j
<|UIG|>تېربىي	t e r b i j
<|UIG|>تېكە	t e k ɛ
<|UIG|>تەبدىل	t ɛ b d i l
<|UIG|>تەبرىك	t ɛ b r i k
<|UIG|>تەبلىغ	t ɛ b l i ʁ
<|UIG|>تەبەسسۈم	t ɛ b ɛ s s y m
<|UIG|>تەتىل	t ɛ t i l
<|UIG|>تەجرىبىخانا	t ɛ d͡ʒ r i b i χ ɑ n ɑ
<|UIG|>تەجرىبە	t ɛ d͡ʒ r i b ɛ
<|UIG|>تەخمىن	t ɛ χ m i n
<|UIG|>تەخمىنەن	t ɛ χ m i n ɛ n
<|UIG|>تەدبىر	t ɛ d b i r
<|UIG|>تەر	t ɛ r
<|UIG|>تەربىيىۋى	t ɛ r b i j i w i
<|UIG|>تەرجىمان	t ɛ r d͡ʒ i m ɑ n
<|UIG|>تەررەھھۇم	t ɛ r r ɛ h h u m
<|UIG|>تەرىپ	t ɛ r i p
<|UIG|>تەس	t ɛ s
<|UIG|>تەسلىم	t ɛ s l i m
<|UIG|>تەسەللى	t ɛ s ɛ l l i
<|UIG|>تەسەۋۋۇر	t ɛ s ɛ w w u r
<|UIG|>تەشۋىش	t ɛ ʃ w i ʃ
<|UIG|>تەشۋىقات	t ɛ ʃ w i q ɑ t
<|UIG|>تەقسىم	t ɛ q s i m
<|UIG|>تەكىت	t ɛ k i t
<|UIG|>تەكەللۇپ	t ɛ k ɛ l l u p
<|UIG|>تەلىمىي	t ɛ l i m i j
<|UIG|>تەلەپ	t ɛ l ɛ p
<|UIG|>تەلەپپۇز	t ɛ l ɛ p p u z
<|UIG|>تەنەززۇل	t ɛ n ɛ z z u l
<|UIG|>تەنەپپۇس	t ɛ n ɛ p p u s
<|UIG|>تەپرىقە	t ɛ p r i q ɛ
<|UIG|>تەڭرى	t ɛ ŋ r i
<|UIG|>تەھرىر	t ɛ h r i r
<|UIG|>تەۋسىيە	t ɛ w s i j ɛ
<|UIG|>جادۇگەر	d͡ʒ ɑ d u ɡ ɛ r
<|UIG|>جازا	d͡ʒ ɑ z ɑ
<|UIG|>جاللات	d͡ʒ ɑ l l ɑ t
<|UIG|>جامائەت	d͡ʒ ɑ m ɑ ʔ ɛ t
<|UIG|>جاھان	d͡ʒ ɑ h ɑ n
<|UIG|>جاھىل	d͡ʒ ɑ h i l
<|UIG|>جاۋاب	d͡ʒ ɑ w ɑ p
<|UIG|>جىنايەتچى	d͡ʒ i n ɑ j ɛ t t͡ʃ i
<|UIG|>جۇغراپىيە	d͡ʒ u ʁ r ɑ p i j ɛ
<|UIG|>جەريان	d͡ʒ ɛ r j ɑ n
<|UIG|>جەزىبە	d͡ʒ ɛ z i b ɛ
<|UIG|>جەسۇر	d͡ʒ ɛ s u r
<|UIG|>جەسەت	d͡ʒ ɛ s ɛ t
<|UIG|>جەھەت	d͡ʒ ɛ h ɛ t
<|UIG|>جەۋز	d͡ʒ ɛ w z
<|UIG|>خاتىرە	χ ɑ t i r ɛ
<|UIG|>خوش	χ o ʃ
<|UIG|>خىت	χ i t
<|UIG|>خىزمەتچى	χ i z m ɛ t t͡ʃ i
<|UIG|>خۇسۇس	χ u s u s
<|UIG|>خۇسۇسىي	χ u s u s i j
<|UIG|>خېمىر	χ e m i r
<|UIG|>خېچىر	χ e t͡ʃ i r
<|UIG|>خەتمە	χ ɛ t m ɛ
<|UIG|>خەتىپ	χ ɛ t i p
<|UIG|>خەيرىيەت	χ ɛ j r i j ɛ t
<|UIG|>دائىمى	d ɑ ʔ i m i
<|UIG|>دادا	d ɑ d ɑ
<|UIG|>داستان	d ɑ s t ɑ n
<|UIG|>دانە	d ɑ n ɛ
<|UIG|>داۋا	d ɑ w ɑ
<|UIG|>دوستانە	d o s t ɑ n ɛ
<|UIG|>دىققەت	d i q q ɛ t
<|UIG|>دىماق	d i m ɑ q
<|UIG|>دىن	d i n
<|UIG|>دىۋان	d i w ɑ n
<|UIG|>دۇئا	d u ʔ ɑ
<|UIG|>دۇتار	d u t ɑ r
<|UIG|>دۇتتار	d u t t ɑ r
<|UIG|>دۇنياۋى	d u n j ɑ w i
<|UIG|>دۈشمەن	d y ʃ m ɛ n
<|UIG|>دېكابر	d e k ɑ b r
<|UIG|>دېموكراتىيە	d e m o k r ɑ t i j ɛ
<|UIG|>دېمەك	d e m ɛ k
<|UIG|>دېڭىزچى	d e ŋ i z t͡ʃ i
<|UIG|>دەرت	d ɛ r t
<|UIG|>دەرىجە	d ɛ r i d͡ʒ ɛ
<|UIG|>دەرھال	d ɛ r h ɑ l
<|UIG|>دەرۋازا	d ɛ r w ɑ z ɑ
<|UIG|>دەقىقە	d ɛ q i q ɛ
<|UIG|>دەپئەتەن	d ɛ p ʔ ɛ t ɛ n
<|UIG|>دەپتەر	d ɛ p t ɛ r
<|UIG|>دەۋەت	d ɛ w ɛ t
<|UIG|>رايونى	r ɑ j o n i
<|UIG|>روھ	r o h
<|UIG|>روھانىي	r o h ɑ n i j
<|UIG|>رىزالەت	r i z ɑ l ɛ t
<|UIG|>رىغبەت	r i ʁ b ɛ t
<|UIG|>رىقابەت	r i q ɑ b ɛ t
<|UIG|>رۇخسەت	r u χ s ɛ t
<|UIG|>رۇكۇ	r u k u
<|UIG|>رېفېراندۇم	r e p e r ɑ n d u m
<|UIG|>رەئىس	r ɛ ʔ i s
<|UIG|>رەزىل	r ɛ z i l
<|UIG|>رەسمىي	r ɛ s m i j
<|UIG|>زالالەت	z ɑ l ɑ l ɛ t
<|UIG|>زامىن	z ɑ m i n
<|UIG|>زاھىرەن	z ɑ h i r ɛ n
<|UIG|>زوھرە	z o h r ɛ
<|UIG|>زىكىر	z i k i r
<|UIG|>زىنا	z i n ɑ
<|UIG|>زىننەت	z i n n ɛ t
<|UIG|>زىيارەت	z i j ɑ r ɛ t
<|UIG|>زۆرۈر	z ø r y r
<|UIG|>زۇلۇم	z u l u m
<|UIG|>زەبۇر	z ɛ b u r
<|UIG|>زەررە	z ɛ r r ɛ
<|UIG|>زەينەپ	z ɛ j n ɛ p
<|UIG|>سائادەت	s ɑ ʔ ɑ d ɛ t
<|UIG|>ساخاۋەت	s ɑ χ ɑ w ɛ t
<|UIG|>ساداقەت	s ɑ d ɑ q ɛ t
<|UIG|>ساراي	s ɑ r ɑ j
<|UIG|>ساق	s ɑ q
<|UIG|>ساقچى	s ɑ q t͡ʃ i
<|UIG|>سايە	s ɑ j ɛ
<|UIG|>ساپ	s ɑ p
<|UIG|>ساھابە	s ɑ h ɑ b ɛ
<|UIG|>ساھىب	s ɑ h i p
<|UIG|>ساۋاپ	s ɑ w ɑ p
<|UIG|>سوئال	s o ʔ ɑ l
<|UIG|>سودىگەر	s o d i ɡ ɛ r
<|UIG|>سىركە	s i r k ɛ
<|UIG|>سىنك	s i n k
<|UIG|>سىنىپداش	s i n i p d ɑ ʃ
<|UIG|>سىيىر	s i j i r
<|UIG|>سىڭىل	s i ŋ i l
<|UIG|>سېخىي	s e χ i j
<|UIG|>سېمىزئوت	s e m i z ʔ o t
<|UIG|>سېھىرگەر	s e h i r ɡ ɛ r
<|UIG|>سەدىقە	s ɛ d i q ɛ
<|UIG|>سەرخۇش	s ɛ r χ u ʃ
<|UIG|>سەكسەنپۇت	s ɛ k s ɛ n p u t
<|UIG|>سەككىز	s ɛ k k i z
<|UIG|>سەككىزىنچى	s ɛ k k i z i n t͡ʃ i
<|UIG|>سەنئەتكار	s ɛ n ʔ ɛ t k ɑ r
<|UIG|>سەپەر	s ɛ p ɛ r
<|UIG|>سەھىيە	s ɛ h i j ɛ
<|UIG|>شاراپەت	ʃ ɑ r ɑ p ɛ t
<|UIG|>شاپائەت	ʃ ɑ p ɑ ʔ ɛ t
<|UIG|>شاھادەت	ʃ ɑ h ɑ d ɛ t
<|UIG|>شاھمات	ʃ ɑ h m ɑ t
<|UIG|>شاھىت	ʃ ɑ h i t
<|UIG|>شىركەت	ʃ i r k ɛ t
<|UIG|>شىمالىي	ʃ i m ɑ l i j
<|UIG|>شىنجاڭ	ʃ i n d͡ʒ ɑ ŋ
<|UIG|>شياڭگاڭ	ʃ j ɑ ŋ ɡ ɑ ŋ
<|UIG|>شېكەر	ʃ e k ɛ r
<|UIG|>شەخسىيەت	ʃ ɛ χ s i j ɛ t
<|UIG|>شەرت	ʃ ɛ r t
<|UIG|>شەرق	ʃ ɛ r q
<|UIG|>شەرەپ	ʃ ɛ r ɛ p
<|UIG|>شەيخ	ʃ ɛ j χ
<|UIG|>شەپكە	ʃ ɛ p k ɛ
<|UIG|>شەھەر	ʃ ɛ h ɛ r
<|UIG|>شەۋكەت	ʃ ɛ w k ɛ t
<|UIG|>غايىپ	ʁ ɑ j i p
<|UIG|>غايەت	ʁ ɑ j ɛ t
<|UIG|>غۇربەت	ʁ u r b ɛ t
<|UIG|>غۇرۇر	ʁ u r u r
<|UIG|>غەرب	ʁ ɛ r p
<|UIG|>غەربىي	ʁ ɛ r b i j
<|UIG|>غەرپ	ʁ ɛ r p
<|UIG|>غەزەپ	ʁ ɛ z ɛ p
<|UIG|>غەلىبە	ʁ ɛ l i b ɛ
<|UIG|>غەلۋىر	ʁ ɛ l w i r
<|UIG|>غەيرەت	ʁ ɛ j r ɛ t
<|UIG|>غەيۇر	ʁ ɛ j u r
<|UIG|>فاشىست	p ɑ ʃ i s t
<|UIG|>قائىدە	q ɑ ʔ i d ɛ
<|UIG|>قابىلىيەت	q ɑ b i l i j ɛ t
<|UIG|>قات	q ɑ t
<|UIG|>قار	q ɑ r
<|UIG|>قارار	q ɑ r ɑ r
<|UIG|>قارارگاھ	q ɑ r ɑ r ɡ ɑ h
<|UIG|>قارشى	q ɑ r ʃ i
<|UIG|>قارىن	q ɑ r i n
<|UIG|>قازاغىستان	q ɑ z ɑ ʁ i s t ɑ n
<|UIG|>قازانماق	q ɑ z ɑ n m ɑ q
<|UIG|>قاسساپ	q ɑ s s ɑ p
<|UIG|>قاغا	q ɑ ʁ ɑ
<|UIG|>قالقان	q ɑ l q ɑ n
<|UIG|>قالۇن	q ɑ l u n
<|UIG|>قانائەت	q ɑ n ɑ ʔ ɛ t
<|UIG|>قانۇنسىز	q ɑ n u n s i z
<|UIG|>قايغۇ	q ɑ j ʁ u
<|UIG|>قاچا	q ɑ t͡ʃ ɑ
<|UIG|>قاھىرە	q ɑ h i r ɛ
<|UIG|>قورقاق	q o r q ɑ q
<|UIG|>قورقۇنچ	q o r q u n t͡ʃ
<|UIG|>قوزا	q o z ɑ
<|UIG|>قوزىقۇلاق	q o z i q u l ɑ q
<|UIG|>قونچ	q o n t͡ʃ
<|UIG|>قويۇن	q o j u n
<|UIG|>قوڭغۇز	q o ŋ ʁ u z
<|UIG|>قوۋم	q o w m
<|UIG|>قوۋۇرغا	q o w u r ʁ ɑ
<|UIG|>قىرغىن	q i r ʁ i n
<|UIG|>قىرىق	q i r i q
<|UIG|>قىزىلغاز	q i z i l ʁ ɑ z
<|UIG|>قىسسە	q i s s ɛ
<|UIG|>قىشلاق	q i ʃ l ɑ q
<|UIG|>قىلىق	q i l i q
<|UIG|>قىياس	q i j ɑ s
<|UIG|>قىيما	q i j m ɑ
<|UIG|>قىچىق	q i t͡ʃ i q
<|UIG|>قۇتلۇق	q u t l u q
<|UIG|>قۇزغۇن	q u z ʁ u n
<|UIG|>قۇسماق	q u s m ɑ q
<|UIG|>قۇمچاق	q u m t͡ʃ ɑ q
<|UIG|>قۇيرۇق	q u j r u q
<|UIG|>قۇچاق	q u t͡ʃ ɑ q
<|UIG|>قۇۋانچ	q u w ɑ n t͡ʃ
<|UIG|>قېلىن	q e l i n
<|UIG|>قېيىن	q e j i n
<|UIG|>قەتئىيەت	q ɛ t ʔ i j ɛ t
<|UIG|>قەدەھ	q ɛ d ɛ h
<|UIG|>قەرەنفىل	q ɛ r ɛ n p i l
<|UIG|>قەسىر	q ɛ s i r
<|UIG|>قەلب	q ɛ l p
<|UIG|>قەلبەن	q ɛ l b ɛ n
<|UIG|>قەلەم	q ɛ l ɛ m
<|UIG|>قەندىل	q ɛ n d i l
<|UIG|>قەپەز	q ɛ p ɛ z
<|UIG|>كابىل	k ɑ b i l
<|UIG|>كاتولىك	k ɑ t o l i k
<|UIG|>كاتېگورىيە	k ɑ t e ɡ o r i j ɛ
<|UIG|>كادمىي	k ɑ d m i j
<|UIG|>كاكاۋۇ	k ɑ k ɑ w u
<|UIG|>كالتسىي	k ɑ l t s i j
<|UIG|>كاللا	k ɑ l l ɑ
<|UIG|>كالىي	k ɑ l i j
<|UIG|>كامالەت	k ɑ m ɑ l ɛ t
<|UIG|>كاۋچۇك	k ɑ w t͡ʃ u k
<|UIG|>كرىمنىي	k r i m n i j
<|UIG|>كرىپتون	k r i p t o n
<|UIG|>كور	k o r
<|UIG|>كورلۇق	k o r l u q
<|UIG|>كونسۇل	k o n s u l
<|UIG|>كىت	k i t
<|UIG|>كىر	k i r
<|UIG|>كىرپىك	k i r p i k
<|UIG|>كىرپىچ	k i r p i t͡ʃ
<|UIG|>كىنو	k i n o
<|UIG|>كىپەك	k i p ɛ k
<|UIG|>كۆز	k ø z
<|UIG|>كۆكس	k ø k s
<|UIG|>كۆل	k ø l
<|UIG|>كۆمەك	k ø m ɛ k
<|UIG|>كۆينەك	k ø j n ɛ k
<|UIG|>كۆپۈك	k ø p y k
<|UIG|>كۆچ	k ø t͡ʃ
<|UIG|>كۇتۇپخانا	k u t u p χ ɑ n ɑ
<|UIG|>كۈلپەت	k y l p ɛ t
<|UIG|>كۈمۈش	k y m y ʃ
<|UIG|>كۈن	k y n
<|UIG|>كۈپ	k y p
<|UIG|>كېلەر	k e l ɛ r
<|UIG|>كېپىل	k e p i l
<|UIG|>كېچا	k e t͡ʃ ɑ
<|UIG|>كەشنىز	k ɛ ʃ n i z
<|UIG|>كەشپ	k ɛ ʃ p
<|UIG|>كەكلىك	k ɛ k l i k
<|UIG|>كەلمەك	k ɛ l m ɛ k
<|UIG|>كەنت	k ɛ n t
<|UIG|>كەندىر	k ɛ n d i r
<|UIG|>كەيپىيات	k ɛ j p i j ɑ t
<|UIG|>كەچۈرۈڭ	k ɛ t͡ʃ y r y ŋ
<|UIG|>كەۋسەر	k ɛ w s ɛ r
<|UIG|>لاك	l ɑ k
<|UIG|>لايىق	l ɑ j i q
<|UIG|>لايىھە	l ɑ j i h ɛ
<|UIG|>لاۋا	l ɑ w ɑ
<|UIG|>لاۋرېنتسىي	l ɑ w r e n t s i j
<|UIG|>لىباس	l i b ɑ s
<|UIG|>لىمونات	l i m o n ɑ t
<|UIG|>لىڭجەن	l i ŋ d͡ʒ ɛ n
<|UIG|>ليۇتېتسىي	l j u t e t s i j
<|UIG|>لۇغەت	l u ʁ ɛ t
<|UIG|>لۈتۈپ	l y t y p
<|UIG|>لەززەت	l ɛ z z ɛ t
<|UIG|>لەقەم	l ɛ q ɛ m
<|UIG|>لەنەت	l ɛ n ɛ t
<|UIG|>لەپ	l ɛ p
<|UIG|>لەڭگەر	l ɛ ŋ ɡ ɛ r
<|UIG|>مائارىپ	m ɑ ʔ ɑ r i p
<|UIG|>ماتكا	m ɑ t k ɑ
<|UIG|>ماجال	m ɑ d͡ʒ ɑ l
<|UIG|>ماددىي	m ɑ d d i j
<|UIG|>مارال	m ɑ r ɑ l
<|UIG|>مارت	m ɑ r t
<|UIG|>مارجان	m ɑ r d͡ʒ ɑ n
<|UIG|>مارگانېتىس	m ɑ r ɡ ɑ n e t i s
<|UIG|>ماقۇل	m ɑ q u l
<|UIG|>مالىيە	m ɑ l i j ɛ
<|UIG|>مامونت	m ɑ m o n t
<|UIG|>مانېۋىر	m ɑ n e w i r
<|UIG|>مايمۇن	m ɑ j m u n
<|UIG|>ماۋزۇ	m ɑ w z u
<|UIG|>مورفىن	m o r p i n
<|UIG|>مولىبدېن	m o l i b d e n
<|UIG|>مىس	m i s
<|UIG|>مىللەت	m i l l ɛ t
<|UIG|>مىليارد	m i l j ɑ r t
<|UIG|>مىمار	m i m ɑ r
<|UIG|>مىنگۇو	m i n ɡ u o
<|UIG|>مىنېرال	m i n e r ɑ l
<|UIG|>مىڭ	m i ŋ
<|UIG|>مۆڭ	m ø ŋ
<|UIG|>مۇئامىلە	m u ʔ ɑ m i l ɛ
<|UIG|>مۇئەززەم	m u ʔ ɛ z z ɛ m
<|UIG|>مۇئەسسەسە	m u ʔ ɛ s s ɛ s ɛ
<|UIG|>مۇئەللىم	m u ʔ ɛ l l i m
<|UIG|>مۇئەللىپ	m u ʔ ɛ l l i p
<|UIG|>مۇبارەك	m u b ɑ r ɛ k
<|UIG|>مۇبالىغە	m u b ɑ l i ʁ ɛ
<|UIG|>مۇتلەق	m u t l ɛ q
<|UIG|>مۇتەۋەللى	m u t ɛ w ɛ l l i
<|UIG|>مۇخالىپ	m u χ ɑ l i p
<|UIG|>مۇختار	m u χ t ɑ r
<|UIG|>مۇداخىلە	m u d ɑ χ i l ɛ
<|UIG|>مۇددەت	m u d d ɛ t
<|UIG|>مۇراسىم	m u r ɑ s i m
<|UIG|>مۇرەببى	m u r ɛ b b i
<|UIG|>مۇرەككەپ	m u r ɛ k k ɛ p
<|UIG|>مۇزاكىرە	m u z ɑ k i r ɛ
<|UIG|>مۇستەھكەم	m u s t ɛ h k ɛ m
<|UIG|>مۇسكۇل	m u s k u l
<|UIG|>مۇسھەپ	m u ʃ ɛ p
<|UIG|>مۇقام	m u q ɑ m
<|UIG|>مۇلازىمەت	m u l ɑ z i m ɛ t
<|UIG|>مۇنبەت	m u n b ɛ t
<|UIG|>مۇپتى	m u p t i
<|UIG|>مۇپەتتىش	m u p ɛ t t i ʃ
<|UIG|>مۇپەسسەل	m u p ɛ s s ɛ l
<|UIG|>مۇھاجىر	m u h ɑ d͡ʒ i r
<|UIG|>مۇھاسىرە	m u h ɑ s i r ɛ
<|UIG|>مۇھىت	m u h i t
<|UIG|>مۇۋەپپەقىيەت	m u w ɛ p p ɛ q i j ɛ t
<|UIG|>مۈشكۈل	m y ʃ k y l
<|UIG|>مۈشۈك	m y ʃ y k
<|UIG|>مېتان	m e t ɑ n
<|UIG|>مېترو	m e t r o
<|UIG|>مېھنەت	m e h n ɛ t
<|UIG|>مەبۇد	m ɛ b u t
<|UIG|>مەتبۇئات	m ɛ t b u ʔ ɑ t
<|UIG|>مەجلىس	m ɛ d͡ʒ l i s
<|UIG|>مەخلۇق	m ɛ χ l u q
<|UIG|>مەخمۇر	m ɛ χ m u r
<|UIG|>مەدرىسە	m ɛ d r i s ɛ
<|UIG|>مەركەز	m ɛ r k ɛ z
<|UIG|>مەرھۇم	m ɛ r h u m
<|UIG|>مەزمۇن	m ɛ z m u n
<|UIG|>مەزھەپ	m ɛ z h ɛ p
<|UIG|>مەسخىرە	m ɛ s χ i r ɛ
<|UIG|>مەسلەك	m ɛ s l ɛ k
<|UIG|>مەسىھ	m ɛ s i h
<|UIG|>مەسەلەن	m ɛ s ɛ l ɛ n
<|UIG|>مەشرەپ	m ɛ ʃ r ɛ p
<|UIG|>مەشغۇلات	m ɛ ʃ ʁ u l ɑ t
<|UIG|>مەشۋەرەت	m ɛ ʃ w ɛ r ɛ t
<|UIG|>مەغلۇبىيەت	m ɛ ʁ l u b i j ɛ t
<|UIG|>مەقئەت	m ɛ q ʔ ɛ t
<|UIG|>مەقسەت	m ɛ q s ɛ t
<|UIG|>مەكتۇپ	m ɛ k t u p
<|UIG|>مەمنۇن	m ɛ m n u n
<|UIG|>مەمۇر	m ɛ m u r
<|UIG|>مەنقۇلات	m ɛ n q u l ɑ t
<|UIG|>مەنپەئەت	m ɛ n p ɛ ʔ ɛ t
<|UIG|>مەيدان	m ɛ j d ɑ n
<|UIG|>مەھبۇس	m ɛ h b u s
<|UIG|>مەھسۇل	m ɛ h s u l
<|UIG|>مەھكەم	m ɛ h k ɛ m
<|UIG|>مەۋسۇم	m ɛ w s u m
<|UIG|>مەۋسۈم	m ɛ w s y m
<|UIG|>نائىلاج	n ɑ ʔ i l ɑ d͡ʒ
<|UIG|>نائىپ	n ɑ ʔ i p
<|UIG|>نائۇستا	n ɑ ʔ u s t ɑ
<|UIG|>ناترىي	n ɑ t r i j
<|UIG|>ناخشا	n ɑ χ ʃ ɑ
<|UIG|>نادان	n ɑ d ɑ n
<|UIG|>نازارەت	n ɑ z ɑ r ɛ t
<|UIG|>ناماز	n ɑ m ɑ z
<|UIG|>ناماقۇل	n ɑ m ɑ q u l
<|UIG|>نامە	n ɑ m ɛ
<|UIG|>نامەلۇم	n ɑ m ɛ l u m
<|UIG|>نان	n ɑ n
<|UIG|>ناپاك	n ɑ p ɑ k
<|UIG|>نوبېلىي	n o b e l i j
<|UIG|>نورمال	n o r m ɑ l
<|UIG|>نىجات	n i d͡ʒ ɑ t
<|UIG|>نىجاسەت	n i d͡ʒ ɑ s ɛ t
<|UIG|>نىسبەت	n i s b ɛ t
<|UIG|>نىسپىي	n i s p i j
<|UIG|>نىكېل	n i k e l
<|UIG|>نىوبىي	n i o b i j
<|UIG|>نىگار	n i ɡ ɑ r
<|UIG|>نۆلىنچى	n ø l i n t͡ʃ i
<|UIG|>نۆۋەت	n ø w ɛ t
<|UIG|>نۇر	n u r
<|UIG|>نېمىسچە	n e m i s t͡ʃ ɛ
<|UIG|>نېيترون	n e j t r o n
<|UIG|>نەبى	n ɛ b i
<|UIG|>نەسىر	n ɛ s i r
<|UIG|>نەسىل	n ɛ s i l
<|UIG|>نەشر	n ɛ ʃ r
<|UIG|>نەقلىيات	n ɛ q l i j ɑ t
<|UIG|>نەي	n ɛ j
<|UIG|>نەپرەت	n ɛ p r ɛ t
<|UIG|>نەپس	n ɛ p s
<|UIG|>نەپەس	n ɛ p ɛ s
<|UIG|>نەپەقە	n ɛ p ɛ q ɛ
<|UIG|>ياخشى	j ɑ χ ʃ i
<|UIG|>ياخشىمۇسىز	j ɑ χ ʃ i m u s i z
<|UIG|>يادىكار	j ɑ d i k ɑ r
<|UIG|>يار	j ɑ r
<|UIG|>يارا	j ɑ r ɑ
<|UIG|>يازماق	j ɑ z m ɑ q
<|UIG|>ياستۇق	j ɑ s t u q
<|UIG|>ياق	j ɑ q
<|UIG|>ياقماق	j ɑ q m ɑ q
<|UIG|>ياقۇت	j ɑ q u t
<|UIG|>يالغان	j ɑ l ʁ ɑ n
<|UIG|>يانماق	j ɑ n m ɑ q
<|UIG|>يانۋار	j ɑ n w ɑ r
<|UIG|>ياڭاق	j ɑ ŋ ɑ q
<|UIG|>ياڭيۇ	j ɑ ŋ j u
<|UIG|>ياگاو	j ɑ ɡ ɑ o
<|UIG|>ياۋۇز	j ɑ w u z
<|UIG|>يىتىم	j i t i m
<|UIG|>يىراقلىق	j i r ɑ q l i q
<|UIG|>يىلىك	j i l i k
<|UIG|>يىڭنە	j i ŋ n ɛ
<|UIG|>يۇتقۇنچاق	j u t q u n t͡ʃ ɑ q
<|UIG|>يۇلتۇز	j u l t u z
<|UIG|>يۇمماق	j u m m ɑ q
<|UIG|>يۇپقا	j u p q ɑ
<|UIG|>يۇڭ	j u ŋ
<|UIG|>يۈتمەك	j y t m ɛ k
<|UIG|>يۈز	j y z
<|UIG|>يۈسۈپ	j y s y p
<|UIG|>يېتەرسىز	j e t ɛ r s i z
<|UIG|>يېقىلغۇ	j e q i l ʁ u
<|UIG|>يېپىشماق	j e p i ʃ m ɑ q
<|UIG|>يېڭىلىق	j e ŋ i l i q
<|UIG|>يېۋروپىي	j e w r o p i j
<|UIG|>يەكۈن	j ɛ k y n
<|UIG|>يەل	j ɛ l
<|UIG|>يەلكەن	j ɛ l k ɛ n
<|UIG|>يەنى	j ɛ n i
<|UIG|>يەھۇدى	j ɛ h u d i
<|UIG|>پاجىر	p ɑ d͡ʒ i r
<|UIG|>پاراسەت	p ɑ r ɑ s ɛ t
<|UIG|>پاراكەندە	p ɑ r ɑ k ɛ n d ɛ
<|UIG|>پارلاق	p ɑ r l ɑ q
<|UIG|>پارچىلىماق	p ɑ r t͡ʃ i l i m ɑ q
<|UIG|>پاسىق	p ɑ s i q
<|UIG|>پاقا	p ɑ q ɑ
<|UIG|>پاكىز	p ɑ k i z
<|UIG|>پال	p ɑ l
<|UIG|>پانىي	p ɑ n i j
<|UIG|>پايتەخت	p ɑ j t ɛ χ t
<|UIG|>پايدا	p ɑ j d ɑ
<|UIG|>پاھىشە	p ɑ h i ʃ ɛ
<|UIG|>پروفېسسور	p r o p e s s o r
<|UIG|>پورازېودىم	p o r ɑ z e o d i m
<|UIG|>پىت	p i t
<|UIG|>پىلان	p i l ɑ n
<|UIG|>پىنگىۋىن	p i n ɡ i w i n
<|UIG|>پىنھان	p i n h ɑ n
<|UIG|>پۇتبول	p u t b o l
<|UIG|>پۇشايمان	p u ʃ ɑ j m ɑ n
<|UIG|>پۇل	p u l
<|UIG|>پېقىر	p e q i r
<|UIG|>پەخرى	p ɛ χ r i
<|UIG|>پەرز	p ɛ r z
<|UIG|>پەرى	p ɛ r i
<|UIG|>پەرىشتە	p ɛ r i ʃ t ɛ
<|UIG|>پەريات	p ɛ r j ɑ t
<|UIG|>پەرھىز	p ɛ r h i z
<|UIG|>پەرەزىي	p ɛ r ɛ z i j
<|UIG|>پەسىھ	p ɛ s i h
<|UIG|>پەقەت	p ɛ q ɛ t
<|UIG|>پەن	p ɛ n
<|UIG|>پەنجاب	p ɛ n d͡ʒ ɑ p
<|UIG|>چارەك	t͡ʃ ɑ r ɛ k
<|UIG|>چوكا	t͡ʃ o k ɑ
<|UIG|>چولپان	t͡ʃ o l p ɑ n
<|UIG|>چىراق	t͡ʃ i r ɑ q
<|UIG|>چىقماق	t͡ʃ i q m ɑ q
<|UIG|>چىكەتكە	t͡ʃ i k ɛ t k ɛ
<|UIG|>چېچەك	t͡ʃ e t͡ʃ ɛ k
<|UIG|>چەكمەك	t͡ʃ ɛ k m ɛ k
<|UIG|>ژاندارما	ʒ ɑ n d ɑ r m ɑ
<|UIG|>ژانىر	ʒ ɑ n i r
<|UIG|>ژۇرنال	ʒ u r n ɑ l
<|UIG|>گاباردىن	ɡ ɑ b ɑ r d i n
<|UIG|>گادولىنىي	ɡ ɑ d o l i n i j
<|UIG|>گاڭپەن	ɡ ɑ ŋ p ɛ n
<|UIG|>گويا	ɡ o j ɑ
<|UIG|>گىرانىت	ɡ i r ɑ n i t
<|UIG|>گىرىپ	ɡ i r i p
<|UIG|>گىياھ	ɡ i j ɑ h
<|UIG|>گۇاڭشى	ɡ u ɑ ŋ ʃ i
<|UIG|>گۇرۇھ	ɡ u r u h
<|UIG|>گۈللەر	ɡ y l l ɛ r
<|UIG|>گەدەن	ɡ ɛ d ɛ n
<|UIG|>ھاجى	h ɑ d͡ʒ i
<|UIG|>ھادىسە	h ɑ d i s ɛ
<|UIG|>ھازىرقى	h ɑ z i r q i
<|UIG|>ھايا	h ɑ j ɑ
<|UIG|>ھاۋا	h ɑ w ɑ
<|UIG|>ھاۋز	h ɑ w z
<|UIG|>ھىيلە	h i j l ɛ
<|UIG|>ھۆججەت	h ø d͡ʒ d͡ʒ ɛ t
<|UIG|>ھۆكۈم	h ø k y m
<|UIG|>ھېسسىي	h e s s i j
<|UIG|>ھېكايە	h e k ɑ j ɛ
<|UIG|>ھەب	h ɛ p
<|UIG|>ھەبەش	h ɛ b ɛ ʃ
<|UIG|>ھەجىم	h ɛ d͡ʒ i m
<|UIG|>ھەربىي	h ɛ r b i j
<|UIG|>ھەقىر	h ɛ q i r
<|UIG|>ھەقىقەتەن	h ɛ q i q ɛ t ɛ n
<|UIG|>ھەپتە	h ɛ p t ɛ
<|UIG|>ھەۋەسكار	h ɛ w ɛ s k ɑ r
<|UIG|>ۋاراق	w ɑ r ɑ q
<|UIG|>ۋارىس	w ɑ r i s
<|UIG|>ۋاز	w ɑ z
<|UIG|>ۋاپا	w ɑ p ɑ
<|UIG|>ۋېلىنېمەت	w e l i n e m ɛ t
<|UIG|>ۋەسىيەت	w ɛ s i j ɛ t
<|UIG|>ۋەقە	w ɛ q ɛ
<|UIG|>ۋەلسىپىت	w ɛ l s i p i t
<|UIG|>ۋەھشەت	w ɛ h ʃ ɛ t
