aare	ɑ ɹ ə
abacaxi	æ b ə k ə ʃ i
abashment	ə b æ ʃ m ə n t
abbreviation	ə b ɹ i v i e ɪ ʃ n̩
abderite	æ b d ə ɹ a ɪ t
abembryonic	æ b ɛ m b ɹ i ɑ n ɪ k
abhinaya	ə b ɪ n ə j ə
abidden	ə b ɪ d n̩
abietene	æ b i ə t i n
abjectness	æ b d͡ʒ ɛ k t n ə s
ableist	e ɪ b ə l ɪ s t
abruption	ə b ɹ ʌ p ʃ n̩
absinthism	æ b s ə n θ ɪ z m̩
abstruse	æ b s t ɹ u s
abuser	ə b j u z ɚ
acacia	ə k e ɪ ʃ ə
acaricide	ə k ɛ ɹ ə s i d
accessorial	æ k s ə s ɔ ɹ i ə l
accidental	æ k s ɪ d ɛ n t l̩
accismus	æ k s ɪ z m ə s
accommodating	ə k ɔ m ə d e ɪ t ɪ ŋ
acerb	ə s ɜ ɹ b
aceric	æ s ɜ ɹ ɪ k
acetary	ə s i t ə ɹ i
acidic	ə s ɪ d ɪ k
adam	æ d ə m
adiaphanous	æ d ɪ æ f ə n ə s
adle	e ɪ d ə l
adventurous	æ d v ɛ n t͡ʃ ɚ ʌ s
adytum	a d ə t ə m
aeolus	i o ʊ l ə s
affinity	ə f ɪ n ɪ t i
afflicted	ə f l ɪ k t ɪ d
aflutter	ə f l ʌ t ɚ
ageful	e ɪ d͡ʒ f ʊ l
agitation	æ d͡ʒ ɪ t e ɪ ʃ ə n
agnew	æ ɡ n u
ailed	e ɪ l d
alary	e ɪ l ə ɹ i
aldehydes	æ l d i h a ɪ d z
aleurometer	æ l j ə ɹ ɑ m ɪ t ɚ
algedonic	æ l d͡ʒ ɪ d ɔ n ɪ k
algo	æ l ɡ o ʊ̯
alias	e ɪ l i ə s
alleyway	æ l i w e ɪ
allies	æ l a ɪ z
allowance	ə l a ʊ ə n s
alluding	ə l u d ɪ ŋ
almucantar	æ l m ə k æ n t ɚ
alquifou	æ l k ɪ f u
amaranthine	æ m ə r æ n θ ɪ n
amphibolous	æ m f ɪ b ə l ə s
analogous	ə n æ l ə ɡ ə s
anarchy	æ n ɑ ɹ k i
anchovy	æ n t͡ʃ o ʊ v i
ancientry	e ɪ n ʃ ə n t ɹ i
angelina	æ n d͡ʒ ə l i n ə
anglesey	æ ŋ ɡ ə l s i
anglophilia	æ ŋ ɡ l o ʊ f ɪ l i ə
angolan	æ ŋ ɡ o ʊ l ə n
animalcule	æ n ɪ m æ l k j u l
animated	æ n ɪ m e ɪ t ɪ d
anlauts	a n l a ʊ t s
annette	ə n ɛ t
anomaloscope	ə n ɑ m ə l o ʊ s k o ʊ p
anorexia	æ n ə ɹ ɛ k s i ə
anthology	æ n θ ɑ l ə d͡ʒ i
antioxidant	æ n t i ɔ k s ɪ d ə n t
antirrio	æ n t ɪ ɹ i o ʊ
anxious	æ ŋ k ʃ ə s
aorist	e ɪ ə ɹ ɪ s t
apamea	æ p ə m i ə
apartment	ə p ɑ ɹ t m ə n t
apology	ə p ɔ l ə d͡ʒ i
appointment	ə p ɔ ɪ n t m ɛ n t
apraxia	ə p ɹ æ k s ɪ ə
aprium	e ɪ p ɹ i ə m
aprons	e ɪ p ɹ ə n z
aquabib	æ k w ə b ɪ b
aragon	æ ɹ ə ɡ ɑ n
arbuscle	ɑ b ʌ s ə l
archelaus	ɑ ɹ k ə l e ɪ ə s
arctogaeal	ɑ ɹ k t ə d͡ʒ i ə
arduous	ɑ ɹ d͡ʒ u ə s
arithmetician	ə ɹ ɪ θ m ə t ɪ ʃ ə n
artless	ɑ ɹ t l ɪ s
asphodel	æ s f ə d ɛ l
asplode	ə s p l o ʊ d
assimilation	ə s ɪ m ə l e ɪ ʃ ə n
assisting	ə s ɪ s t ɪ ŋ
asterix	æ s t ə ɹ ɪ k s
asteroids	æ s t ə ɹ o ɪ d z
astonishment	ə s t ɑ n ɪ ʃ m ə n t
astrozoology	æ s t ɹ ə z o ʊ ɔ l ə d͡ʒ i
asymmetry	e ɪ s ɪ m ɪ t ɹ i
atmosphere	æ t m ə s f ɪ ɹ
atom	a t ə m
attaching	ə t æ t͡ʃ ɪ ŋ
attests	ə t ɛ s t s
aubergine	o ʊ b ɚ ʒ i n
augean	ɔ d͡ʒ i ə n
augurs	ɔ ɡ ɚ z
augustan	ɔ ɡ ʌ s t ə n
austenite	ɔ s t ɪ n a ɪ t
austerity	ɔ s t ɛ ɹ ɪ t i
aventurine	ə v ɛ n t͡ʃ ə ɹ ɪ n
averroes	ə v ɛ ɹ o ʊ i z
aviation	e ɪ v i e ɪ ʃ ə n
awook	ə w ʊ k
axe	æ k s
azalea	ə z e ɪ l i ə
azeri	ə z ɛ ɹ i
backrest	b æ k ɹ e s t
backslang	b æ k s l æ ŋ
backstroke	b æ k s t ɹ o ʊ k
baconian	b ə k o ʊ n ɪ ə n
bactericide	b æ k t ɪ ə ɹ ɪ s a ɪ d
bacteriotherapy	b æ k t ɪ ə ɹ ɪ o ʊ θ e ɹ ə p i
badly	b æ d l i
baggage	b æ ɡ ɪ d͡ʒ
baggie	b æ ɡ i
bales	b e ɪ l z
ball	b ɔ l
ballcock	b ɔ l k ɔ k
ballet	b æ l e ɪ
baloney	b ə l o ʊ n i
bamf	b æ m f
bandersnatch	b æ n d ə ɹ s n æ t͡ʃ
baptism	b æ p t ɪ z ə m
barley	b ɑ ɹ l i
barnacle	b ɑ ɹ n ə k l̩
batcrap	b æ t k ɹ æ p
bayed	b e ɪ d
beads	b i d z
beam	b i m
beanbag	b i n b æ ɡ
beaten	b i t ə n
beater	b i t ɚ
beaus	b o ʊ z
beechmast	b i t͡ʃ m æ s t
beefsteak	b i f s t e ɪ k
beeping	b i p ɪ ŋ
beggings	b ɛ ɡ ɪ ŋ z
begnaw	b ɪ n ɔ
beholden	b i h o ʊ l d ə n
beida	b e ɪ d a
belches	b ɛ l t͡ʃ ɪ z
beluga	b ə l u ɡ ə
benevolence	b ə n ɛ v ə l ə n s
berg	b ɝ ɡ
bergamot	b ɝ ɡ ə m ɑ t
besalted	b ɪ s ɑ l t ɪ d
besprenge	b ɪ s p ɹ ɛ n d͡ʒ
bewitching	b ə w ɪ t͡ʃ ɪ ŋ
biceps	b a ɪ s ɛ p s
biennial	b a ɪ ɛ n ɪ ə l
biff	b ɪ f
bimetallic	b a ɪ m ɪ t æ l ɪ k
binal	b a ɪ n ə l
binomial	b a ɪ n o ʊ m i ə l
biological	b a ɪ ə l ɑ d͡ʒ ɪ k ə l
biscotti	b ɪ s k ɑ t i
bitty	b ɪ t i
blabs	b l æ b z
blackout	b l æ k a ʊ t
blazoning	b l e ɪ z ə n ɪ ŋ
blending	b l ɛ n d ɪ ŋ
blighted	b l a ɪ t ɪ d
blinkard	b l ɪ ŋ k ə ɹ d
blister	b l ɪ s t ɚ
blocks	b l ɑ k s
blond	b l ɑ n d
blunting	b l ʌ n t ɪ ŋ
boaster	b o ʊ s t ɚ
bogomile	b ɔ ɡ ə m a ɪ l
boko	b o ʊ k o ʊ
bolete	b o ʊ l i t
bonapartism	b o ʊ n ə p ɑ ɹ t ɪ z ə m
bond	b ɑ n d
bookshelf	b ʊ k ʃ ɛ l f
boon	b u n
bosques	b ɔ s k e ɪ z
boughten	b ɔ t ə n
boundings	b a ʊ n d ɪ ŋ z
bourdon	b ʊ ə d ə n
bovine	b o ʊ v a ɪ n
boy	b ɔ ɪ
braising	b ɹ e ɪ z ɪ ŋ
bramble	b ɹ æ m b ə l
brangle	b ɹ æ ŋ ɡ ə l
brassiere	b ɹ ə z ɪ ɹ
braves	b ɹ e ɪ v z
bread	b ɹ ɛ d
breasty	b ɹ ɛ s t i
breaths	b ɹ ɛ θ s
bred	b ɹ ɛ d
breeding	b ɹ i d ɪ ŋ
breton	b ɹ ɛ t ə n
bribing	b ɹ a ɪ b ɪ ŋ
bridgehead	b ɹ ɪ d͡ʒ h ɛ d
briefed	b ɹ i f t
brighten	b ɹ a ɪ t ə n
brightest	b ɹ a ɪ t ɪ s t
bringer	b ɹ ɪ ŋ ə ɹ
brisk	b ɹ ɪ s k
broseph	b ɹ o ʊ s ə f
brow	b ɹ a ʊ
browsing	b ɹ a ʊ z ɪ ŋ
brumby	b ɹ ʌ m b i
buckle	b ʌ k ə l
buffoonic	b ə f u n ɪ k
building	b ɪ l d ɪ ŋ
bullion	b ʊ l j ə n
bummer	b ʌ m ə ɹ
bundle	b ʌ n d ə l
bungle	b ʌ ŋ ɡ ə l
bupkis	b ʌ p k ɪ s
burb	b ɝ b
burdock	b ɝ d ɑ k
bureaucracy	b j ʊ ɹ ɑ k ɹ ə s i
bushel	b ʊ ʃ ə l
busted	b ʌ s t ə d
busticate	b ʌ s t ɪ k e ɪ t
butt	b ʌ t
butterbrot	b ʊ t ə ɹ b ɹ o ʊ t
butterfingered	b ʌ t ɚ f ɪ ŋ ɡ ɚ d
butterfish	b ʌ t ə ɹ f ɪ ʃ
byte	b a ɪ t
cacciatore	k ɑ t͡ʃ ə t ɔ ɹ i
caddy	k æ d i
caelum	s i l ə m
caitiff	k e ɪ t ɪ f
calas	k ə l ɑ
cali	k æ l i
cambuslang	k æ m b ə s l æ ŋ
cameron	k æ m ə ɹ ə n
camo	k æ m o ʊ
camp	k æ m p
camping	k æ m p ɪ ŋ
camps	k æ m p s
cancer	k æ n s ɚ
cant	k æ n t
capability	k e ɪ p ə b ɪ l ə t i
capacitate	k ə p æ s ɪ t e ɪ t
capisce	k ə p i ʃ
capless	k æ p l ə s
capricornus	k æ p ɹ ɪ k ɔ ɹ n ə s
capuchin	k æ p ə t͡ʃ ɪ n
carburetor	k ɑ ɹ b j ə ɹ e ɪ t ɚ
carcanet	k ɑ ɹ k ə n ɛ t
careen	k ə ɹ i n
carelessly	k ɛ ɹ l ə s l i
carer	k ɛ ɹ ɚ
carinthian	k ə r ɪ n θ i ə n
carlisle	k ɑ ɹ l a ɪ l
carson	k ɑ ɹ s ə n
catastrophic	k æ t ə s t ɹ ɔ f ɪ k
catchment	k æ t͡ʃ m ə n t
catless	k æ t l ə s
cavalcade	k æ v ə l k e ɪ d
caveat	k æ v i ɑ t
caws	k ɔ z
cedar	s i d ɚ
ceilidhean	k e ɪ l i ə n
cellophane	s ɛ l ə f e ɪ n
celluloid	s ɛ l j ə l ɔ ɪ d
ceqli	t͡ʃ ɛ ŋ l i
cervix	s ɝ v ɪ k s
chaconne	ʃ a k ɔ n
changing	t͡ʃ e ɪ n d͡ʒ ɪ ŋ
chaplin	t͡ʃ æ p l ɪ n
chappy	t͡ʃ æ p i
chen	t͡ʃ ɛ n
cherimoya	t͡ʃ ɛ ɹ ɪ m ɔ ɪ ə
cherine	ʃ ɪ ɹ i n
cheroot	t͡ʃ ə ɹ u t
chickenhawk	t͡ʃ ɪ k ɪ n h ɔ k
child	t͡ʃ a ɪ l d
childbed	t͡ʃ a ɪ l d b ɛ d
childrearing	t͡ʃ a ɪ l d ɹ ɪ ə ɹ ɪ ŋ
chimings	t͡ʃ a ɪ m ɪ ŋ z
chin	t͡ʃ ɪ n
chinatown	t͡ʃ a ɪ n ə t a ʊ n
chitinous	k a ɪ t ɪ n ə s
choenix	k i n ɪ k s
chon	t͡ʃ ɑ n
chopstix	t͡ʃ ɑ p s t ɪ k s
choral	k ɔ ɹ ə l
chord	k ɔ ɹ d
chose	t͡ʃ o ʊ z
chott	ʃ ɑ t
choupique	ʃ u p i k
christ	k ɹ a ɪ s t
chucky	t͡ʃ ʌ k i
chumpy	t͡ʃ ʌ m p i
ciera	s i ɛ ɹ ə
civilized	s ɪ v ɪ l a ɪ z d
cladribine	k l æ d ɹ ɪ b i n
clamped	k l æ m p t
clapping	k l æ p ɪ ŋ
claps	k l æ p s
cleanliness	k l ɛ n l i n ə s
clevedon	k l i v d ə n
cleverer	k l ɛ v ɚ ɚ
clinostat	k l a ɪ n ə s t æ t
clip	k l ɪ p
clithrophobia	k l ɪ θ ɹ ə f o ʊ b i ə
clivus	k l a ɪ v ə s
clockwork	k l ɑ k w ɝ k
closeup	k l o ʊ s ʌ p
clouds	k l a ʊ d z
cluck	k l ʌ k
clumpy	k l ʌ m p i
clumsiness	k l ʌ m z i n ə s
coals	k o ʊ l z
coates	k o ʊ t s
coeus	s i ə z
cohort	k o ʊ̯ h ɔ ɹ t
colander	k ɑ l ə n d ə ɹ
coleford	k o ʊ l f ə ɹ d
collection	k ə l ɛ k ʃ ə n
collective	k ə l ɛ k t ɪ v
combination	k ɑ m b ɪ n e ɪ ʃ ə n
combined	k ə m b a ɪ n d
combustion	k ə m b ʌ s t͡ʃ ə n
comedones	k ɑ m ɪ d o ʊ n i z
commixtion	k ə m ɪ k s t͡ʃ ə n
compilation	k ɑ m p ɪ l e ɪ ʃ ə n
complicate	k ɑ m p l ɪ k e ɪ t
computerette	k ə m p j u t ɚ ɹ ɛ t
conceded	k ə n s i d ɪ d
conceive	k ə n s i v
conclusion	k ə n k l u ʒ ə n
confiture	k ɔ n f ɪ t j ʊ ə ɹ
conformance	k ə n f ɔ m ə n s
confusion	k ə n f j u ʒ ə n
congeries	k ɑ n d͡ʒ ə ɹ i z
congo	k ɑ ŋ ɡ o ʊ
connotation	k ɑ n ə t e ɪ ʃ ə n
consecution	k ɔ n s ɪ k j u ʃ ə n
conspersion	k ə n s p ɜ ɹ ʒ ə n
construal	k ə n s t ɹ u ə l
contraband	k ɑ n t ɹ ə b æ n d
contracted	k ə n t ɹ æ k t ɪ d
controls	k ə n t͡ʃ ɹ o ʊ l s
convenable	k ə n v i n ə b ə l
convex	k ɑ n v ɛ k s
conway	k ɔ n w e ɪ
corna	k ɔ ɹ n ə
corncrake	k ɔ r n k r e ɪ k
corny	k ɔ ɹ n i
corradiate	k o ʊ ɹ e ɪ d i e ɪ t
corrugation	k ɔ r ə ɡ e ɪ ʃ ə n
corse	k ɔ ɹ s
cosmogony	k ɔ z m ɔ ɡ ə n i
cosmopolis	k ɔ z m ɔ p ɔ l ɪ s
costamere	k ɑ s t ə m ɪ ɹ
costive	k ɑ s t ɪ v
cotulla	k ə t j u l ə
coulisse	k u l i s
counterplot	k a ʊ n t ɚ p l ɑ t
counterpoise	k a ʊ n t ə ɹ p ɔ ɪ z
countrywide	k ʌ n t ɹ i w a ɪ d
couple	k ʌ p ə l
courtship	k ɔ ɹ t͡ʃ ɪ p
cowan	k a ʊ ə n
cowrie	k a ʊ ɹ i
crane	k ɹ e ɪ n
cream	k ɹ i m
creator	k ɹ i e ɪ t ɚ
crewmember	k ɹ u m ɛ m b ɚ
cronut	k ɹ o ʊ n ʌ t
crossed	k ɹ ɔ s t
crotch	k ɹ ɑ t͡ʃ
cruisings	k ɹ u z ɪ ŋ z
crustings	k ɹ ʌ s t ɪ ŋ z
cruz	k ɹ u z
crystalline	k ɹ ɪ s t ə l a ɪ n
css	s i ɛ s ɛ s
cuds	k ʌ d z
culled	k ʌ l d
culls	k ʌ l z
cumulation	k j u m j ə l e ɪ ʃ ə n
cusps	k ʌ s p s
cycles	s a ɪ k ə l z
cylindrical	s ɪ l ɪ n d ɹ ɪ k ə l
cynganeddion	k ə ŋ ə n ɛ ð j ə n
cypriot	s ɪ p ɹ i ə t
cyprus	s a ɪ p ɹ ə s
cytonuclear	s a ɪ t o n u k l i ɚ
daddy	d æ d i
daftness	d æ f t n ə s
dalry	d æ l ɹ a ɪ
dames	d e ɪ m z
damsel	d æ m z ə l
dan	d æ n
danae	d æ n e ɪ i
danbo	d æ n b o ʊ
dapagliflozin	d æ p ə ɡ l ə f l o ʊ z ɪ n
darken	d ɑ ɹ k ə n
davis	d e ɪ v ɪ s
dawson	d ɔ s ə n
daylights	d e ɪ l a ɪ t s
dazy	d e ɪ z i
deaths	d ɛ θ s
debasement	d ɪ b e ɪ s m ə n t
december	d ɪ s ɛ m b ə ɹ
decim	d ɛ s ɪ m
declan	d ɛ k l ə n
dedovshchina	dʲ ɪ d ɐ f ɕː i n ə
deepest	d i p ɪ s t
defcon	d ɛ f k ɑ n
deictic	d a ɪ k t ɪ k
deirdre	d ɪ ɹ d ɹ ə
delam	d i l æ m
delavirdine	d ɛ l ə v ɪ ɹ d i n
deluxe	d ə l ʌ k s
demonstratable	d ɛ m ə n s t ɹ e ɪ t ə b l
denotes	d ɪ n o ʊ t s
dentiparous	d ɛ n t ɪ p ə ɹ ə s
deontic	d i ɔ n t ɪ k
derelict	d ɛ ɹ ə l ɪ k t
deride	d ɪ ɹ a ɪ d
despairing	d ɪ s p ɛ ɹ ɪ ŋ
detraction	d ɪ t ɹ æ k ʃ ə n
dexterous	d ɛ k s t ɹ ə s
dextrin	d ɛ k s t ɹ ɪ n
dezh	d ɛ ʒ
diathetic	d a ɪ ə θ ə t ɪ k
dicked	d ɪ k t
didst	d ɪ d s t
different	d ɪ f ə ɹ ə n t
difficulties	d ɪ f ɪ k ə l t i z
digger	d ɪ ɡ ɚ
dimmer	d ɪ m ə ɹ
dimp	d ɪ m p
dims	d ɪ m z
dinning	d ɪ n ɪ ŋ
diocese	d a ɪ ə s ɪ s
dirigent	d ɪ ɹ ɪ d͡ʒ ə n t
disadvantage	d ɪ s ə d v æ n t ɪ d͡ʒ
disaster	d ɪ z æ s t ɚ
discography	d ɪ s k ɑ ɡ ɹ ə f i
disdain	d ɪ s d e ɪ n
disinvite	d ɪ s ɪ n v a ɪ t
displease	d ɪ s p l i z
dissension	d ɪ s ɛ n ʃ ə n
distress	d ɪ s t ɹ ɛ s
distribution	d ɪ s t ɹ ə b j u ʃ ə n
ditchings	d ɪ t͡ʃ ɪ ŋ z
diver	d a ɪ̯ v ə ɹ
dixie	d ɪ k s i
doggedly	d ɔ ɡ ə d l i
dominance	d ɑ m ɪ n ə n s
dominic	d ɑ m ə n ɪ k
dormouse	d ɔ ɹ m a ʊ s
doug	d ʌ ɡ
downed	d a ʊ n d
drapery	d ɹ e ɪ p ə ɹ i
dreaded	d ɹ ɛ d ɪ d
dreadful	d ɹ ɛ d f ʊ l
dreamed	d ɹ i m d
drey	d ɹ e ɪ
drillings	d ɹ ɪ l ɪ ŋ z
dronabinol	d ɹ o ʊ n æ b ɪ n ɔ l
droved	d ɹ o ʊ v d
drown	d ɹ a ʊ n
drowsing	d ɹ a ʊ z ɪ ŋ
drupe	d ɹ u p
duffy	d ʌ f i
dumpling	d ʌ m p l ɪ ŋ
dumpster	d ʌ m p s t ɚ
dundee	d ʌ n d i
dweller	d w ɛ l ə ɹ
dyscrasia	d ɪ s k ɹ e ɪ z ɪ ə
dystopian	d ɪ s t o ʊ p i ə n
earnestly	ɝ n ɪ s t l i
earwig	ɪ ə ɹ w ɪ ɡ
ease	i z
easel	i z ə l
easter	i s t ɚ
eastleigh	i s t l i
ecchymose	ɛ k ɪ m o ʊ z
ed	ɛ d
edgy	ɛ d͡ʒ i
edifice	ɛ d ɪ f ɪ s
editings	ɛ d ɪ t ɪ ŋ z
educational	ɛ d͡ʒ ʊ k e ɪ ʃ ə n ə l
educe	ɪ d u s
ees	i z
eff	ɛ f
effervescent	ɛ f ɚ v ɛ s ə n t
egestion	i d͡ʒ ɛ s t͡ʃ ə n
eggar	ɛ ɡ ɚ
eggs	ɛ ɡ z
electrolyte	i l ɛ k t ɹ ɵ l a ɪ t
elks	ɛ l k s
elutriate	ɪ l u t ɹ ɪ e ɪ t
elvan	ɛ l v ə n
elven	ɛ l v ə n
elytron	ɛ l ɪ t ɹ ɔ n
embarrassing	ɪ m b æ ɹ ə s ɪ ŋ
embolalia	ɛ m b ə l e ɪ l i ə
embroidery	ɪ m b ɹ ɔ ɪ d ə ɹ i
emesa	ɛ m ə s ə
empathic	ɛ m p æ θ ɪ k
enamored	ɪ n æ m ə ɹ d
enaunter	ɪ n ɔ n t ə ɹ
endeavouring	ɪ n d ɛ v ə ɹ ɪ ŋ
endymion	ɛ n d ɪ m i ə n
engineering	ɛ n d͡ʒ ɪ n ɪ ə ɹ ɪ ŋ
ensconce	ɛ n s k ɑ n s
entrust	ɪ n t ɹ ʌ s t
entscheidungsproblem	ɛ n t͡ʃ ʌ ɪ d ʊ ŋ s p ɹ ɔ b l ə m
epaulement	e ɪ p o ʊ l m ɑ n t
epeolatry	ɛ p i ɔ l ə t ɹ i
epicness	ɛ p ɪ k n ə s
epinephrine	ɛ p ɪ n ɛ f ɹ ɪ n
episcopalian	ə p ɪ s k ə p e ɪ l i n̩
eradicate	ɪ ɹ æ d ɪ k e ɪ t
erlking	ɜ l k ɪ ŋ
esker	ɛ s k ɚ
esoterica	ɛ s ɵ t ɛ ɹ ɪ k ə
esotropia	ɛ s o ʊ t ɹ o ʊ p i ə
estivate	ɛ s t ɪ v e ɪ t
estriol	ɛ s t ɹ a ɪ ɔ l
ethiopian	i θ i o ʊ p i ə n
etymology	ɛ t ɪ m ɑ l ə d͡ʒ i
eunatremic	j u n ə t ɹ i m ɪ k
euouae	j u u i
euterpe	j u t ɝ p i
excave	ɛ k s k e ɪ v
excommune	ɛ k s k ə m j u n
exhausted	ɪ ɡ z ɔ s t ɪ d
exporting	ɪ k s p ɔ ɹ t ɪ ŋ
extensive	ɛ k s t ɛ n s ɪ v
facer	f e ɪ s ə r
facile	f æ s ə l
fain	f e ɪ n
falsify	f ɔ l s ɪ f a ɪ
famished	f æ m ɪ ʃ t
farthest	f ɑ ɹ ð ɪ s t
fat	f æ t
fatso	f æ t s o ʊ
fatuous	f æ t͡ʃ u ə s
faults	f ɔ l t s
favors	f e ɪ v ɚ z
feck	f ɛ k
feckful	f ɛ k f ə l
feeb	f i b
felicity	f ə l ɪ s ɪ t i
fellah	f ɛ l ə
femaleness	f i m e ɪ l n ɪ s
fence	f ɛ n s
fettle	f ɛ t ə l
feudalist	f j u d ə l ɪ s t
filly	f ɪ l i
films	f ɪ l m z
fir	f ɝ
firebrand	f a ɪ ɚ b ɹ æ n d
fit	f ɪ t
fixable	f ɪ k s ə b ə l
fizzle	f ɪ z ə l
flab	f l æ b
flailing	f l e ɪ l ɪ ŋ
flashbulb	f l æ ʃ b ʌ l b
flat	f l æ t
flaubertian	f l o ʊ b ɝ t i ə n
flaxen	f l æ k s ə n
fleak	f l i k
fleming	f l ɛ m ɪ ŋ
flotilla	f l o ʊ t ɪ l ə
fluorophilic	f l ɔ ɹ ə f ɪ l ɪ k
foils	f ɔ ɪ l z
fool	f u l
footfall	f ʊ t f ɔ l
foreignness	f ɔ ɹ ə n n ə s
forint	f ɔ ɹ ɪ n t
forming	f ɔ ɹ m ɪ ŋ
foulard	f u l ɑ ɹ d
foxily	f ɔ k s ɪ l i
freaking	f ɹ i k ɪ ŋ
freck	f ɹ ɛ k
freedive	f r i d a ɪ v
freelance	f ɹ i l æ n s
freester	f ɹ i s t ɚ
fremd	f ɹ ɛ m d
fresher	f ɹ ɛ ʃ ɚ
frieze	f ɹ i z
frigging	f ɹ ɪ ɡ ɪ ŋ
fritz	f ɹ ɪ t s
frizzle	f ɹ ɪ z ə l
frosh	f ɹ ɔ ʃ
frowny	f ɹ a ʊ n i
frustrate	f ɹ ʌ s t ɹ e ɪ t
fucus	f j u k ə s
functions	f ʌ ŋ k ʃ ə n z
fussbutton	f ʌ s b ʌ t n̩
fuster	f ʌ s t ɚ
future	f j u t͡ʃ ɚ
gabe	ɡ e ɪ b
gangnam	ɡ ɑ ŋ n ɑ m
gasbag	ɡ æ s b æ ɡ
gast	ɡ æ s t
gavel	ɡ æ v ə l
geek	ɡ i k
generosity	d͡ʒ ɛ n ə ɹ ɑ s ə t i
genet	d͡ʒ ɛ n ɪ t
genocidaire	d͡ʒ ɛ n ə s i d ɛ ɹ
genteel	d͡ʒ ɛ n t i l
genus	d͡ʒ i n ə s
geodetics	d͡ʒ i o ʊ d ɛ t ɪ k s
geography	d͡ʒ i ɑ ɡ ɹ ə f i
geophyte	d͡ʒ i o ʊ f a ɪ t
gern	ɡ ɜ ɹ n
gibberish	d͡ʒ ɪ b ə ɹ ɪ ʃ
gigged	ɡ ɪ ɡ d
gilded	ɡ ɪ l d ɪ d
ginsu	ɡ ɪ n s u
gloomy	ɡ l u m i
gloria	ɡ l ɔ ɹ i ə
gmat	d͡ʒ i m æ t
gnaw	n ɔ
goguryeo	ɡ o ʊ ɡ ʊ ə ɹ i o ʊ
gout	ɡ a ʊ t
gowns	ɡ a ʊ n z
graft	ɡ ɹ æ f t
greengage	ɡ ɹ i n ɡ e ɪ d͡ʒ
gridlocks	ɡ ɹ ɪ d l ɔ k s
grieved	ɡ ɹ i v d
grinches	ɡ ɹ ɪ n t͡ʃ ɪ z
grip	ɡ ɹ ɪ p
grist	ɡ ɹ ɪ s t
grit	ɡ ɹ ɪ t
grogram	ɡ ɹ ɑ ɡ ɹ ə m
groupie	ɡ ɹ u p i
growlf	ɡ ɹ a ʊ l f
gruff	ɡ ɹ ʌ f
gruffish	ɡ ɹ ʌ f ɪ ʃ
guardiancy	ɡ ɑ ɹ d i ə n s i
guerdon	ɡ ɝ d ə n
guinevere	ɡ w ɪ n ɪ v ɪ ɹ
gums	ɡ ʌ m z
gunate	ɡ u n e ɪ t
gunship	ɡ ʌ n ʃ ɪ p
gushes	ɡ ʌ ʃ ɪ z
gusla	ɡ ʊ s l ə
guzheng	ɡ u d͡ʒ ʌ ŋ
habilitation	h ə b ɪ l ɪ t e ɪ ʃ ə n
hacienda	h ɑ s i ɛ n d ə
hades	h e ɪ d i z
haggard	h æ ɡ ɚ d
haida	h a ɪ d ə
haiti	h e ɪ t i
hallucination	h ə l u s ɪ n e ɪ ʃ ə n
hanger	h æ ŋ ɡ ɚ
hardened	h ɑ ɹ d n̩ d
harmonize	h ɑ ɹ m ə n a ɪ z
hath	h æ θ
haupt	h a ʊ p t
havoc	h æ v ə k
hazelwood	h e ɪ z ə l w ʊ d
headdesk	h ɛ d d ɛ s k
headwind	h ɛ d w ɪ n d
heaty	h i t i
hebdomadal	h ɛ b d ɔ m ə d ə l
hebrides	h ɛ b ɹ ə d i z
hecatonicosachoron	h ɛ k ə t ɔ n a ɪ k o ʊ s i k o ʊ ɹ ɔ n
heles	h i l z
hellacious	h ɛ l e ɪ ʃ ə s
helladic	h ə l æ d ɪ k
hellenicity	h ɛ l ɛ n ɪ s ə t i
hemocytometer	h i m o ʊ s a ɪ t ɑ m ɪ ɾ ɚ
hep	h ɛ p
heriot	h ɛ ɹ ɪ ə t
hertz	h ɝ t s
hicked	h ɪ k t
hicking	h ɪ k ɪ ŋ
hickman	h ɪ k m ə n
hieroglyphic	h a ɪ ɹ ə ɡ l ɪ f ɪ k
higham	h a ɪ ə m
highfather	h a ɪ f ɑ ð ɚ
hijackers	h a ɪ d͡ʒ æ k ə ɹ s
hippyish	h ɪ p i ɪ ʃ
hirs	h ɪ ɹ z
hisses	h ɪ s ɪ z
hittite	h ɪ t a ɪ t
hobbyist	h ɑ b i ɪ s t
homer	h o ʊ m ə ɹ
homodimer	h o ʊ m o ʊ d a ɪ m ɚ
honeyed	h ʌ n i d
hooted	h u t ɪ d
hornbeam	h ɔ ɹ n b i m
hornbill	h ɔ ɹ n b ɪ l
horologion	ɔ ɹ ə l ɔ j ɔ n
houthi	h u θ i
hov	e ɪ t͡ʃ o ʊ v i
huboon	h j u b u n
hulks	h ʌ l k s
humbert	h ʌ m b ə ɹ t
hunnic	h ʌ n ɪ k
hutt	h ʌ t
hydaspes	h a ɪ d æ s p i z
hydrocodone	h a ɪ d ɹ o ʊ k o ʊ d o ʊ n
hyllus	h ɪ l ə s
hyp	h ɪ p
hyperemotional	h a ɪ p ə ɹ i m o ʊ ʃ ə n ə l
hyperplasia	h a ɪ p ɚ p l e ɪ ʒ ə
hyrax	h a ɪ ɹ æ k s
ibisbill	a ɪ b ɪ s b ɪ l
ibotenic	i b o ʊ t ɛ n ɪ k
icebreaker	a ɪ s b ɹ e ɪ k ə ɹ
icositetrachoron	a ɪ k o ʊ s i t ɛ t ɹ ə k o ʊ ɹ ɔ n
ielts	a ɪ̯ ɛ l t s
ignote	ɪ ɡ n o ʊ t
ikey	ʌ ɪ k i
illecebrous	ɪ l ɛ s ɪ b ɹ ə s
illimitable	ɪ l ɪ m ɪ t ə b ə l
ily	ɪ l i
immerse	ɪ m ɜ ɹ s
immutably	ɪ m j u t ə b l ɪ
impales	ɪ m p e ɪ l z
imperfection	ɪ m p ɚ f ɛ k ʃ ə n
imperil	ɪ m p ɛ ɹ ə l
imply	ɪ m p l a ɪ
importunity	ɪ m p ɔ ɹ t u n ɪ t i
impoverished	ɪ m p ɑ v ə ɹ ɪ ʃ t
impressive	ɪ m p ɹ ɛ s ɪ v
impugn	ɪ m p j u n
imputation	ɪ m p j ʊ t e ɪ ʃ ə n
inaccurate	ɪ n æ k j ʊ ɹ ə t
inappropro	ɪ n ə p ɹ o ʊ p ɹ o ʊ
inchings	ɪ n t͡ʃ ɪ ŋ z
inconsiderate	ɪ n k ə n s ɪ d ə ɹ ɪ t
incredulity	ɪ n k ɹ ɪ d j u l ɪ t i
indebted	ɪ n d ɛ t ɪ d
indecision	ɪ n d ɪ s ɪ ʒ ə n
indeterminate	ɪ n d ɪ t ɜ ɹ m ɪ n ə t
indices	ɪ n d ɪ s i z
indulge	ɪ n d ʌ l d͡ʒ
infiltrationism	ɪ n f ɪ l t ɹ e ɪ ʃ ə n ɪ z m̩
inflammable	ɪ n f l æ m ə b ə l
informant	ɪ n f ɔ ɹ m ə n t
ingemination	ɪ n d͡ʒ ɛ m ɪ n e ɪ ʃ ə n
ingredient	ɪ n ɡ ɹ i d i ə n t
inhabitant	ɪ n h æ b ɪ t ə n t
inheritance	ɪ n h ɛ ɹ ə t ə n s
initial	ɪ n ɪ ʃ ə l
injector	ɪ n d͡ʒ ɛ k t ɚ
inosite	ɪ n ə s a ɪ t
inquest	ɪ ŋ k w ɛ s t
inquiration	ɪ ŋ k w ɪ ɹ e ɪ ʃ ə n
insolvable	ɪ n s ɔ l v ə b ə l
insure	ɪ n ʃ ʊ ɚ
intently	ɪ n t ɛ n t l i
intermezzo	ɪ n t ɚ m ɛ t s o ʊ
intermittent	ɪ n t ɚ m ɪ t n̩ t
interspecific	ɪ n t ɚ s p ə s ɪ f ɪ k
interventive	ɪ n t ɚ v ɛ n t ə v
intrahepatic	ɪ n t ɹ ə h ə p æ t ɪ k
intraresidue	ɪ n t ɹ ə ɹ ɛ z ɪ d u
invariably	ɪ n v ɛ ɹ i ə b l i
iphone	a ɪ f o ʊ̯ n
irredeemable	ɪ ɹ ə d i m ə b ə l
irreparable	ɪ ɹ ɛ p ə ɹ ə b ə l
irruent	ɪ ɹ ɪ ʊ ə n t
isauria	a ɪ s ɔ ɹ i ə
isethionate	a ɪ s ɪ θ a ɪ ə n e ɪ t
isolated	a ɪ s ə l e ɪ t ɪ d
isotropy	a ɪ s ɔ t ɹ ə p i
isthmus	ɪ s m ə s
italianization	ɪ t æ l j ə n ə z e ɪ ʃ ə n
iwan	i w ɑ n
jacal	h ə k ɑ l
jace	d͡ʒ e ɪ s
jakun	d͡ʒ ʌ k u n
janissary	d͡ʒ æ n ə z e ɹ i
japanese	d͡ʒ æ p ə n i z
jared	d͡ʒ æ ɹ ə d
jenkin	d͡ʒ ɛ ŋ k ɪ n
jestings	d͡ʒ ɛ s t ɪ ŋ z
jig	d͡ʒ ɪ ɡ
jodhpurs	d͡ʒ ɑ d p ɚ z
johnnycake	d͡ʒ ɑ n i k e ɪ k
jonathan	d͡ʒ ɑ n ə θ ə n
journal	d͡ʒ ɝ n ə l
judder	d͡ʒ ʌ d ɚ
judeophilia	d͡ʒ u d i o ʊ f ɪ l ɪ ə
juicer	d͡ʒ u s ɚ
justify	d͡ʒ ʌ s t ɪ f a ɪ
katana	k ə t ɑ n ə
kellia	k ɛ l i ə
keynsham	k e ɪ n ʃ ə m
khazar	k ə z ɑ ɹ
kiki	k i k i
kinds	k a ɪ n d z
kishke	k ɪ ʃ k ə
kithe	k ʌ ɪ ð
klein	k l a ɪ n
kniffles	n ɪ f l i z
koi	k ɔ ɪ
kriol	k ɹ i o ʊ l
kylix	k a ɪ l ɪ k s
kylixes	k a ɪ l ɪ k s ə z
kyphotone	k a ɪ f ə t o ʊ n
kyrgyz	k ɪ ɹ ɡ ɪ z
labiodental	l e ɪ b i o ʊ d e n t ə l
labor	l e ɪ b ɚ
lacerated	l æ s ə ɹ e ɪ t ɪ d
laciniate	l ə s ɪ n i ə t
lack	l æ k
lacrimogenous	l æ k ɹ ɪ m ɑ d͡ʒ ə n ə s
ladakh	l ə d ɑ k
laden	l e ɪ d ə n
lageniform	l ə d͡ʒ ɛ n ə f ɔ ɹ m
lager	l ɑ ɡ ɚ
landing	l æ n d ɪ ŋ
landon	l æ n d ə n
landover	l æ n d o ʊ v ə ɹ
languet	l æ ŋ ɡ w ɪ t
langur	l ʌ ŋ ɡ ʊ ə ɹ
lantibiotic	l æ n t i b a ɪ ɔ t ɪ k
lapses	l æ p s ɪ z
lariat	l æ ɹ ɪ ə t
laters	l e ɪ t ɚ z
lazed	l e ɪ z d
leaks	l i k s
leapfrog	l i p f ɹ ɑ ɡ
legato	l ə ɡ ɑ t o ʊ
leninite	l ɛ n ɪ n a ɪ t
lesdar	l ɛ z d ɑ ɹ
lesson	l ɛ s n̩
lethargy	l ɛ θ ɚ d͡ʒ i
leucotome	l u k ə t o ʊ m
levitous	l ɛ v ɪ t ə s
lewdness	l u d n ə s
lezzer	l ɛ z ɚ
li	l i
lias	l i ə s
libertine	l ɪ b ɚ t i n
lignify	l ɪ ɡ n ɪ f a ɪ
likelihood	l a ɪ k l i h ʊ d
liken	l a ɪ k ə n
likin	l i k ɪ n
lil	l ɪ l
lilliputian	l ɪ l ɪ p j u ʃ ə n
limn	l ɪ m
limner	l ɪ m n ɚ
lipline	l ɪ p l a ɪ n
listicle	l ɪ s t ə k l̩
listing	l ɪ s t ɪ ŋ
litharge	l ɪ θ ɑ ɹ d͡ʒ
litterateur	l ɪ t ə ɹ ə t ʊ ɚ
loaf	l o ʊ f
loam	l o ʊ m
lodgment	l ɑ d͡ʒ m ə n t
loggat	l ɔ ɡ ə t
logological	l ɑ ɡ o ʊ l ɑ d͡ʒ i k ə l
logorrhea	l ɔ ɡ ə ɹ i ə
logy	l o ʊ ɡ i
londraville	l ɑ n d ɹ ə v ɪ l
long	l ɔ ŋ
longed	l ɔ ŋ d
longeval	l ɔ n d͡ʒ i v ə l
longhope	l ɔ ŋ h o ʊ p
looked	l ʊ k t
loose	l u s
lote	l o ʊ t
lottery	l ɑ t ɚ i
lusk	l ʌ s k
lusophilia	l u s ə f ɪ l ɪ ə
macdonald	m ə k d ɑ n ə l d
macher	m ɑ x ɛ ɹ
machinist	m ə ʃ i n ɪ s t
macky	m æ k i
macspaunday	m ə k s p ɔ n d e ɪ
maggie	m æ ɡ i
magnesia	m æ ɡ n i ʒ ə
magnificent	m æ ɡ n ɪ f ə s ə n t
maidan	m a ɪ d ɑ n
malady	m æ l ə d i
malamute	m æ l ə m j u t
malarkey	m ə l ɑ ɹ k i
malevolent	m ə l ɛ v ə l ə n t
malodorous	m æ l o ʊ d ə ɹ ə s
mammal	m æ m ə l
mandarin	m æ n d ə ɹ ɪ n
mandom	m æ n d ə m
manks	m æ ŋ k s
manly	m æ n l i
manpack	m æ n p æ k
mantilla	m æ n t i j ə
map	m æ p
marginally	m ɑ ɹ d͡ʒ ɪ n ə l i
mariah	m ə ɹ a ɪ ə
marine	m ə ɹ i n
marocain	m ɑ ɹ ə k e ɪ n
massachusetts	m æ s ə t͡ʃ u s ɪ t s
massingbird	m æ s ɪ ŋ b ɜ ɹ d
masterdom	m æ s t ɚ d ə m
maulstick	m ɔ l s t ɪ k
meal	m i l
mean	m i n
mediator	m i d i e ɪ t ɚ
meerkitten	m i ə k ɪ t ə n
membraneous	m ɛ m b ɹ e ɪ n i ə s
men	m ɛ n
mendaciously	m ɛ n d e ɪ ʃ ə s l i
mendelevium	m ɛ n d ə l i v i ə m
mental	m ɛ n t ə l
merenchyma	m ɛ ɹ ɪ ŋ k a ɪ m ə
mesmerize	m ɛ z m ə ɹ a ɪ z
messias	m ə s a ɪ ə s
messrs	m ɛ s ɚ z
metacercaria	m ɛ t ə s ɜ ɹ k ɛ ɹ ɪ ə
metatheoretical	m ɛ t ə θ i ə ɹ ɛ t ɪ k l̩
mete	m i t
meth	m ɛ θ
metharbital	m ə θ ɑ ɹ b ə t ɔ l
metic	m ɛ t ə k
mexiletine	m ɛ k s ɪ l ə t i n
microzyma	m a ɪ k ɹ o ʊ z a ɪ m ə
milnacipran	m ɪ l n æ s ə p ɹ æ n
mimantean	m ɪ m æ n t i ə n
mime	m a ɪ m
ministerial	m ɪ n ə s t ɪ ɹ i ə l
minto	m ɪ n t o ʊ
minyans	m ɪ n a ɪ ə n z
miserabilist	m ɪ z ə ɹ ə b ə l ɪ s t
miserly	m a ɪ z ə ɹ l i
misoprostol	m a ɪ s o ʊ p ɹ ɑ s t ɔ l
mithraeum	m ɪ θ ɹ i ə m
mitre	m a ɪ t ə ɹ
mizo	m ɪ z o ʊ
mnemotechnical	n ɛ m o ʊ t ɛ k n ɪ k ə l
moan	m o ʊ n
modus	m o ʊ d ə s
mogwai	m ɔ ɡ w a ɪ
moil	m ɔ ɪ l
molestation	m o ʊ l ɪ s t e ɪ ʃ ə n
monaco	m ɑ n ə k o ʊ
montpellier	m ɔ n p ɛ l i e ɪ
montseny	m ɔ n t s e ɪ n
moonwalk	m u n w ɔ k
moos	m u z
morass	m ə ɹ æ s
mosey	m o ʊ z i
motel	m o ʊ t ɛ l
mowed	m o ʊ d
much	m ʌ t͡ʃ
mud	m ʌ d
mundialization	m ɑ n d i ə l ə z e ɪ ʃ ə n
munificence	m j u n ɪ f ɪ s ə n s
mussolini	m ʊ s ə l i n i
mutable	m j u t ə b l̩
myeloid	m a ɪ ə l ɔ ɪ d
myob	ɛ m w a ɪ o ʊ b i
myoglobinemia	m a ɪ o ʊ ɡ l o ʊ b ɪ n i m i ə
mystic	m ɪ s t ɪ k
myvyrian	m i v ɪ ɹ i ə n
nabal	n e ɪ b ə l
naltrexone	n æ l t ɹ ɛ k s o ʊ n
naming	n e ɪ m ɪ ŋ
nandrolone	n æ n d ɹ ə l o ʊ n
nanson	n æ n s ə n
nanterre	n ɑ n t ɛ ɹ
narrowly	n ɛ ɹ o ʊ l i
nate	n e ɪ t
nazareth	n æ z ə ɹ ə θ
ncaa	ɛ n s i e ɪ e ɪ
neb	n ɛ b
nectar	n ɛ k t ə ɹ
need	n i d
needful	n i d f ə l
negus	n i ɡ ə s
nephite	n i f a ɪ t
nepotic	n ə p ɔ t ɪ k
nervy	n ɝ v i
netter	n ɛ t ə ɹ
neutral	n u t ɹ ə l
neville	n ɛ v ə l
newman	n u m ə n
nifurtimox	n a ɪ f ɝ t ɪ m ɑ k s
niggery	n ɪ ɡ ə ɹ i
nighness	n a ɪ n ə s
nintendo	n ɪ n t ɛ n d o ʊ
niobium	n a ɪ o ʊ b i ə m
nithing	n a ɪ ð ɪ ŋ
nob	n ɑ b
nog	n ɔ ɡ
nominalize	n ɑ m ə n ə l a ɪ z
noscapine	n ɑ s k ə p i n
nougat	n u ɡ ə t
nulls	n ʌ l z
numinous	n j u m ə n ə s
obliviality	ə b l ɪ v i æ l ɪ t i
obsequious	ə b s i k w i ə s
obstinacy	ɑ b s t ɪ n ə s i
occupied	ɑ k j ə p a ɪ d
octad	ɑ k t æ d
octobers	ɑ k t o ʊ b ɚ z
octosyllabic	ɑ k t o ʊ s ɪ l æ b ɪ k
octyne	ɔ k t a ɪ n
offend	ə f ɛ n d
oiler	ɔ ɪ l ɚ
ok	o ʊ k e ɪ
olson	o ʊ l s ə n
omohyoid	o ʊ m o ʊ h a ɪ ɔ ɪ d
onchocerciasis	ɔ ŋ k ə s ɜ k a ɪ ə s ɪ s
oneirocritic	o ʊ n a ɪ ɹ ə k ɹ ɪ t ɪ k
onymous	ɑ n ɪ m ə s
oov	u v
openly	o ʊ p ə n l i
orangeat	ɔ ɹ æ n ʒ æ t
orfe	ɔ f
organum	ɔ ɹ ɡ ə n ə m
orotundity	ɔ ɹ ə t ʌ n d ɪ t i
ossify	ɑ s ə f a ɪ
ostentation	ɔ s t ə n t e ɪ ʃ ə n
ostrichism	ɑ s t ɹ i t͡ʃ ɪ z ə m
otira	o ʊ t ɪ ɹ ɑ
ouagadougou	w ɑ ɡ ə d u ɡ u
ouguiya	u ɡ i j ə
overact	o ʊ v ə ɹ æ k t
overawe	o ʊ v ɚ ɔ
overdraft	o ʊ v ɚ d ɹ æ f t
overlive	o ʊ v ə ɹ l ɪ v
overproof	o ʊ v ɚ p ɹ u f
oversolicitous	o ʊ v ɚ s ə l ɪ s ɪ ɾ ə s
overspecialization	o ʊ v ɚ s p ɛ ʃ ə l ɪ z e ɪ ʃ n̩
overview	o ʊ v ə ɹ v j u
oxycodone	ɑ k s ɪ k o ʊ d o ʊ n
oxymethazoline	ɑ k s ɪ m ə θ æ z ə l i n
paan	p ɑ n
packet	p æ k ɪ t
pact	p æ k t
pagination	p æ d͡ʒ ə n e ɪ ʃ ə n
paint	p e ɪ n t
painting	p e ɪ n t ɪ ŋ
paladin	p æ l ə d ɪ n
palau	p ə l a ʊ
panendeistic	p æ n ɛ n d i ɪ s t ɪ k
pantheists	p æ n t h i ĭ s t s
pantries	p æ n t ɹ i z
paraenesis	p ə ɹ i n ɪ s ɪ s
paramour	p æ ɹ ə m ɔ ɹ
parchment	p ɑ ɹ t͡ʃ m ə n t
parfilage	p ɑ ɹ f ɪ l ɑ ʒ
parity	p æ ɹ ɪ t i
participation	p ɑ ɹ t ɪ s ɪ p e ɪ ʃ ə n
parting	p ɑ ɹ t ɪ ŋ
passively	p æ s ɪ v l i
pasture	p æ s t͡ʃ ɚ
pater	p e ɪ t ɚ
patientive	p e ɪ ʃ ə n t ɪ v
patroon	p ə t ɹ u n
patting	p æ t ɪ ŋ
paving	p e ɪ v ɪ ŋ
payer	p e ɪ ɚ
peach	p i t͡ʃ
peacocking	p i k ɑ k ɪ ŋ
peasants	p ɛ z ə n t s
pebbles	p ɛ b ə l z
peck	p ɛ k
peddle	p ɛ d ə l
pee	p i
peeves	p i v z
pembrokeshire	p ɛ m b ɹ ʊ k ʃ ə ɹ
peptics	p ɛ p t ɪ k s
perfidious	p ɚ f ɪ d i ə s
periegete	p ɛ ɹ i ə d͡ʒ i t
periodical	p ɪ ɹ i ɑ d ɪ k l̩
perpetual	p ɚ p ɛ t͡ʃ u ə l
perseverate	p ɚ s ɛ v ə ɹ e ɪ t
pert	p ɝ t
perth	p ɝ θ
pestled	p ɛ s ə l d
petalous	p ɛ t ə l ə s
pettywhin	p ɛ t i w ɪ n
phillip	f ɪ l ɪ p
phinary	f a ɪ n ə ɹ i
phosphorus	f ɑ s f ɚ ə s
picnics	p ɪ k n ɪ k s
piggott	p ɪ ɡ ə t
pilate	p a ɪ l ə t
piles	p a ɪ l z
pilled	p ɪ l d
pima	p i m ə
pincer	p ɪ n s ə ɹ
piquing	p i k ɪ ŋ
piscivore	p ɪ s ɪ v ɔ ɹ
pishogue	p ɪ ʃ o ʊ ɡ
pituitary	p ɪ t u ɪ t ɛ ɹ i
pixie	p ɪ k s i
placed	p l e ɪ s t
placenta	p l ə s ɛ n t ə
plag	p l æ d͡ʒ
planchette	p l æ n ʃ ɛ t
plane	p l e ɪ n
planning	p l æ n ɪ ŋ
plasmid	p l æ z m ɪ d
pleat	p l i t
plectrum	p l ɛ k t ɹ ə m
plogging	p l ɔ ɡ ɪ ŋ
pluck	p l ʌ k
pluranimous	p l ʊ ɹ æ n ɪ m ə s
pococurantism	p o ʊ k o ʊ k j ʊ ɹ æ n t ɪ z ə m
polysemic	p ɔ l ɪ s i m ɪ k
polyzoa	p ɔ l i z o ʊ ə
pooped	p u p t
pork	p ɔ ɹ k
portentously	p ɔ t e n t ə s l i
portrayal	p ɔ ɹ t ɹ e ɪ ə l
positivism	p ɑ z ɪ t ɪ v ɪ z m
posology	p ə z ɑ l ə d͡ʒ i
prairial	p ɹ ɛ ɹ j ɑ l
prate	p ɹ e ɪ t
pratt	p ɹ æ t
preconsonantal	p ɹ i k ɔ n s ə n æ n t ə l
predilection	p ɹ ɛ d ə l ɛ k ʃ n̩
preengage	p r i ɪ n ɡ e ɪ d͡ʒ
prefect	p ɹ i f e k t
prefer	p ɹ ɪ f ɝ
preke	p ɹ i k
prelect	p ɹ ɪ l ɛ k t
prenup	p ɹ i n ʌ p
preoccupy	p ɹ i ɑ k j u p a ɪ
prescriptive	p ɹ ɪ s k ɹ ɪ p t ɪ v
presented	p ɹ ɪ z ɛ n t ɪ d
presuit	p ɹ ɪ s j u t
prevention	p ɹ ɪ v ɛ n ʃ ə n
primitive	p ɹ ɪ m ɪ t ɪ v
prised	p ɹ a ɪ z d
prisoned	p ɹ ɪ z ə n d
probability	p ɹ ɑ b ə b ɪ l ɪ ɾ i
procedures	p ɹ ə s i d͡ʒ ɚ s
proceeded	p ɹ ə s i d ɪ d
profuseness	p ɹ o ʊ f j u s n ə s
prognosis	p ɹ ɑ ɡ n o ʊ s ɪ s
prolix	p ɹ o ʊ l ɪ k s
propane	p ɹ o ʊ p e ɪ n
proposed	p ɹ ə p o ʊ z d
proposition	p ɹ ɑ p ə z ɪ ʃ ə n
prosaism	p ɹ o ʊ z e ɪ ɪ z ə m
prosperous	p ɹ ɑ s p ə ɹ ə s
protect	p ɹ ə t ɛ k t
provide	p ɹ ə v a ɪ d
provisional	p ɹ ə v ɪ ʒ ə n ə l
prowl	p ɹ a ʊ l
prowled	p ɹ a ʊ l d
proximity	p ɹ ɑ k s ɪ m ɪ t i
psaki	s ɑ k i
psych	s a ɪ k
ptolemaic	t ɑ l ə m e ɪ ɪ k
publican	p ʌ b l ɪ k ə n
puffy	p ʌ f i
pug	p ʌ ɡ
pulleys	p ʊ l i z
pullulate	p ʌ l j ʊ l e ɪ t
pumps	p ʌ m p s
punishings	p ʌ n ɪ ʃ ɪ ŋ z
pursuing	p ɚ s u ɪ ŋ
pyramidal	p ɪ ɹ æ m ɪ d l̩
pyrophyte	p a ɪ ɹ ə f a ɪ t
quacks	k w æ k s
quadriplegia	k w ɑ d ɹ ɪ p l i d͡ʒ ə
quarl	k w ɔ ɹ l
quarry	k w ɔ ɹ i
queerdar	k w ɪ ɹ d ɑ ɹ
quicksilver	k w ɪ k s ɪ l v ɚ
quidnunc	k w ɪ d n ʌ ŋ k
quintillionth	k w ɪ n t ɪ l i ə n θ
rach	ɹ e ɪ t͡ʃ
radius	ɹ e ɪ d i ə s
radon	ɹ e ɪ d ɔ n
rains	ɹ e ɪ n z
rapunzel	ɹ ə p ʌ n z ə l
rats	ɹ æ t s
rattail	ɹ æ t t e ɪ l
ravage	ɹ æ v ɪ d͡ʒ
ravel	ɹ æ v ə l
ravening	ɹ æ v ə n ɪ ŋ
reaction	ɹ i æ k ʃ ə n
reap	ɹ i p
reason	ɹ i z ə n
rebellion	ɹ ɪ b ɛ l i ə n
recalcitrance	ɹ ɪ k æ l s ɪ t ɹ ə n s
receivability	ɹ ə s i v ɑ b ɪ l ɪ t i
recrimination	ɹ i k ɹ ɪ m ə n e ɪ ʃ ə n
recto	ɹ ɛ k t o ʊ
redebug	ɹ i d i b ʌ ɡ
redig	ɹ i d ɪ ɡ
reduce	ɹ ɪ d u s
reese	ɹ i s
regarding	ɹ ɪ ɡ ɑ ɹ d ɪ ŋ
regorge	ɹ ɪ ɡ ɔ ɹ d͡ʒ
regulating	ɹ ɛ ɡ j ə l e ɪ t ɪ ŋ
regurgitate	ɹ ɪ ɡ ɝ d͡ʒ ə t e ɪ t
relation	ɹ ɪ l e ɪ ʃ ə n
religiosity	ɹ ɪ l ɪ d͡ʒ ɪ ɑ s ə t i
remission	ɹ ə m ɪ ʃ ə n
remover	ɹ ɪ m u v ɚ
remunerative	ɹ ɪ m j u n ə ɹ ə t ɪ v
renverse	ɹ ɪ n v ɜ ɹ s
repug	ɹ ə p ə ɡ
reputation	ɹ ɛ p j ʊ t e ɪ ʃ ə n
resentment	ɹ ɪ z ɛ n t m ə n t
resident	ɹ ɛ z ɪ d ə n t
resolute	ɹ ɛ z ə l j u t
resoundingly	ɹ ɪ z a ʊ n d ɪ ŋ l i
restricted	ɹ ɪ s t ɹ ɪ k t ɪ d
reverent	ɹ ɛ v ɹ ə n t
revolt	ɹ ɪ v o ʊ l t
rhodium	ɹ o ʊ d i ə m
rich	ɹ ɪ t͡ʃ
ridotto	ɹ ə d o ʊ t o ʊ
rif	ɹ ɪ f
roasted	ɹ o ʊ s t ɪ d
roughly	ɹ ʌ f l i
rubato	r ə b ɑ t o ʊ
ruism	ɹ u ɪ z ə m
running	ɹ ʌ n ɪ ŋ
rupert	ɹ u p ɚ t
ruption	ɹ ʌ p ʃ ə n
ruritanian	ɹ ʊ ɹ ɪ t e ɪ n i ə n
sabulous	s æ b j ʊ l ə s
sacrament	s æ k ɹ ə m ə n t
sagacious	s ə ɡ e ɪ ʃ ə s
sailor	s e ɪ l ɚ
sakhalin	s æ k ə l i n
sallies	s æ l i z
salmon	s æ m ə n
salmonella	s æ l m ə n ɛ l ə
salsify	s æ l s ɪ f i
sambadrome	s æ m b ə d ɹ o ʊ m
sancerre	s ɔ̃ n s ɛ ɹ
sandy	s æ n d i
sappho	s æ f o ʊ
sardinia	s ɑ ɹ d ɪ n i ə
sardonyx	s ɑ ɹ d ɔ n ɪ k s
satcoms	s a t k ɑ m z
sault	s u
saunter	s ɔ n t ɚ
savings	s e ɪ v ɪ ŋ z
savoy	s ə v ɔ ɪ
scab	s k æ b
scale	s k e ɪ l
scanty	s k æ n t i
schlepps	ʃ l ɛ p s
schmooze	ʃ m u z
scholarship	s k ɑ l ə ɹ ʃ ɪ p
scramble	s k ɹ æ m b l̩
scriptings	s k ɹ ɪ p t ɪ ŋ s
scrofula	s k ɹ ɔ f j ə l ə
scrotum	s k ɹ o ʊ t ə m
scrubber	s k ɹ ʌ b ɚ
seal	s i l
sedge	s ɛ d͡ʒ
seed	s i d
seemer	s i m ə ɹ
seemly	s i m l i
seems	s i m z
selfish	s ɛ l f ɪ ʃ
semipermeable	s ɛ m i p ɜ ɹ m i ə b ə l
sensitive	s ɛ n s ɪ t ɪ v
sentence	s ɛ n t ə n s
sephirah	s ə f ɪ ɹ ə
sept	s ɛ p t
septendecillion	s ɛ p t ə n d ə s ɪ l i ə n
sequela	s ɪ k w i l ə
serf	s ɝ f
setiform	s i t ə f ɔ ɹ m
sextant	s ɛ k s t ə n t
shamed	ʃ e ɪ m d
shameful	ʃ e ɪ m f ə l
shamefully	ʃ e ɪ m f ə l i
shampoo	ʃ æ m p u
share	ʃ ɛ ɹ
shed	ʃ ɛ d
sheen	ʃ i n
shells	ʃ ɛ l z
shergottite	ʃ ɚ ɡ ə t a ɪ t
shits	ʃ ɪ t s
shorn	ʃ ɔ ɹ n
shout	ʃ a ʊ t
showing	ʃ o ʊ ɪ ŋ
shrubby	ʃ ɹ ʌ b i
shrugged	ʃ ɹ ʌ ɡ d
shrugging	ʃ ɹ ʌ ɡ ɪ ŋ
shtetl	ʃ t ɛ t ə l
sibred	s ɪ b ɹ ə d
sibsey	s ɪ b z i
sideways	s a ɪ d w e ɪ z
sig	s ɪ ɡ
signary	s ɪ ɡ n ə ɹ i
silenus	s a ɪ l i n ə s
singularity	s ɪ ŋ ɡ j ə l æ ɹ ə t ɪ
skamania	s k ə m e ɪ n i ə
sketchy	s k ɛ t͡ʃ i
skiddy	s k ɪ d i
skilled	s k ɪ l d
skirl	s k ɜ l
skum	s k ʌ m
skunk	s k ʌ ŋ k
skysill	s k a ɪ s ɪ l
slack	s l æ k
slashy	s l æ ʃ i
sleiveen	s l i v i n
slogan	s l o ʊ ɡ ə n
slowworm	s l o ʊ w ɜ ɹ m
sluff	s l ʌ f
slushy	s l ʌ ʃ i
smicker	s m ɪ k ə ɹ
smokehouse	s m o ʊ k h a ʊ s
smollett	s m ɑ l ə t
smorc	s m ɔ ɹ k
smudge	s m ʌ d͡ʒ
snacky	s n æ k i
snapin	s n æ p ɪ n
snelly	s n ɛ l i
snippety	s n ɪ p ɪ t i
snooze	s n u z
socking	s ɑ k ɪ ŋ
socle	s o ʊ k ə l
soiree	s w ɑ ɹ e ɪ
somalia	s ə m ɑ l i ə
somnifacient	s ɑ m n ə f e ɪ ʃ ə n t
soprano	s ə p ɹ æ n o ʊ
sorbet	s ɔ ɹ b e ɪ
spac	s p æ k
spasmodic	s p æ z m ɑ d ɪ k
spathe	s p e ɪ ð
spean	s p i n
specifier	s p ɛ s ə f a ɪ ɚ
speedboat	s p i d b o ʊ t
spell	s p ɛ l
spelunks	s p ɪ l ʌ ŋ k s
spidey	s p a ɪ d i
spilt	s p ɪ l t
spim	s p ɪ m
spinner	s p ɪ n ɚ
spiral	s p a ɪ ɹ ə l
splinter	s p l ɪ n t ɚ
splunk	s p l ʌ ŋ k
splutter	s p l ʌ t ɚ
sporty	s p ɔ ɹ t i
sprayed	s p ɹ e ɪ d
sql	ɛ s k j u ɛ l
squarely	s k w ɛ ɹ l i
squishiness	s k w ɪ ʃ i n ə s
stan	s t æ n
stared	s t ɛ ɹ d
stationed	s t ɛ ɪ ʃ ə n d
stave	s t e ɪ v
steal	s t i l
stenoses	s t ɛ n o ʊ s i z
stephanie	s t ɛ f ə n i
stepson	s t ɛ p s ʌ n
sterns	s t ɜ ɹ n z
stethoscope	s t ɛ θ ə s k o ʊ p
stheno	s θ ɛ n o ʊ
stiff	s t ɪ f
stiletto	s t ə l ɛ t o ʊ
stinnett	s t ɪ n ɛ t
stithy	s t ɪ ð i
stooge	s t u d͡ʒ
store	s t ɔ ɹ
stork	s t ɔ ɹ k
strain	s t ɹ e ɪ̯ n
strained	s t ɹ e ɪ̯ n d
strake	s t ɹ e ɪ k
strigate	s t ɹ ɪ ɡ ə t
strived	s t ɹ a ɪ v d
stroud	s t ɹ a ʊ d
stroy	s t ɹ ɔ ɪ
strumpet	s t ɹ ʌ m p ɪ t
stun	s t ʌ n
stutter	s t ʌ ɾ ɚ
stylize	s t a ɪ l a ɪ z
subdivide	s ʌ b d ɪ v a ɪ d
succedaneum	s ʌ k s ɪ d e ɪ n ɪ ə m
succeeding	s ə k s i d ɪ ŋ
successive	s ə k s ɛ s ɪ v
sucky	s ʌ k i
suds	s ʌ d z
sufentanil	s u f ɛ n t ə n ɪ l
suffer	s ʌ f ɚ
suifenhe	s w e ɪ f ʌ n h ʌ
sulfamethoxazole	s ʌ l f ə m ɛ θ ɑ k s ə z o ʊ l
summon	s ʌ m ə n
summons	s ʌ m ə n z
sunfish	s ʌ n f ɪ ʃ
sunspot	s ʌ n s p ɑ t
superannuate	s u p ə ɹ æ n j u e ɪ t
superflux	s u p ə ɹ f l ʌ k s
superhero	s j u p ə ɹ h ɪ ɹ o ʊ
supes	s u p s
suprasternal	s u p ɹ ə s t ɜ n ə l
surround	s ə ɹ a ʊ n d
swam	s w æ m
sweats	s w ɛ t s
swell	s w ɛ l
switches	s w ɪ t͡ʃ ɪ z
synechia	s ɪ n ɛ k i ə
synomone	s ɪ n ə m o ʊ n
systematize	s ɪ s t ə m ə t a ɪ z
systems	s ɪ s t ə m z
tablet	t æ b l ə t
tabloid	t æ b l ɔ ɪ d
taco	t ɑ k o ʊ
tad	t æ d
tainted	t e ɪ n t ɪ d
takes	t e ɪ k s
talarozole	t ə l æ ɹ ə z o ʊ l
talents	t æ l ə n t s
tammy	t æ m i
tamp	t æ m p
tankard	t æ ŋ k ɚ d
tape	t e ɪ̯ p
tariff	t ɛ ɹ ɪ f
tarnation	t ɑ ɹ n e ɪ ʃ ə n
tases	t e ɪ z ɪ z
tass	t æ s
tasted	t e ɪ s t ɪ d
teetotaling	t i t o ʊ t ə l ɪ ŋ
teh	t ɛ
telekong	t ə l ə k o ŋ
telekung	t ə l ə k u ŋ
teleophyte	t ɛ l i o ʊ f a ɪ t
telepathetic	t ɛ l ə p ə t h ɛ t ɪ k
telepathetically	t ɛ l ə p ə θ ɛ t ɪ k l i
telmisartan	t ɛ l m ɪ s ɑ ɹ t ə n
tenecteplase	t ə n ɛ k t ə p l e ɪ s
tenent	t ɛ n ɛ n t
tennessine	t ɛ n ə s i n
tense	t ɛ n s
tenure	t ɛ n j ɚ
termagant	t ɚ m ə ɡ ə n t
terminate	t ɝ m ɪ n e ɪ t
tetraoxanes	t ɛ t ɹ ə ɔ k s e ɪ n z
thad	θ æ d
thalia	θ ə l a ɪ ə
tham	t ʌ m
thankful	θ æ ŋ k f ə l
thatcherite	θ æ t͡ʃ ə ɹ a ɪ t
theocentric	θ i o ʊ s ɛ n t ɹ ɪ k
thereto	ð ɛ ɚ t u
theseus	θ i s i ə s
thiol	θ a ɪ ɔ l
thought	θ ɔ t
thrace	θ ɹ e ɪ s
threatened	θ ɹ ɛ t n̩ d
threatening	θ ɹ ɛ t n̩ ɪ ŋ
thrombospondin	θ ɹ ɑ m b o ʊ s p ɑ n d ɪ n
thrusts	θ ɹ ʌ s t s
tie	t a ɪ
tigris	t a ɪ ɡ ɹ ɪ s
timaru	t ɪ m ə ɹ u
timber	t ɪ m b ɚ
timbrel	t ɪ m b ɹ ə l
timorous	t ɪ m ə ɹ ə s
tint	t ɪ n t
titan	t a ɪ t ə n
titer	t a ɪ t ɚ
tolvaptan	t ɑ l v æ p t ə n
tonicity	t ə n ɪ s ɪ t i
tooter	t u t ə r
toothpick	t u θ p ɪ k
toothy	t u θ i
topeka	t ə p i k ə
topology	t ə p ɑ l ə d͡ʒ i
toque	t o ʊ k
torah	t ɔ ɹ ɑ
tornado	t ɔ ɹ n e ɪ d o ʊ
tother	t ʌ ð ə ɹ
touchdown	t ʌ t͡ʃ d a ʊ n
traitor	t ɹ e ɪ t ɚ
transcendence	t ɹ æ n t s ɛ n d ə n s
transcendental	t ɹ æ n s ɛ n d ɛ n t ə l
transwell	t ɹ æ n z w ɛ l
tray	t ɹ e ɪ
tregear	t ɹ ə ɡ ɪ ə ɹ
tren	t ɹ ɛ n
trendy	t ɹ ɛ n d i
trepidation	t ɹ ɛ p ɪ d e ɪ ʃ ə n
triamterene	t ɹ a ɪ æ m t ə ɹ i n
triathlon	t ɹ a ɪ æ θ l ɔ n
trifecta	t ɹ a ɪ f ɛ k t ə
trig	t ɹ ɪ ɡ
trillion	t ɹ ɪ l j ə n
trinketry	t ɹ ɪ ŋ k ɪ t ɹ i
triptote	t ɹ ɪ p t o ʊ t
tritone	t͡ʃ ɹ a ɪ t o ʊ n
trowel	t ɹ a ʊ ə l
tsipouro	t s ɪ p ʊ ɹ o ʊ
tuatapere	t u ɑ t a p ə ɹ i
tugboat	t ʌ ɡ b o ʊ t
tumbrel	t ʌ m b ɹ ə l
tunes	t j ʉː n s
tunis	t u n ə s
turbid	t ɜ ɹ b ɪ d
turkman	t ɜ ɹ k m ə n
tweeter	t w i t ɚ
twite	t w a ɪ t
typing	t a ɪ p ɪ ŋ
tyres	t a ɪ ə ɹ z
uefa	j u e ɪ f ə
ultramarine	ʌ l t ɹ ə m ə ɹ i n
umgang	ʌ m ɡ a ŋ
unbeknownst	ʌ n b ɪ n o ʊ n s t
uncaged	ʌ n k e ɪ d͡ʒ d
underarm	ʌ n d ɚ ɑ ɹ m
unenabled	ʌ n ə n e ɪ b ə l d
unesco	j u n ɛ s k o ʊ
unexpectedly	ʌ n ɪ k s p ɛ k t ɪ d l i
unfriendly	ʌ n f ɹ ɛ n d l i
unredressable	ʌ n ɹ ɪ d ɹ ɛ s ə b ə l
unvitiated	ʌ n v ɪ ʃ i e ɪ t ɪ d
uphold	ʌ p h o l d
uptalking	ə p t ɔ k ɪ ŋ
urethra	j ʊ ɹ i θ ɹ ə
uterus	j u t ə ɹ ə s
uxoricide	ʌ k s ɔ ɹ ɪ s a ɪ d
valiant	v æ l j ə n t
valleys	v æ l i z
vancomycin	v æ ŋ k ə m a ɪ s ɪ n
vanish	v æ n ɪ ʃ
vaticination	v ə t ɪ s ɪ n e ɪ ʃ ə n
vega	v e ɪ ɡ ə
vegeburger	v ɛ d͡ʒ i b ɜ ɹ ɡ ə ɹ
vegetal	v ɛ d͡ʒ ɪ̈ t l̩
venda	v ɛ n d ə
venomous	v ɛ n ə m ə s
verdure	v ɜ d͡ʒ ɚ
veridical	v ə ɹ ɪ d ɪ k ə l
vetter	v ɛ t ɚ
vicegerency	v a ɪ s d͡ʒ ɪ ə ɹ ə n t s i
victories	v ɪ k t ə ɹ i z
vig	v ɪ ɡ
vigil	v ɪ d͡ʒ ə l
vigneron	v i n j ə ɹ ɔ̃
violoncello	v a ɪ ə l ə n t͡ʃ ɛ l o ʊ
virtuous	v ɝ t͡ʃ u ə s
vivid	v ɪ v ɪ d
vivifying	v ɪ v ɪ f ʌ ɪ ŋ
volley	v ɔ l i
voltaic	v ɔ l t e ɪ ɪ k
vorozole	v ɔ ɹ ə z o ʊ l
wabash	w ɑ b æ ʃ
wack	w æ k
wallaby	w ɑ l ə b i
wasp	w ɑ s p
watercress	w ɔ t ə ɹ k ɹ ɛ s
waving	w e ɪ v ɪ ŋ
waxy	w æ k s i
weaken	w i k ə n
weaponize	w ɛ p ə n a ɪ z
welly	w ɛ l i
welwyn	w ɛ l ɪ n
wharfage	w ɔ ɹ f ɪ d͡ʒ
whiffle	w ɪ f l̩
whooshy	w u ʃ i
whyja	w a ɪ d͡ʒ ə
wicky	w ɪ k i
wilton	w ɪ l t ə n
windage	w ɪ n d ɪ d͡ʒ
winner	w ɪ n ɚ
wiper	w a ɪ p ɚ
withers	w ɪ ð ɚ z
woken	w o ʊ k ə n
woman	w ʊ m ə n
wonder	w ʌ n d ɚ
working	w ɝ k ɪ ŋ
woundable	w u n d ə b ə l
wrath	ɹ æ θ
wrexham	ɹ ɛ k s ə m
wronged	ɹ ɔ ŋ d
wushu	w u ʃ u
wuss	w ʊ s
wuvz	w ʌ v z
xining	ʃ i n ɪ ŋ
yank	j æ ŋ k
yare	j ɛ ɹ
yeovil	j o ʊ v ɪ l
yerevanian	j e ɹ ə v ɑ n i ə n
yeung	j ʌ ŋ
yoicks	j ɔ ɪ k s
yonic	j o ʊ n ɪ k
zed	z ɛ d
zelensky	z ɪ l ɛ n s k i
zerk	z ɝ k
zetetic	z ə t ɛ t ɪ k
zillionths	z ɪ l j ə n θ s
zine	z i n
zinefan	z i n f æ n
zipper	z ɪ p ɚ
ziti	z i t i
zoologist	z o ʊ ɑ l ə d͡ʒ ɪ s t
zowie	z a ʊ ɪ
zythology	z a ɪ θ ɔ l ə d͡ʒ i
