<|GER|>ab	a p
<|GER|>abfertigung	a p f ɛ ʁ t i ɡ ʊ ŋ
<|GER|>abfinden	a p f ɪ n d ə n
<|GER|>abflug	ʔ a p f l uː k
<|GER|>abgang	a p ɡ a ŋ
<|GER|>abkürzung	a p k ʏ ʁ t s ʊ ŋ
<|GER|>abschirmen	a p ʃ ɪ ʁ m ə n
<|GER|>abstand	a p ʃ t a n t
<|GER|>abstrich	a p ʃ t ʁ ɪ ç
<|GER|>abwehrspieler	a p v ɛ ɐ̯ ʃ p iː l ɐ
<|GER|>abzug	a p t͡s uː k
<|GER|>all	a l
<|GER|>allein	a l a ɪ n
<|GER|>allem	a l ə m
<|GER|>allerdings	ʔ a l ɐ d ɪ ŋ s
<|GER|>alte	a l t ə
<|GER|>amt	a m t
<|GER|>an	ʔ a n
<|GER|>anblick	ʔ a n b l ɪ k
<|GER|>andere	ʔ a n d ə ʁ ə
<|GER|>anderer	a n d ə r ə r
<|GER|>anfang	ʔ a n f a ŋ
<|GER|>angesichts	ʔ a n ɡ ə z ɪ ç t s
<|GER|>angespannt	a n ɡ ə ʃ p a n t
<|GER|>angewiesen	a n ɡ ə v iː z n̩
<|GER|>angriff	a n ɡ ʁ ɪ f
<|GER|>ankündigung	a n k ʏ n d ɪ ɡ ʊ ŋ
<|GER|>ansatz	a n z a t s
<|GER|>anschauen	ʔ a n ʃ a ʊ̯ ə n
<|GER|>ansicht	ʔ a n z ɪ ç t
<|GER|>antje	ʔ a n t j ə
<|GER|>antworten	a n t v ɔ ʁ t ə n
<|GER|>anwohner	a n v oː n ɐ
<|GER|>anzahl	a n t s aː l
<|GER|>arbeitsplatz	ʔ a ʁ b a ɪ̯ t s p l a t s
<|GER|>architektur	a ʁ ç i t ɛ k t uː ɐ̯
<|GER|>aschenbrödel	a ʃ n̩ b ʁ øː d l̩
<|GER|>atem	aː t ə m
<|GER|>attacke	a t a k ə
<|GER|>attila	a t i l a
<|GER|>auf	a ʊ̯ f
<|GER|>aufkleber	a ʊ̯ f k l eː b ɐ
<|GER|>aufrechterhalten	a ʊ̯ f ʁ ɛ ç t ʔ ɛ ɐ̯ h a l t n̩
<|GER|>aufruf	a ʊ̯ f ʁ uː f
<|GER|>aufs	a ʊ̯ f s
<|GER|>aufschlag	a ʊ̯ f ʃ l aː k
<|GER|>aus	a ʊ s
<|GER|>ausfallen	a ʊ̯ s f a l ə n
<|GER|>ausführung	ʔ a ʊ̯ s f yː ʁ ʊ ŋ
<|GER|>ausgeben	a ʊ̯ s ɡ eː b ə n
<|GER|>ausgebildet	a ʊ̯ s ɡ ə b ɪ l d ə t
<|GER|>ausgehen	ʔ a ʊ̯ s ɡ eː ə n
<|GER|>ausgeschlossen	a ʊ̯ s ɡ ə ʃ l ɔ s ə n
<|GER|>ausmass	a ʊ̯ s m aː s
<|GER|>ausnahme	a ʊ̯ s n aː m ə
<|GER|>aussage	a ʊ̯ s z aː ɡ ə
<|GER|>ausser	a ʊ̯ s ɐ
<|GER|>ausserhalb	a ʊ̯ s ɐ h a l p
<|GER|>ausstellung	a ʊ̯ s ʃ t ɛ l ʊ ŋ
<|GER|>bahn	b aː n
<|GER|>bayern	b a ɪ̯ ɐ n
<|GER|>beckmann	b ɛ k m a n
<|GER|>bedarf	b ə d a ʁ f
<|GER|>befürworten	b ə f yː ɐ̯ v ɔ ʁ t n̩
<|GER|>befürworter	b ə f yː ɐ̯ v ɔ ʁ t ɐ
<|GER|>begeistert	b ə ɡ a ɪ̯ s t ɐ t
<|GER|>behandlung	b ə h a n d l ʊ ŋ
<|GER|>behinderung	b ə h ɪ n d ə ʁ ʊ ŋ
<|GER|>beifahrer	b a ɪ̯ f aː ʁ ɐ
<|GER|>bein	b a ɪ̯ n
<|GER|>beispielsweise	b a ɪ̯ ʃ p iː l s v a ɪ̯ z ə
<|GER|>bekannt	b ə k a n t
<|GER|>bekenntnis	b ə k ɛ n t n ɪ s
<|GER|>bekommen	b ə k ɔ m ə n
<|GER|>bekämpft	b ə k ɛ m f t
<|GER|>berauben	b ə ʁ a ʊ̯ b n̩
<|GER|>bereich	b ə ʁ a ɪ̯ ç
<|GER|>bereit	b ə ʁ a ɪ̯ t
<|GER|>bergland	b ɛ ʁ k l a n t
<|GER|>beschluss	b ə ʃ l ʊ s
<|GER|>beschlussfähig	b ə ʃ l ʊ s f ɛː ɪ ç
<|GER|>beschweren	b ə ʃ v eː ʁ ə n
<|GER|>besprechen	b ə ʃ p ʁ ɛ ç ə n
<|GER|>besser	b ɛ s ɐ
<|GER|>bestellung	b ə ʃ t ɛ l ʊ ŋ
<|GER|>besuch	b ə z uː χ
<|GER|>besucher	b ə z uː x ɐ
<|GER|>bettina	b ɛ t iː n a
<|GER|>bevölkerung	b ə f œ l k ə ʁ ʊ ŋ
<|GER|>bewahren	b ə v aː ʁ ə n
<|GER|>bewohner	b ə v oː n ɐ
<|GER|>bewährungsstrafe	b ə v ɛː ʁ ʊ ŋ s ʃ t ʁ aː f ə
<|GER|>beziehung	b ə t s iː ʊ ŋ
<|GER|>bezirk	b ə t͡s ɪ ʁ k
<|GER|>bezwingen	b ə t͡s v ɪ ŋ ə n
<|GER|>bieten	b iː t ə n
<|GER|>bilden	b ɪ l d ə n
<|GER|>bildung	b ɪ l d ʊ ŋ
<|GER|>bin	b ɪ n
<|GER|>bisher	b ɪ s h eː ɐ̯
<|GER|>bislang	b ɪ s l a ŋ
<|GER|>bitte	b ɪ t ə
<|GER|>bleiben	b l a ɪ̯ b ə n
<|GER|>breit	b ʁ a ɪ̯ t
<|GER|>breite	b ʁ a ɪ̯ t ə
<|GER|>bremsen	b ʁ ɛ m z ə n
<|GER|>brot	b ʁ oː t
<|GER|>brutaler	b ʁ u t aː l ɐ
<|GER|>bund	b ʊ n t
<|GER|>bundestag	b ʊ n d ə s t aː k
<|GER|>bundeswehr	b ʊ n d ə s v eː ɐ̯
<|GER|>bäume	b ɔ ʏ m ə
<|GER|>böse	b øː z ə
<|GER|>bürgermeister	b ʏ ʁ ɡ ɐ m a ɪ̯ s t ɐ
<|GER|>dafür	d a f yː ʁ
<|GER|>dagegen	d a ɡ eː ɡ ŋ̩
<|GER|>danach	d a n aː χ
<|GER|>dann	d a n
<|GER|>daran	d a ʁ a n
<|GER|>dass	d a s
<|GER|>decke	d ɛ k ə
<|GER|>deiner	d a ɪ̯ n ɐ
<|GER|>demnach	d eː m n aː x
<|GER|>denen	d eː n ə n
<|GER|>denkfehler	d ɛ ŋ k f eː l ɐ
<|GER|>denn	d ɛ n
<|GER|>derzeit	d eː ɐ̯ t͡s a ɪ̯ t
<|GER|>deshalb	d ɛ s h a l p
<|GER|>dessen	d ɛ s ə n
<|GER|>deutscher	d ɔ ɪ̯ t͡ʃ ɐ
<|GER|>dezember	d e t s ɛ m b ɐ
<|GER|>dinge	d ɪ ŋ ə
<|GER|>diskutieren	d ɪ s k u t iː ʁ ə n
<|GER|>diversität	d i v ɛ ʁ z i t ɛː t
<|GER|>draussen	d r a ʊ̯ s ə n
<|GER|>drei	d ʁ a ɪ̯
<|GER|>dritte	d r ɪ t ə
<|GER|>drosselung	d ʁ ɔ s ə l ʊ ŋ
<|GER|>druck	d ʁ ʊ k
<|GER|>drücken	d ʁ ʏ k ə n
<|GER|>durchschnittlich	d ʊ ɐ̯ ç ʃ n ɪ t l ɪ ç
<|GER|>durchsuchung	d ʊ ʁ ç z uː χ ʊ ŋ
<|GER|>dürfen	d ʏ r f ə n
<|GER|>ebenso	eː b ə n z oː
<|GER|>ecke	ɛ k ə
<|GER|>eckert	ɛ k ɐ t
<|GER|>eher	eː ə ʁ
<|GER|>einbruch	a ɪ̯ n b ʁ ʊ x
<|GER|>eine	ʔ a ɪ̯ n ə
<|GER|>einem	a ɪ̯ n ə m
<|GER|>einfach	ʔ a ɪ̯ n f a x
<|GER|>einfallen	a ɪ̯ n f a l ə n
<|GER|>einheiten	a ɪ̯ n h a ɪ̯ t ə n
<|GER|>einher	a ɪ̯ n h eː ɐ̯
<|GER|>einkaufen	a ɪ̯ n k a ʊ̯ f ə n
<|GER|>einlagern	ʔ a ɪ n l aː ɡ ɐ n
<|GER|>einlassung	a ɪ̯ n l a s ʊ ŋ
<|GER|>einleitung	a ɪ̯ n l a ɪ̯ t ʊ ŋ
<|GER|>einmal	a ɪ̯ n m aː l
<|GER|>einnehmend	a ɪ̯ n n eː m ə n t
<|GER|>einrichtung	ʔ a ɪ̯ n ʁ ɪ ç t ʊ ŋ
<|GER|>einsatz	ʔ a ɪ̯ n z a t s
<|GER|>einsteiger	a ɪ n ʃ t ɐ ɪ ɡ ɐ
<|GER|>einstellung	a ɪ̯ n ʃ t ɛ l ʊ ŋ
<|GER|>einwohner	a ɪ̯ n v oː n ɐ
<|GER|>empfehlen	ʔ ɛ m p f eː l ə n
<|GER|>empfehlung	ɛ m p f eː l ʊ ŋ
<|GER|>empört	ɛ m p øː ɐ̯ t
<|GER|>endlich	ɛ n t l ɪ ç
<|GER|>entscheidung	ʔ ɛ n t ʃ a ɪ̯ d ʊ ŋ
<|GER|>enttäuschend	ɛ n t t ɔ ɪ̯ ʃ n̩ t
<|GER|>erdnuss	eː ɐ̯ t n ʊ s
<|GER|>erdreich	eː ɐ̯ t ʁ a ɪ̯ ç
<|GER|>erforderlich	ɛ ɐ̯ f ɔ ʁ d ɐ l ɪ ç
<|GER|>ergebnisse	ɛ ɐ̯ ɡ eː p n ɪ s ə
<|GER|>erkrankung	ɛ r k r a ŋ k ʊ ŋ
<|GER|>erleichtern	ʔ ɛ ɐ̯ l a ɪ̯ ç t ɐ n
<|GER|>erleichterung	ɛ ɐ̯ l a ɪ̯ ç t ə ʁ ʊ ŋ
<|GER|>ermittler	ɛ ɐ̯ m ɪ t l ɐ
<|GER|>erneut	ɛ ʁ n ɔ ɪ̯ t
<|GER|>ernüchternd	ɛ ɐ̯ n ʏ ç t ɐ n t
<|GER|>erreichen	ɛ ɐ̯ ʁ a ɪ̯ ç ə n
<|GER|>erst	eː r s t
<|GER|>erste	eː r s t ə
<|GER|>erster	eː ɐ̯ s t ɐ
<|GER|>erwachsene	ɛ ɐ̯ v a k s ə n ə
<|GER|>erweitern	ʔ ɛ ɐ̯ v a ɪ̯ t ɐ n
<|GER|>essen	ɛ s ə n
<|GER|>etwa	ɛ t v a
<|GER|>etwas	ɛ t v a s
<|GER|>eventuell	e v ɛ n t u̯ ɛ l
<|GER|>existieren	ɛ k s ɪ s t iː ʁ ə n
<|GER|>fahndung	f aː n d ʊ ŋ
<|GER|>fand	f a n t
<|GER|>farbe	f a r b ə
<|GER|>farbenfroh	f a ʁ b n̩ f ʁ oː
<|GER|>fass	f a s
<|GER|>faustschlag	f a ʊ̯ s t ʃ l aː k
<|GER|>februar	f eː b r u aː r
<|GER|>fehler	f eː l ɐ
<|GER|>feld	f ɛ l t
<|GER|>fell	f ɛ l
<|GER|>fenster	f ɛ n s t ɐ
<|GER|>festlegen	f ɛ s t l eː ɡ ə n
<|GER|>feststellen	f ɛ s t ʃ t ɛ l ə n
<|GER|>feuer	f ɔ ʏ̯ ə r
<|GER|>findet	f ɪ n d ə t
<|GER|>flagge	f l a ɡ ə
<|GER|>fleisch	f l a ɪ̯ ʃ
<|GER|>flick	f l ɪ k
<|GER|>fläche	f l ɛ ç ə
<|GER|>fokus	f oː k ʊ s
<|GER|>folge	f ɔ l ɡ ə
<|GER|>form	f ɔ ʁ m
<|GER|>formulieren	f ɔ ʁ m u l iː ʁ ə n
<|GER|>fracht	f r a x t
<|GER|>fragen	f ʁ aː ɡ ə n
<|GER|>fraglich	f ʁ aː k l ɪ ç
<|GER|>frauen	f ʁ a ʊ ə n
<|GER|>freiburg	f ʁ a ɪ̯ b ʊ ʁ k
<|GER|>freien	f ʁ a ɪ̯ ə n
<|GER|>freude	f ʁ ɔ ʏ̯ d ə
<|GER|>freundin	f ʁ ɔ ʏ̯ n d ɪ n
<|GER|>frisch	f ʁ ɪ ʃ
<|GER|>front	f ʁ ɔ n t
<|GER|>frühjahrsputz	f ʁ yː j aː ɐ̯ s p ʊ t s
<|GER|>frühzeitig	f ʁ yː t͡s a ɪ̯ t ɪ ç
<|GER|>fährt	f ɛː r t
<|GER|>fälle	f ɛ l ə
<|GER|>fällen	f ɛ l ə n
<|GER|>fällt	f ɛ l t
<|GER|>fühlen	f yː l ə n
<|GER|>führung	f yː ʁ ʊ ŋ
<|GER|>füssen	f ʏ s n̩
<|GER|>gab	ɡ aː p
<|GER|>ganz	ɡ a n t s
<|GER|>ganze	ɡ a n t s ə
<|GER|>gebe	ɡ eː b ə
<|GER|>gedanken	ɡ ə d a ŋ k ə n
<|GER|>gefecht	ɡ ə f ɛ ç t
<|GER|>gefährlich	ɡ ə f ɛː ɐ̯ l ɪ ç
<|GER|>gefällt	ɡ ə f ɛ l t
<|GER|>gefühle	ɡ ə f yː l ə
<|GER|>gegen	ɡ e ɡ ə n
<|GER|>gegenteil	ɡ eː ɡ n̩ t a ɪ̯ l
<|GER|>geht	ɡ eː t
<|GER|>geht's	ɡ eː t s
<|GER|>gehört	ɡ ə h øː ɐ̯ t
<|GER|>geldanlage	ɡ ɛ l t ʔ a n l aː ɡ ə
<|GER|>gelesen	ɡ ə l eː z ə n
<|GER|>geliebt	ɡ ə l iː p t
<|GER|>gemacht	ɡ ə m a x t
<|GER|>gemeinde	ɡ ə m a ɪ̯ n d ə
<|GER|>gemusst	ɡ ə m ʊ s t
<|GER|>genauso	ɡ ə n a ʊ̯ z oː
<|GER|>genügen	ɡ ə n yː ɡ n̩
<|GER|>gerechtigkeit	ɡ ə ʁ ɛ ç t ɪ ç k a ɪ̯ t
<|GER|>gericht	ɡ ə ʁ ɪ ç t
<|GER|>gerne	ɡ ɛ r n ə
<|GER|>gesang	ɡ ə z a ŋ
<|GER|>gescheitert	ɡ ə ʃ a ɪ̯ t ɐ t
<|GER|>geschichte	ɡ ə ʃ ɪ ç t ə
<|GER|>geschäft	ɡ ə ʃ ɛ f t
<|GER|>geschätzt	ɡ ə ʃ ɛ t͡s t
<|GER|>gesellschaft	ɡ ə z ɛ l ʃ a f t
<|GER|>gesetzgeber	ɡ ə z ɛ t s ɡ eː b ɐ
<|GER|>gesetzlich	ɡ ə z ɛ t͡s l ɪ ç
<|GER|>gespenst	ɡ ə ʃ p ɛ n s t
<|GER|>gesprochen	ɡ ə ʃ p ʁ ɔ x n̩
<|GER|>gespräch	ɡ ə ʃ p ʁ ɛː ç
<|GER|>gestaltung	ɡ ə ʃ t a l t ʊ ŋ
<|GER|>gestellt	ɡ ə ʃ t ɛ l t
<|GER|>gestorben	ɡ ə ʃ t ɔ ʁ b ə n
<|GER|>gesundheit	ɡ ə z ʊ n t h a ɪ̯ t
<|GER|>getan	ɡ ə t aː n
<|GER|>getöse	ɡ ə t øː z ə
<|GER|>gewesen	ɡ ə v eː z ə n
<|GER|>gewinnen	ɡ ə v ɪ n ə n
<|GER|>gewiss	ɡ ə v ɪ s
<|GER|>gewährleisten	ɡ ə v ɛː ʁ l a ɪ̯ s t ə n
<|GER|>giessen	ɡ iː s ə n
<|GER|>gilt	ɡ ɪ l t
<|GER|>ging	ɡ ɪ ŋ
<|GER|>gitarrist	ɡ i t a ʁ ɪ s t
<|GER|>glasfaser	ɡ l aː s f aː z ɐ
<|GER|>gleich	ɡ l a ɪ̯ ç
<|GER|>gleichen	ɡ l a ɪ̯ ç ə n
<|GER|>gliederung	ɡ l iː d ə ʁ ʊ ŋ
<|GER|>grad	ɡ ʁ aː t
<|GER|>grossbritannien	ɡ ʁ oː s b ʁ ɪ t a n j ə n
<|GER|>grossen	ɡ ʁ oː s n̩
<|GER|>grosses	ɡ ʁ oː s ə s
<|GER|>grundstück	ɡ ʁ ʊ n t ʃ t ʏ k
<|GER|>grösser	ɡ ʁ øː s ɐ
<|GER|>grösstenteils	ɡ ʁ øː s t ə n t a ɪ̯ l s
<|GER|>gärtner	ɡ ɛ ʁ t n ɐ
<|GER|>günther	ɡ ʏ n t ɐ
<|GER|>habe	h aː b ə
<|GER|>halt	h a l t
<|GER|>haltbar	h a l t b aː ʁ
<|GER|>hanau	h aː n a ʊ̯
<|GER|>handy	h ɛ n d i
<|GER|>hatte	h a t ə
<|GER|>hauptstadt	h a ʊ̯ p t ʃ t a t
<|GER|>haushund	h a ʊ̯ s h ʊ n t
<|GER|>hektar	h ɛ k t aː ɐ̯
<|GER|>helfen	h ɛ l f n̩
<|GER|>herbst	h ɛ ʁ p s t
<|GER|>herrgottswinkel	h ɛ ʁ ɡ ɔ t͡s v ɪ ŋ k l̩
<|GER|>herrschaft	h ɛ ʁ ʃ a f t
<|GER|>hersteller	h eː ɐ̯ ʃ t ɛ l ɐ
<|GER|>herzen	h ɛ ʁ t s n̩
<|GER|>heuer	h ɔ ʏ̯ ɐ
<|GER|>hilfreich	h ɪ l f ʁ a ɪ̯ ç
<|GER|>hinten	h ɪ n t ə n
<|GER|>hinter	h ɪ n t ɐ
<|GER|>hinterlassen	h ɪ n t ɐ l a s n̩
<|GER|>hoffentlich	h ɔ f n̩ t l ɪ ç
<|GER|>hoffnung	h ɔ f n ʊ ŋ
<|GER|>husten	h uː s t ə n
<|GER|>hätte	h ɛ t ə
<|GER|>höhe	h øː ə
<|GER|>hörsaal	h øː ɐ̯ z aː l
<|GER|>ich	ɪ ç
<|GER|>ideen	i d eː ə n
<|GER|>ihrem	ʔ iː ʁ ə m
<|GER|>illegal	ɪ l e ɡ aː l
<|GER|>im	ɪ m
<|GER|>immer	ɪ m ɐ
<|GER|>impfung	ɪ m p͡f ʊ ŋ
<|GER|>indem	ɪ n d eː m
<|GER|>inne	ɪ n ə
<|GER|>innerhalb	ɪ n ɐ h a l p
<|GER|>insbesondere	ɪ n s b ə z ɔ n d ə ʁ ə
<|GER|>insgesamt	ɪ n s ɡ ə z a m t
<|GER|>intensiv	ɪ n t ɛ n z iː f
<|GER|>interessiert	ɪ n t ə ʁ s iː ɐ̯ t
<|GER|>investieren	ɪ n v ɛ s t iː ʁ ə n
<|GER|>inzidenz	ɪ n t͡s i d ɛ n t͡s
<|GER|>inzwischen	ɪ n t͡s v ɪ ʃ n̩
<|GER|>jahr	j aː r
<|GER|>jahre	j aː ʁ ə
<|GER|>jahrgang	j aː ɐ̯ ɡ a ŋ
<|GER|>jede	j eː d ə
<|GER|>jeden	j eː d n̩
<|GER|>jedenfalls	j eː d ə n f a l s
<|GER|>jedes	j eː d ə s
<|GER|>jedoch	j eː d ɔ x
<|GER|>jemand	j eː m a n t
<|GER|>jeweils	j eː v a ɪ̯ l s
<|GER|>jugendliche	j uː ɡ ə n t l ɪ ç ə
<|GER|>junge	j ʊ ŋ ə
<|GER|>jägers	j ɛː ɡ ɐ s
<|GER|>jährlich	j ɛː ɐ̯ l ɪ ç
<|GER|>kaiser	k a ɪ̯ z ɐ
<|GER|>kaiserslautern	k a ɪ z ɐ s l a ʊ t ɐ n
<|GER|>kampagne	k a m p a n j ə
<|GER|>kann	k a n
<|GER|>kanzlerin	k a n t s l ə ʁ ɪ n
<|GER|>kaum	k a ʊ̯ m
<|GER|>kehren	k eː ʁ ə n
<|GER|>kein	k a ɪ̯ n
<|GER|>keine	k a ɪ̯ n ə
<|GER|>kennzeichen	k ɛ n t s a ɪ ç ə n
<|GER|>kinder	k ɪ n d ɐ
<|GER|>kippen	k ɪ p ə n
<|GER|>klimakrise	k l iː m a k ʁ iː z ə
<|GER|>konnte	k ɔ n t ə
<|GER|>konsole	k ɔ n z oː l ə
<|GER|>konstant	k ɔ n s t a n t
<|GER|>konstantinopel	k ɔ n s t a n t i n oː p l̩
<|GER|>korrigieren	k ɔ ʁ i ɡ iː ʁ ə n
<|GER|>kraft	k ʁ a f t
<|GER|>kreisssaal	k ʁ a ɪ̯ s z aː l
<|GER|>kreisverkehr	k ʁ a ɪ̯ s f ɛ ɐ̯ k eː ɐ̯
<|GER|>krise	k ʁ iː z ə
<|GER|>kunden	k ʊ n d ə n
<|GER|>kurz	k ʊ ʁ t͡s
<|GER|>kurzarbeit	k ʊ ʁ t͡s ʔ a ʁ b a ɪ̯ t
<|GER|>kämpfen	k ɛ m p f ə n
<|GER|>könne	k œ n ə
<|GER|>können	k œ n ə n
<|GER|>könnt	k œ n t
<|GER|>könnte	k œ n t ə
<|GER|>körper	k œ r p ə r
<|GER|>kürzlich	k ʏ ʁ t s l ɪ ç
<|GER|>küster	k ʏ s t ɐ
<|GER|>lage	l aː ɡ ə
<|GER|>landkreis	l a n t k ʁ a ɪ̯ s
<|GER|>langen	l a ŋ ə n
<|GER|>laut	l a ʊ̯ t
<|GER|>leben	l eː b ə n
<|GER|>lebenspartner	l eː b n̩ s p a ʁ t n ɐ
<|GER|>lebt	l eː p t
<|GER|>leicht	l a ɪ̯ ç t
<|GER|>leise	l a ɪ z ə
<|GER|>leisten	l a ɪ̯ s t n̩
<|GER|>lernen	l ɛ ɐ n ə n
<|GER|>lesen	l eː z n̩
<|GER|>letzte	l ɛ t͡s t ə
<|GER|>letztlich	l ɛ t s t l ɪ ç
<|GER|>lieber	l iː b ɐ
<|GER|>linken	l ɪ ŋ k ə n
<|GER|>literatur	l ɪ t ə ʁ a t uː ɐ̯
<|GER|>losfahren	l oː s f aː ʁ ə n
<|GER|>losgehen	l oː s ɡ eː ə n
<|GER|>luft	l ʊ f t
<|GER|>lässt	l ɛ s t
<|GER|>lösung	l øː z ʊ ŋ
<|GER|>machte	m a x t ə
<|GER|>magazin	m a ɡ a t s iː n
<|GER|>magdeburg	m a k d ə b ʊ ʁ k
<|GER|>manch	m a n ç
<|GER|>mandat	m a n d aː t
<|GER|>manko	m a ŋ k o
<|GER|>mann	m a n
<|GER|>marke	m a ʁ k ə
<|GER|>massiv	m a s iː f
<|GER|>massnahmen	m aː s n aː m ə n
<|GER|>matthias	m a t iː a s
<|GER|>mau	m a ʊ̯
<|GER|>mechanismus	m e ç a n ɪ s m ʊ s
<|GER|>meine	m a ɪ̯ n ə
<|GER|>meiner	m a ɪ̯ n ɐ
<|GER|>meistens	m a ɪ̯ s t n̩ s
<|GER|>mich	m ɪ ç
<|GER|>mikrofon	m i k ʁ o f oː n
<|GER|>mild	m ɪ l t
<|GER|>milliarde	m ɪ l j aː d ə
<|GER|>ministerpräsident	m i n ɪ s t ɐ p ʁ ɛː z i d ɛ n t
<|GER|>minute	m i n uː t ə
<|GER|>mit	m ɪ t
<|GER|>mitarbeiter	m ɪ t a r b a ɪ̯ t ə r
<|GER|>mitglieder	m ɪ t ɡ l iː d ɐ
<|GER|>mitgliedern	m ɪ t ɡ l iː d ɐ n
<|GER|>mithilfe	m ɪ t h ɪ l f ə
<|GER|>mitte	m ɪ t ə
<|GER|>mitteilen	m ɪ t t a ɪ̯ l ə n
<|GER|>mittelfeld	m ɪ t ə l f ɛ l t
<|GER|>mitternacht	m ɪ t ɐ n a χ t
<|GER|>mittwoch	m ɪ t v ɔ x
<|GER|>mobilität	m o b i l i t ɛː t
<|GER|>moderne	m o d ɛ ʁ n ə
<|GER|>monate	m oː n a t ə
<|GER|>monats	m oː n a t͡s
<|GER|>moral	m o ʁ aː l
<|GER|>musiker	m uː z i k ɐ
<|GER|>muss	m ʊ s
<|GER|>musste	m ʊ s t ə
<|GER|>männer	m ɛ n ɐ
<|GER|>möchte	m œ ç tʰ ə
<|GER|>möglich	m øː k l ɪ ç
<|GER|>möglichkeit	m øː k l ɪ ç k a ɪ̯ t
<|GER|>müller	m ʏ l ɐ
<|GER|>müsse	m ʏ s ə
<|GER|>müssen	m ʏ s ə n
<|GER|>müsste	m ʏ s t ə
<|GER|>nachrichtenagentur	n aː χ ʁ ɪ ç t ə n a ɡ ɛ n t uː ɐ
<|GER|>nacken	n a k ə n
<|GER|>nahe	n aː ə
<|GER|>nase	n aː z ə
<|GER|>nasenloch	n aː z ə n l ɔ χ
<|GER|>nazis	n aː t s iː s
<|GER|>nebst	n eː p s t
<|GER|>nennen	n ɛ n ə n
<|GER|>nennwert	n ɛ n v eː r t
<|GER|>nett	n ɛ t
<|GER|>netz	n ɛ t͡s
<|GER|>neu	n ɔ ʏ̯
<|GER|>neudeutsch	n ɔ ɪ̯ d ɔ ɪ̯ t͡ʃ
<|GER|>neun	n ɔ ʏ̯ n
<|GER|>niederlande	n iː d ɐ l a n d ə
<|GER|>niedersachsen	n iː d ɐ z a k s ə n
<|GER|>niederösterreich	n iː d ɐ ʔ øː s t ə ʁ a ɪ̯ ç
<|GER|>normalerweise	n ɔ ʁ m aː l ɐ v a ɪ̯ z ə
<|GER|>notfall	n oː t f a l
<|GER|>notstand	n oː t ʃ t a n t
<|GER|>oben	ʔ oː b ə n
<|GER|>offenbar	ɔ f n̩ b aː ɐ̯
<|GER|>offiziell	ɔ f i t s j ɛ l
<|GER|>oft	ɔ f t
<|GER|>ohne	oː n ə
<|GER|>ohnehin	oː n ə h ɪ n
<|GER|>ordnungsgemäss	ɔ ʁ d n ʊ ŋ s ɡ ə m ɛː s
<|GER|>ortschaft	ɔ ʁ t ʃ a f t
<|GER|>ostersonntag	oː s t ɐ z ɔ n t aː k
<|GER|>pappbecher	p a p b ɛ ç ɐ
<|GER|>pariser	p a ʁ iː z ɐ
<|GER|>parkplatz	p a r k p l a t͡s
<|GER|>parteipolitik	p a ʁ t a ɪ̯ p o l i t iː k
<|GER|>pfleger	p f l eː ɡ ɐ
<|GER|>phase	f aː z ə
<|GER|>pilgern	p ɪ l ɡ ɐ n
<|GER|>pkw	p eː k a v eː
<|GER|>planen	p l aː n ə n
<|GER|>podest	p o d ɛ s t
<|GER|>polarstern	p o l aː ɐ̯ ʃ t ɛ ɐ̯ n
<|GER|>polizist	p o l i t͡s ɪ s t
<|GER|>polizisten	p o l i t͡s ɪ s t ə n
<|GER|>portugiesin	p ɔ ʁ t u ɡ iː z ɪ n
<|GER|>postfach	p ɔ s t f a χ
<|GER|>premierministerin	p ʁ e m j eː m i n ɪ s t ɐ ʁ ɪ n
<|GER|>prinz	p ʁ ɪ n t͡s
<|GER|>probieren	p ʁ o b iː ʁ ə n
<|GER|>profi	p ʁ oː f i
<|GER|>profitieren	p ʁ o f i t iː ʁ ə n
<|GER|>prognose	p ʁ o ɡ n oː z ə
<|GER|>programm	p r o ɡ r a m
<|GER|>projekt	p ʁ o j ɛ k t
<|GER|>promille	p ʁ o m ɪ l ə
<|GER|>prominenter	p ʁ ɔ m i n ɛ n t ɐ
<|GER|>publikum	p uː b l iː k ʊ m
<|GER|>quer	k v eː ɐ̯
<|GER|>querdenker	k v eː ɐ̯ d ɛ ŋ k ɐ
<|GER|>rahmen	ʁ aː m ə n
<|GER|>raum	ʁ a ʊ̯ m
<|GER|>rechnen	ʁ ɛ ç n ə n
<|GER|>regierung	ʁ ə ɡ iː ʁ ʊ ŋ
<|GER|>reicher	ʁ a ɪ̯ ç ɐ
<|GER|>reichlich	ʁ a ɪ̯ ç l ɪ ç
<|GER|>reihe	ʁ a ɪ̯ ə
<|GER|>rekord	ʁ e k ɔ ʁ t
<|GER|>rendite	ʁ ɛ n d iː t ə
<|GER|>respektive	r e s p ɛ k t iː v e
<|GER|>richtung	ʁ ɪ ç t ʊ ŋ
<|GER|>richtungen	ʁ ɪ ç t ʊ ŋ
<|GER|>rote	ʁ oː t ə
<|GER|>russe	ʁ ʊ s ə
<|GER|>räume	ʁ ɔ ɪ̯ m ə
<|GER|>räumen	ʁ ɔ ɪ̯ m ə n
<|GER|>rückzug	ʁ y k t s uː k
<|GER|>saal	z aː l
<|GER|>sache	z a x ə
<|GER|>sachen	z a x n̩
<|GER|>sage	z aː ɡ ə
<|GER|>saniert	z a n iː ɐ̯ t
<|GER|>scharf	ʃ a r f
<|GER|>scheut	ʃ ɔ ʏ̯ t
<|GER|>schicksal	ʃ ɪ k z aː l
<|GER|>schieben	ʃ iː b ə n
<|GER|>schien	ʃ iː n
<|GER|>schienen	ʃ iː n ə n
<|GER|>schlagen	ʃ l aː ɡ n̩
<|GER|>schliesslich	ʃ l iː s l ɪ ç
<|GER|>schloss	ʃ l ɔ s
<|GER|>schlusspunkt	ʃ l ʊ s p ʊ ŋ k t
<|GER|>schlüsselanhänger	ʃ l ʏ s l̩ ʔ a n h ɛ n ɡ ɐ
<|GER|>schmoren	ʃ m oː ʁ ə n
<|GER|>schneefall	ʃ n eː f a l
<|GER|>schnell	ʃ n ɛ l
<|GER|>schnellen	ʃ n ɛ l n̩
<|GER|>schneller	ʃ n ɛ l ɐ
<|GER|>schule	ʃ uː l ə
<|GER|>schutz	ʃ ʊ t͡s
<|GER|>schweizer	ʃ v a ɪ̯ t͡s ɐ
<|GER|>schweren	ʃ v eː r ə n
<|GER|>schätzung	ʃ ɛ t s ʊ ŋ
<|GER|>schöne	ʃ øː n ə
<|GER|>schönste	ʃ øː n s t ə
<|GER|>schüler	ʃ yː l ɐ
<|GER|>schülern	ʃ yː l ɐ n
<|GER|>sechs	z ɛ k s
<|GER|>sehnsüchtig	z eː n z ʏ ç t ɪ ç
<|GER|>sehr	z eː r
<|GER|>seid	z a ɪ̯ t
<|GER|>seien	z a ɪ̯ ə n
<|GER|>seine	z a ɪ̯ n ə
<|GER|>seiner	z a ɪ̯ n ɐ
<|GER|>seines	z a ɪ̯ n ə s
<|GER|>seit	z a ɪ̯ t
<|GER|>seite	z a ɪ̯ t ə
<|GER|>seiten	z a ɪ̯ t ə n
<|GER|>selbstmord	z ɛ l p s t m ɔ ʁ t
<|GER|>selbstverwirklichung	z ɛ l p s t f ɛ ɐ̯ v ɪ ʁ k l ɪ ç ʊ ŋ
<|GER|>senat	z e n aː t
<|GER|>sender	z ɛ n d ɐ
<|GER|>setzen	z ɛ t s ə n
<|GER|>sich	z ɪ ç
<|GER|>sicherheit	z ɪ ç ɐ h a ɪ̯ t
<|GER|>sicherlich	z ɪ ç ɐ l ɪ ç
<|GER|>sichern	z ɪ ç ɐ n
<|GER|>sieger	z iː ɡ ɐ
<|GER|>sinkt	z ɪ ŋ k t
<|GER|>sinnvoll	z ɪ n f ɔ l
<|GER|>sogar	z o ɡ aː ɐ̯
<|GER|>solche	z ɔ l ç ə
<|GER|>soldaten	z ɔ l d aː t n
<|GER|>soll	z ɔ l
<|GER|>sommer	z ɔ m ɐ
<|GER|>spann	ʃ p a n
<|GER|>spaziergang	ʃ p a t͡s iː ɐ̯ ɡ a ŋ
<|GER|>speed	s p iː t
<|GER|>spiel	ʃ p iː l
<|GER|>spielen	ʃ p iː l ə n
<|GER|>spieler	ʃ p iː l ɐ
<|GER|>sportler	ʃ p ɔ ʁ t l ɐ
<|GER|>sprechen	ʃ p r ɛ ç ə n
<|GER|>sprecher	ʃ p r ɛ ç ə r
<|GER|>spricht	ʃ p ʁ ɪ ç t
<|GER|>sprung	ʃ p ʁ ʊ ŋ
<|GER|>spur	ʃ p uː ɐ̯
<|GER|>spüren	ʃ p yː ʁ ə n
<|GER|>staatsanwalt	ʃ t aː t͡s ʔ a n v a l t
<|GER|>staatsanwaltschaft	ʃ t aː t͡s ʔ a n v a l t ʃ a f t
<|GER|>stark	ʃ t a r k
<|GER|>starten	ʃ t a r t ə n
<|GER|>statt	ʃ t a t
<|GER|>stattdessen	ʃ t a t d ɛ s n̩
<|GER|>steinmauer	ʃ t a ɪ n m a ʊ̯ ɐ
<|GER|>sterben	ʃ t ɛ ʁ b ə n
<|GER|>stets	ʃ t eː t s
<|GER|>steuern	ʃ t ɔ ɪ̯ ɐ n
<|GER|>stichwort	ʃ t ɪ ç v ɔ ʁ t
<|GER|>stieg	ʃ t iː k
<|GER|>stimme	ʃ t ɪ m ə
<|GER|>stockerl	ʃ t ɔ k ɐ l
<|GER|>stolz	ʃ t ɔ l t͡s
<|GER|>strafe	ʃ t ʁ aː f ə
<|GER|>strasse	ʃ t r aː s ə
<|GER|>strich	ʃ t ʁ ɪ ç
<|GER|>stufe	ʃ t uː f ə
<|GER|>stunden	ʃ t ʊ n d ə n
<|GER|>stärke	ʃ t ɛ r k ə
<|GER|>stück	ʃ t ʏ k
<|GER|>stürmer	ʃ t ʏ r m ə r
<|GER|>suchen	z uː x ə n
<|GER|>suchmaschine	z uː x m a ʃ iː n ə
<|GER|>sucht	z ʊ x t
<|GER|>süden	z yː d ə n
<|GER|>sündenbock	z ʏ n d ə n b ɔ k
<|GER|>tage	t aː ɡ ə
<|GER|>tagen	t aː ɡ ə n
<|GER|>tat	t aː t
<|GER|>tatsächlich	t aː t z ɛ ç l ɪ ç
<|GER|>teilweise	t a ɪ̯ l v a ɪ̯ z ə
<|GER|>tests	t ɛ s t s
<|GER|>teuer	t ɔ ʏ̯ ɐ
<|GER|>thermometer	t ɛ ʁ m o m eː t ɐ
<|GER|>thüringen	t yː ʁ ɪ ŋ ə n
<|GER|>tirol	t i ʁ oː l
<|GER|>tolle	t ɔ l ə
<|GER|>tonnen	t ɔ n ə n
<|GER|>transfer	t r a n s f eː r
<|GER|>tritt	t ʁ ɪ t
<|GER|>trockenheit	t ʁ ɔ k ə n h a ɪ̯ t
<|GER|>trugen	t ʁ uː ɡ n
<|GER|>tränen	t ʁ ɛ n ə n
<|GER|>tschernobyl	t͡ʃ ɛ ʁ n oː b ʏ l
<|GER|>tweet	t v iː t
<|GER|>twitter	t v ɪ t ə r
<|GER|>töpfern	t œ p f ɐ n
<|GER|>uhr	uː r
<|GER|>um	ʊ m
<|GER|>umgang	ʊ m ɡ a ŋ
<|GER|>umsetzung	ʊ m z ɛ t s ʊ ŋ
<|GER|>unabhängig	ʊ n a p h ɛ ŋ ɪ ç
<|GER|>unermüdlich	ʊ n ɛ ɐ m yː t l ɪ ç
<|GER|>unfall	ʊ n f a l
<|GER|>ungebrochen	ʊ n ɡ ə b ʁ ɔ χ n̩
<|GER|>ungestraft	ʊ n ɡ ə ʃ t ʁ aː f t
<|GER|>ungewöhnlich	ʊ n ɡ ə v øː n l ɪ ç
<|GER|>unglaublich	ʊ n ɡ l a u̯ p l ɪ ç
<|GER|>uns	ʊ n s
<|GER|>unter	ʊ n t ɐ
<|GER|>unterirdisch	ʊ n t ɐ ʔ ɪ ʁ d ɪ ʃ
<|GER|>unternehmen	ʊ n t ɐ n eː m ə n
<|GER|>unternehmer	ʊ n t ɐ n eː m ɐ
<|GER|>unterschied	ʔ ʊ n tʰ ɐ ʃ iː t
<|GER|>unterschiedlich	ʊ n t ɐ ʃ iː t l ɪ ç
<|GER|>unterstützung	ʊ n t ɐ ʃ t ʏ t͡s ʊ ŋ
<|GER|>unterwegs	ʊ n t ɐ v eː k s
<|GER|>unzufriedenheit	ʔ ʊ n t͡s u f ʁ iː d ə n h a ɪ̯ t
<|GER|>ursprünglich	ʔ uː ɐ̯ ʃ p ʁ ʏ ŋ l ɪ ç
<|GER|>veranstaltung	f ɛ ɐ̯ a n ʃ t a l t ʊ ŋ
<|GER|>verantwortung	f ɛ ɐ̯ ʔ a n t v ɔ ʁ t ʊ ŋ
<|GER|>verbindung	f ɛ ɐ̯ b ɪ n d ʊ ŋ
<|GER|>verein	f ɛ ɐ̯ ʔ a ɪ̯ n
<|GER|>vereinigung	f ɛ ɐ̯ ʔ a ɪ̯ n ɪ ɡ ʊ ŋ
<|GER|>verfassung	f ɛ ɐ̯ f a s ʊ ŋ
<|GER|>verfügung	f ɛ ɐ̯ f yː ɡ ʊ ŋ
<|GER|>vergabe	f ɛ ɐ̯ ɡ aː b ə
<|GER|>vergangenheit	f ɛ ɐ̯ ɡ a ŋ ə n h a ɪ̯ t
<|GER|>vergessen	f ɛ ɐ̯ ɡ ɛ s ə n
<|GER|>verhindert	f ɛ ʁ h ɪ n d ɐ t
<|GER|>verhältnis	f ɛ ɐ̯ h ɛ l t n ɪ s
<|GER|>verkauf	f ɛ ɐ̯ k a ʊ̯ f
<|GER|>verkehr	f ɛ r k eː r
<|GER|>verkürzen	f ɛ ɐ̯ k ʏ ʁ t͡s ə n
<|GER|>verlassen	f ə r l a s ə n
<|GER|>vermeiden	f ɛ ɐ̯ m a ɪ̯ d ə n
<|GER|>vernichten	f ɛ ɐ̯ n ɪ ç t ə n
<|GER|>verscheuchen	f ɛ ɐ̯ ʃ ɔ ɪ ç ə n
<|GER|>verschieben	f ɛ r ʃ iː b ə n
<|GER|>versicherte	f ɛ ɐ̯ z ɪ ç ɐ t ə
<|GER|>versickern	f ɛ ɐ̯ z ɪ k ɐ n
<|GER|>verständnis	f ɛ ɐ̯ ʃ t ɛ n t n ɪ s
<|GER|>verstärkung	f ɛ ɐ̯ ʃ t ɛ ʁ k ʊ ŋ
<|GER|>versuchen	f ɛ ɐ̯ z uː x ə n
<|GER|>verteidigung	f ɛ ɐ̯ t a ɪ̯ d ɪ ɡ ʊ ŋ
<|GER|>verteilen	f ɛ ʁ t a ɪ̯ l ə n
<|GER|>vertrauen	f ɛ ɐ̯ t ʁ a ʊ̯ ə n
<|GER|>vertreibung	f ɛ ʁ t ʁ a ɪ̯ b ʊ ŋ
<|GER|>veränderung	f ɛ ɐ̯ ɛ n d ə ʁ ʊ ŋ
<|GER|>verärgern	f ɛ ʁ ʔ ɛ ʁ ɡ ɐ n
<|GER|>videokonferenz	v iː d e o k ɔ n f e ʁ ɛ n t͡s
<|GER|>viele	f iː l ə
<|GER|>vieles	f iː l ə s
<|GER|>violett	v iː o l ɛ t
<|GER|>viren	v iː r ə n
<|GER|>volkes	f ɔ l k ə s
<|GER|>voll	f ɔ l
<|GER|>vollendung	f ɔ l ʔ ɛ n d ʊ ŋ
<|GER|>von	f ɔ n
<|GER|>vorbild	f oː ɐ̯ b ɪ l t
<|GER|>vorgänger	f oː ɐ̯ ɡ ɛ ŋ ɐ
<|GER|>vorhaben	f oː ʁ h aː b ə n
<|GER|>vorjahr	f oː ɐ̯ j aː ɐ̯
<|GER|>vorsitz	f oː ɐ̯ z ɪ t s
<|GER|>vorwurf	f oː ʁ v ʊ ʁ f
<|GER|>vorüber	f o ʁ yː b ɐ
<|GER|>waffe	v a f ə
<|GER|>wahl	v aː l
<|GER|>wahlen	v aː l ə n
<|GER|>wahllokal	v aː l l o k aː l
<|GER|>wahrscheinlich	v aː ɐ̯ ʃ a ɪ̯ n l ɪ ç
<|GER|>wann	v a n
<|GER|>wegwerfen	v ɛ k v ɛ ɐ̯ f n̩
<|GER|>weil	v a ɪ̯ l
<|GER|>wein	v a ɪ̯ n
<|GER|>weise	v a ɪ̯ z ə
<|GER|>weisse	v a ɪ̯ s ə
<|GER|>welche	v ɛ l ç ə
<|GER|>welt	v ɛ l t
<|GER|>weltweit	v ɛ l t v a ɪ̯ t
<|GER|>wenig	v eː n ɪ ç
<|GER|>wer	v eː r
<|GER|>werktags	v ɛ r k t aː k s
<|GER|>werte	v ɛ ɐ̯ t ə
<|GER|>wettbewerb	v ɛ t b ə v ɛ ʁ p
<|GER|>wetter	v ɛ t ɐ
<|GER|>will	v ɪ l
<|GER|>willkommen	v ɪ l k ɔ m ə n
<|GER|>windschutzscheibe	v ɪ n t ʃ ʊ t͡s ʃ a ɪ̯ b ə
<|GER|>winzerin	v ɪ n t s ɐ ʁ ɪ n
<|GER|>wird	v ɪ ɐ̯ t
<|GER|>wirken	v ɪ ʁ k ə n
<|GER|>wirklich	v ɪ ʁ k l ɪ ç
<|GER|>wo	v oː
<|GER|>woche	v ɔ x ə
<|GER|>wochenende	v ɔ χ n̩ ʔ ɛ n d ə
<|GER|>wohl	v oː l
<|GER|>wohlleben	v oː l l eː b n̩
<|GER|>wohnen	v oː n ə n
<|GER|>wohnung	v oː n ʊ ŋ
<|GER|>wollte	v ɔ l t ə
<|GER|>wort	v ɔ r t
<|GER|>wunderbar	v ʊ n d ɐ b aː ɐ̯
<|GER|>wunsch	v ʊ n ʃ
<|GER|>wurde	v ʊ ʁ d ə
<|GER|>würde	v ʏ ʁ d ə
<|GER|>zahl	t s aː l
<|GER|>zart	t s aː r t
<|GER|>zehn	t͡s eː n
<|GER|>zeichen	t s a ɪ̯ ç ə n
<|GER|>zeigen	t͡s a ɪ̯ ɡ ə n
<|GER|>zeitlos	t͡s a ɪ̯ t l oː s
<|GER|>zeitpunkt	t s a ɪ̯ t p ʊ ŋ k t
<|GER|>zeitraum	t s a ɪ̯ t ʁ a ʊ̯ m
<|GER|>zeugin	t s ɔ ʏ̯ ɡ ɪ n
<|GER|>zuerst	t s u ʔ eː ɐ̯ s t
<|GER|>zufall	t͡s uː f a l
<|GER|>zufolge	t s u f ɔ l ɡ ə
<|GER|>zugleich	t͡s u ɡ l a ɪ̯ ç
<|GER|>zugänglich	t s uː ɡ ɛ ŋ l ɪ ç
<|GER|>zumindest	t͡s u m ɪ n d ə s t
<|GER|>zunächst	t s u n ɛː ç s t
<|GER|>zur	t s uː ɐ̯
<|GER|>zurzeit	t s ʊ r t s a ɪ t
<|GER|>zurück	t͡s u ʁ ʏ k
<|GER|>zuschauer	t͡s uː ʃ a ʊ̯ ɐ
<|GER|>zuvor	t͡s u f oː ɐ̯
<|GER|>zwar	t͡s v aː ɐ̯
<|GER|>zweierlei	t s v a ɪ̯ ɐ l a ɪ̯
<|GER|>zweifel	t͡s v a ɪ̯ f l̩
<|GER|>zweitens	t͡s v a ɪ̯ t n̩ s
<|GER|>zweiter	t͡s v a ɪ̯ t ɐ
<|GER|>zwingen	t s v ɪ ŋ ə n
<|GER|>zwischen	t s v ɪ ʃ ə n
<|GER|>zwölf	t͡s v œ l f
<|GER|>zürcher	t͡s ʏ ʁ ç ɐ
<|GER|>äussern	ɔ ʏ̯ s ɐ n
<|GER|>öffnen	ʔ œ f n ə n
<|GER|>öffnung	œ f n ʊ ŋ
<|GER|>österreich	øː s t ə ʁ a ɪ ç
<|GER|>überhaupt	yː b ɐ h a ʊ̯ p t
<|GER|>überlegungen	y b ɐ l eː ɡ ʊ ŋ ə n
<|GER|>überraschend	yː b ɐ ʁ a ʃ ə n t
<|GER|>überrascht	yː b ɐ ʁ a ʃ t
<|GER|>übertragen	yː b ə r t r aː ɡ ə n
<|GER|>überwindung	yː b ɐ v ɪ n d ʊ ŋ
<|SWE|>adjö	a j øː
<|SWE|>affär	a ¹ f ɛː r
<|SWE|>afton	a f t ɔ n
<|SWE|>aggressiv	a ɡ r ɛ s iː v
<|SWE|>agneta	a ŋ ² n eː t a
<|SWE|>aktie	a k t s ɪ ɛ
<|SWE|>aktuell	a k t ɵ ɛ l
<|SWE|>akut	a k ʉː t
<|SWE|>albin	¹ a l b ɪ n
<|SWE|>aldrig	a l d r i ɡ
<|SWE|>alkoholist	a l k ʊ h ʊ l ɪ s t
<|SWE|>allihop	a l ɪ h uː p
<|SWE|>allmän	a l m ɛ n
<|SWE|>allvarlig	a l v ɑː r l ɪ ɡ
<|SWE|>ambitiös	a m b i ɧ øː s
<|SWE|>ana	 ɑː n a
<|SWE|>and	a n d
<|SWE|>andra	a n d r a
<|SWE|>ansikte	a nː s ɪ k t ə
<|SWE|>anspråk	 a n s p r oː k
<|SWE|>ansvarig	 a n s v ɑː r ɪ ɡ
<|SWE|>antisemitism	a n t ɪ s ɛ m ɪ t ɪ s m
<|SWE|>arkiv	a r k iː v
<|SWE|>arrangemang	a r a n ɧ e m a ŋ
<|SWE|>arrangera	a r a n ɧ eː r a
<|SWE|>arsenik	a r s ɛ n iː k
<|SWE|>arton	 ɑː r t ɔ n
<|SWE|>arv	a r v
<|SWE|>as	ɑː s
<|SWE|>attack	a t a k
<|SWE|>avfärda	ɑː v f ɛ r d a
<|SWE|>avgå	 ɑː v ɡ oː
<|SWE|>avled	 ɑː v l eː d
<|SWE|>avseende	ɑː v s eː ɛ n d ɛ
<|SWE|>bad	b ɑː d
<|SWE|>bak	b ɑː k
<|SWE|>bakbord	b aː k b uː r d
<|SWE|>band	b a n d
<|SWE|>bank	b a ŋː k
<|SWE|>barnet	b ɑː r n ɛ t
<|SWE|>bas	b ɑː s
<|SWE|>bedrägeri	b ɛ d r ɛː ɡ ɛ r iː
<|SWE|>behov	b ɛ h uː v
<|SWE|>belgien	b ɛ l ɡ ɪ ɛ n
<|SWE|>berg	b ɛ r j
<|SWE|>berget	b ɛ r j ɛ t
<|SWE|>bergs	b ɛ r j s
<|SWE|>bert	b æ ʈ
<|SWE|>besökare	b ɛ s øː k a r ɛ
<|SWE|>betala	b ɛ t ɑː l a
<|SWE|>betyda	b ɛ ¹ t yː d a
<|SWE|>bilist	b ɪ l ɪ s t
<|SWE|>bill	b ɪ l
<|SWE|>bjuda	 b j ʉː d a
<|SWE|>blad	¹ b l ɑː d
<|SWE|>blandning	 b l a n d n i ŋ
<|SWE|>blev	b l eː v
<|SWE|>bli	b l iː
<|SWE|>blomqvist	 b l ʊ m k v ɪ s t
<|SWE|>blott	b l ɔ tː
<|SWE|>blåljus	b l oː j ʉː s
<|SWE|>bo	b uː
<|SWE|>boden	b uː d ɛ n
<|SWE|>bodil	¹ b uː d ɪ l
<|SWE|>bok	b uː k
<|SWE|>bokhandel	 b uː k h a n d ɛ l
<|SWE|>bord	b uː ɖ
<|SWE|>bordtennis	 b uː ɖ t ɛ n ɪ s
<|SWE|>bortaplan	 b ɔ r t a p l ɑː n
<|SWE|>bostad	 b uː s t ɑː d
<|SWE|>bov	b uː v
<|SWE|>brand	b r a n d
<|SWE|>bris	b r iː s
<|SWE|>brista	 b r ɪ sː t a
<|SWE|>bro	b r uː
<|SWE|>bron	b r uː n
<|SWE|>bröd	b r øː d
<|SWE|>bröt	b r øː t
<|SWE|>bur	b ʉː r
<|SWE|>buss	b ɵ s
<|SWE|>bär	b ɛː r
<|SWE|>båda	b oː d a
<|SWE|>bål	b oː l
<|SWE|>båt	b oː ə t
<|SWE|>böcker	¹ b ø kː ə r
<|SWE|>centimeter	s ɛ n t ɪ m eː t ɛ r
<|SWE|>charlotta	ɧ a r ² ɭ o t a
<|SWE|>charlotte	ɧ a ɭ o t
<|SWE|>dag	d ɑː ɡ
<|SWE|>damm	d a m
<|SWE|>dan	d ɑː n
<|SWE|>danmark	¹ d a n m a r k
<|SWE|>dansk	d a n s k
<|SWE|>danska	 d a n s k a
<|SWE|>december	d ɛ s ɛ m b ɛ r
<|SWE|>definition	d ɛ f ɪ n ɪ ¹ ɧ uː n
<|SWE|>dela	d eː l a
<|SWE|>dem	d ɔ m
<|SWE|>den	d ɛ nː
<|SWE|>denne	d ɛ nː ɛ
<|SWE|>dessa	d ɛ sː a
<|SWE|>dessutom	d e s ʉː t ɔ m
<|SWE|>detektiv	d ɛ t ɛ k t iː v
<|SWE|>dig	d ɛ j
<|SWE|>diskussion	d ɪ s k ɵ ɧ uː n
<|SWE|>djup	j ʉː p
<|SWE|>djupt	j ʉː p t
<|SWE|>djur	j ʉː r
<|SWE|>dock	d ɔ kː
<|SWE|>dog	d uː ɡ
<|SWE|>dra	d r ɑː
<|SWE|>dricka	 d r ɪ kː a
<|SWE|>dricker	d r ɪ kː e r
<|SWE|>droppen	d r ɔ pː ɛ n
<|SWE|>dryg	d r yː ɡ
<|SWE|>dröm	d r œ mː
<|SWE|>dubbel	d ɵ b ɛ l
<|SWE|>dyr	d yː r
<|SWE|>där	d ɛː r
<|SWE|>då	d oː
<|SWE|>dålig	d oː l ɪ ɡ
<|SWE|>dö	d øː
<|SWE|>död	d øː d
<|SWE|>döda	 d øː d a
<|SWE|>dölja	d œ l j a
<|SWE|>efter	ɛ f t ɛ r
<|SWE|>eftersom	 ɛ f t æ r s ɔ m
<|SWE|>ek	eː k
<|SWE|>elegant	ɛ l ɛ ɡ a n t
<|SWE|>elfte	ɛ l f t ɛ
<|SWE|>eller	ɛ l ɛ r
<|SWE|>elva	ɛ l v a
<|SWE|>enda	ɛ n d a
<|SWE|>engagera	a ŋ ɡ a ɧ eː r a
<|SWE|>engelska	e ŋ e l s k a
<|SWE|>enhetlig	eː n h eː t l ɪ ɡ
<|SWE|>enkel	ɛ ŋ k ɛ l
<|SWE|>ensam	 ɛ nː s a mː
<|SWE|>erkänna	eː r ɕ ɛ n a
<|SWE|>eskilstuna	ɛ̂ sː k ɪ l s t ʉː n a
<|SWE|>ett	ɛ t
<|SWE|>europé	ɛ r ʊ p eː
<|SWE|>fabrik	f a b r iː k
<|SWE|>fader	f ɑː d ɛ r
<|SWE|>fallskärm	f a l ɧ ɛ r m
<|SWE|>farlig	 f ɑː r l ɪ ɡ
<|SWE|>februari	f ɛ b r ɵ ɑː r ɪ
<|SWE|>fem	f ɛ m
<|SWE|>femton	f ɛ m t ɔ n
<|SWE|>fett	f ɛ t
<|SWE|>ficka	f ɪ kː a
<|SWE|>finger	f ɪ ŋː ɛ r
<|SWE|>finska	 f ɪ n s k a
<|SWE|>fisk	f ɪ s k
<|SWE|>fiske	 f ɪ s k ɛ
<|SWE|>fisken	f ɪ sː k ɛ n
<|SWE|>fjol	f j uː l
<|SWE|>flicka	f l ɪ kː a
<|SWE|>flickan	f l ɪ kː a n
<|SWE|>flickor	f l ɪ k ʊ r
<|SWE|>folkmusik	 f ɔ l k m ɵ s iː k
<|SWE|>fotboll	f uː t b ɔ l
<|SWE|>fram	f r a m
<|SWE|>framför	 f r a m f œː r
<|SWE|>franska	 f r a n s k a
<|SWE|>fred	f r eː d
<|SWE|>frihet	f r iː h eː t
<|SWE|>fru	f r ʉː
<|SWE|>frukt	f r ɵ k t
<|SWE|>främlingsfientlighet	 f r ɛ m l ɪ ŋ s f ɪ ɛ n t l ɪ ɡ h eː t
<|SWE|>fråga	f r oː ɡ a
<|SWE|>frånvaro	 f r oː n v ɑː r ʊ
<|SWE|>frös	f r øː s
<|SWE|>full	f ɵ l
<|SWE|>fungera	f ɵ ŋ ɡ eː r a
<|SWE|>fusk	f ɵ s k
<|SWE|>fyr	f yː r
<|SWE|>färg	f ɛ r j
<|SWE|>färsk	f ɛ r s k
<|SWE|>får	f oː r
<|SWE|>fåtal	 f oː t ɑː l
<|SWE|>förbruka	f œ r b r ʉː k a
<|SWE|>förbundskapten	f œ r ² b ɵ n d s k a p t eː n
<|SWE|>förena	f œ r eː n a
<|SWE|>förening	f œ r eː n ɪ ŋ
<|SWE|>förgäves	f œ r j ɛː v ɛ s
<|SWE|>förrän	f œ r ɛ n
<|SWE|>försiktighet	f øː r s ɪ k t ɪ ɡ h eː t
<|SWE|>förstöra	f œ ʂ ʈ œː r a
<|SWE|>försvarstal	f œ r ² s v ɑː r s t ɑː l
<|SWE|>förvärras	f œ̞ r v æ r a s
<|SWE|>förälder	f œ r ¹ ɛ l d æ r
<|SWE|>förälskelse	f œ r ɛ l s k ɛ l s ɛ
<|SWE|>gammal	 ɡ a mː a l
<|SWE|>gav	ɡ ɑː v
<|SWE|>ge	j eː
<|SWE|>genren	ɧ a ŋ ɛ r n
<|SWE|>georg	j eː ɔ r j
<|SWE|>ger	j eː r
<|SWE|>gjorde	j ʊ ɖ ɛ
<|SWE|>gjort	j ʊ ʈ
<|SWE|>gjuta	 j ʉː t a
<|SWE|>glatt	ɡ l a tː
<|SWE|>glögg	ɡ l œ ɡ
<|SWE|>gott	ɡ ɔ t
<|SWE|>green	ɡ r iː n
<|SWE|>grej	ɡ r ɛ j
<|SWE|>grekland	ɡ r eː k l a n d
<|SWE|>grep	ɡ r eː p
<|SWE|>gross	ɡ r ɔ s
<|SWE|>grund	ɡ r ɵ n d
<|SWE|>grät	ɡ r ɛː t
<|SWE|>grön	ɡ r øː n
<|SWE|>gud	ɡ ʉː d
<|SWE|>gula	 ɡ ʉː l a
<|SWE|>guld	ɡ ɵ l d
<|SWE|>gym	j ʏ m
<|SWE|>gärna	 j ɛː r n a
<|SWE|>gävle	j ɛː v l ɛ
<|SWE|>gång	ɡ ɔ ŋ
<|SWE|>göran	j øː r a n
<|SWE|>hade	 h a dː ɛ
<|SWE|>haft	h a f t
<|SWE|>hall	h a l
<|SWE|>halv	h a l v
<|SWE|>halvlek	 h a l v l eː k
<|SWE|>hand	h a n d
<|SWE|>hans	h ɑː n s
<|SWE|>hantverk	h a n t v ɛ r k
<|SWE|>har	h ɑː r
<|SWE|>hat	h ɑː t
<|SWE|>hav	h ɑː v
<|SWE|>heat	h iː t
<|SWE|>hej	h ɛ jː
<|SWE|>hel	h eː l
<|SWE|>helig	h eː l ɪ ɡ
<|SWE|>helsingborg	h ɛ l s ɪ ŋ b ɔ r j
<|SWE|>helsingfors	h ɛ l s ɪ ŋ f ɔ r s
<|SWE|>hemester	h ɛ m ɛ s t ɛ r
<|SWE|>hemmaplan	 h ɛ m a p l ɑː n
<|SWE|>henne	h ɛ nː ɛ
<|SWE|>herr	h ɛ r
<|SWE|>heta	h eː t a
<|SWE|>hitta	h ɪ t a
<|SWE|>hjälp	j ɛ l p
<|SWE|>holm	h ɔ l m ɛ
<|SWE|>honom	h ɔ nː ɔ m
<|SWE|>hoppa	h ɔ p a
<|SWE|>hot	h uː t
<|SWE|>hotell	h ʊ t ɛ lː
<|SWE|>hud	h ʉː d
<|SWE|>humle	h ɵ m l ɛ
<|SWE|>hund	h ɵ n d
<|SWE|>hundra	h ɵ n d r a
<|SWE|>hungrig	h ɵ ŋ r ɪ ɡ
<|SWE|>hur	h ʉː r
<|SWE|>hus	h ʉː s
<|SWE|>hustru	h ɵ̄ sː t r ʉ̂ː
<|SWE|>hygglig	h ʏ ɡ l ɪ ɡ
<|SWE|>hylla	h ʏ lː a
<|SWE|>häl	h ɛː l
<|SWE|>häll	h ɛ l
<|SWE|>här	h æː r
<|SWE|>härlig	h ɛː r l ɪ ɡ
<|SWE|>hårt	h oː ʈ
<|SWE|>hö	h øː
<|SWE|>hög	h øː ɡ
<|SWE|>höga	h øː ɡ a
<|SWE|>högljudd	 h øː ɡ j ɵ d
<|SWE|>höst	h œ s t
<|SWE|>höstas	 h œ s t a s
<|SWE|>idrott	 iː d r ɔ t
<|SWE|>igelkott	iː ɡ ɛ l k ɔ t
<|SWE|>ihjäl	ɪ j ɛː l
<|SWE|>ihop	ɪ h uː p
<|SWE|>inga	 ɪ ŋ a
<|SWE|>ingenting	ɪ ŋ ɛ n tʰ ɪ ŋ
<|SWE|>inger	 ɪ n j eː r
<|SWE|>innan	 ɪ n a n
<|SWE|>insjukna	 ɪ n ɧ ʉː k n a
<|SWE|>inte	 ɪ n t ɛ
<|SWE|>internationell	ɪ n t ɛ r n a t ɧ ʊ n ɛ l
<|SWE|>intryck	ɪ n t r ʏ kː
<|SWE|>is	iː s
<|SWE|>italien	ɪ t ɒː l ɪ ə n
<|SWE|>jag	j ɑː ɡ
<|SWE|>januari	j a n ɵ ɑː r ɪ
<|SWE|>japanska	j a p ɑː n s k a
<|SWE|>jasmine	ɧ a s m iː n
<|SWE|>jason	j ɑː s ɔ n
<|SWE|>jennie	¹ j ɛ n ɪ
<|SWE|>jonsson	j ʊ n s ɔ n
<|SWE|>jonte	 j ɔ n t ɛ
<|SWE|>jord	j uː r d
<|SWE|>jorden	j uː r d ɛ n
<|SWE|>journal	ɧ ʊ ɳ ɑː l
<|SWE|>journalist	ɧ ʊ r n a l ɪ s t
<|SWE|>juice	j uː s
<|SWE|>jul	j ʉː l
<|SWE|>juli	j ʉː l ɪ
<|SWE|>juni	j ʉː n ɪ
<|SWE|>jupiter	j ʉː p ɪ t ɛ r
<|SWE|>järv	j æ r v
<|SWE|>kajak	k a j ɑː k
<|SWE|>kalifornien	k a l ɪ f uː r n ɪ ɛ n
<|SWE|>kall	k a l
<|SWE|>kalla	 k a lː a
<|SWE|>kalle	 k a l ɛ
<|SWE|>kamera	k ɑː m ɛ r a
<|SWE|>kan	k a nː
<|SWE|>kanske	 k a n ɧ ɛ
<|SWE|>karta	k ɑː r t a
<|SWE|>katarina	k a t a ² r iː n a
<|SWE|>katt	k a tː
<|SWE|>kemi	ɕ ɛ m iː
<|SWE|>kil	ɕ iː l
<|SWE|>kilometer	ɕ ɪ l ʊ m eː t ɛ r
<|SWE|>kina	 ɕ iː n a
<|SWE|>kläder	k l ɛː d ɛ r
<|SWE|>knarka	k n a r k a
<|SWE|>kniv	k n iː v
<|SWE|>knut	k n ʉː t
<|SWE|>knä	k n ɛː
<|SWE|>kol	k oː l
<|SWE|>kolla	k ɔ l a
<|SWE|>kom	k ɔ m
<|SWE|>komma	 k ɔ m a
<|SWE|>kompis	¹ k ɔ m p ɪ s
<|SWE|>konspirationsteoretiker	k ɔ n s p ɪ r a ² ɧ uː n s t ɛ ʊ r eː t ɪ k ɛ r
<|SWE|>konspirationsteori	k ɔ n s p ɪ r a ² ɧ uː n s t ɛ ʊ r iː
<|SWE|>konst	k ɔ nː s t
<|SWE|>konsumtion	k ɔ n s ɵ m ɧ uː n
<|SWE|>kontrast	k ʊ n t r a s t
<|SWE|>kor	k uː r
<|SWE|>kraftfull	k r a f t f ɵ l
<|SWE|>krav	k ɾ ɑː v
<|SWE|>krig	k r iː ɡ
<|SWE|>kristina	k r ɪ ² s t iː n a
<|SWE|>krona	k r uː n a
<|SWE|>kropp	k r ɔ pː
<|SWE|>krut	k r ʉː t
<|SWE|>kul	k ʉː l
<|SWE|>kull	k ɵ l
<|SWE|>kunde	k ɵ n d ə
<|SWE|>kungsfiskare	k ɵ ŋ s f ɪ s k a r ɛ
<|SWE|>kurs	k ʉː r s
<|SWE|>kvalitet	k v a l ɪ t eː
<|SWE|>kvar	k v ɑː r
<|SWE|>kvarter	k v a r t eː r
<|SWE|>kvinna	k v ɪ nː a
<|SWE|>kvinnan	k v ɪ nː a n
<|SWE|>kvinnor	k v ɪ nː ʊ r
<|SWE|>kväll	k v ɛ lː
<|SWE|>käka	 ɕ ɛː k a
<|SWE|>källa	ɕ ɛ l a
<|SWE|>känd	ɕ ɛ n d
<|SWE|>känna	ɕ ɛ n n a
<|SWE|>känt	ɕ ɛ n t
<|SWE|>kär	ɕ ɛː r
<|SWE|>kära	ɕ ɛː r a
<|SWE|>kärlek	ɕ ɛː r l eː k
<|SWE|>kål	k oː l
<|SWE|>kår	k oː r
<|SWE|>kö	k øː
<|SWE|>kök	ɕ øː k
<|SWE|>köl	ɕ øː l
<|SWE|>köp	ɕ øː p
<|SWE|>köpa	ɕ øː p a
<|SWE|>köpenhamn	ɕ øː p ɛ n h a m n
<|SWE|>laboratorium	l a b ʊ r a t uː r ɪ ɵ m
<|SWE|>lade	l ɑː d ɛ
<|SWE|>lag	l ɑː ɡ
<|SWE|>lager	l ɑː ɡ ɛ r
<|SWE|>lagt	l a k t
<|SWE|>lagts	l a k t s
<|SWE|>lappuggla	l a p ɵ ɡ l a
<|SWE|>lax	l a k s
<|SWE|>leende	l eː ɛ n d ɛ
<|SWE|>legitim	l ɛ ɡ ɪ t iː m
<|SWE|>leif	l ɛ j f
<|SWE|>lev	l eː v
<|SWE|>linnéa	l ɪ ² n eː a
<|SWE|>lita	l iː t a
<|SWE|>liv	l iː v
<|SWE|>ljud	j ʉː d
<|SWE|>ljungby	 j ɵ ŋ b ʏ
<|SWE|>ljus	j ʉː s
<|SWE|>london	l ɔ n d ɔ n
<|SWE|>lopp	l ɔ pː
<|SWE|>lugn	l ɵ ŋ n
<|SWE|>lunch	l ɵ n ɧ
<|SWE|>lund	l ɵ n d
<|SWE|>lycklig	l ʏ kː l ɪ ɡ
<|SWE|>lyssna	 l ʏ s n a
<|SWE|>läcka	l ɛ k a
<|SWE|>läger	l ɛː ɡ ɛ r
<|SWE|>lägga	 l ɛ ɡ a
<|SWE|>län	l ɛː n
<|SWE|>länge	l ɛ ŋ ɛ
<|SWE|>längs	l ɛ ŋ s
<|SWE|>lär	l ɛː r
<|SWE|>lära	l æː r a
<|SWE|>läs	l ɛː s
<|SWE|>läsa	l ɛː s a
<|SWE|>läser	l ɛ s ɛ r
<|SWE|>lätt	l ɛ t
<|SWE|>låg	l oː ɡ
<|SWE|>långsam	 l ɔ ŋ s a m
<|SWE|>långt	l ɔ ŋ t
<|SWE|>låt	l oː t
<|SWE|>låta	 l oː t a
<|SWE|>lön	l øː n
<|SWE|>löpa	l øː p a
<|SWE|>lördag	l øː r d ɑː ɡ
<|SWE|>lös	l øː s
<|SWE|>lösa	 l øː s a
<|SWE|>mage	 m ɑː ɡ ɛ
<|SWE|>magnus	¹ m a ŋ n ɵ s
<|SWE|>maj	m a j
<|SWE|>malmö	m a l m øː
<|SWE|>malte	 m a l t ɛ
<|SWE|>mannen	m a nː ɛ n
<|SWE|>margareta	m a r ɡ a ² r eː t a
<|SWE|>marika	m a ² r iː k a
<|SWE|>maskin	m a ɧ iː n
<|SWE|>mat	m ɑː t
<|SWE|>matchfixning	 m a t͡ɕ f ɪ k s n ɪ ŋ
<|SWE|>mattias	m a t iː a s
<|SWE|>medarbetare	m eː d a r b eː t a r ɛ
<|SWE|>meddela	m eː d d e l a
<|SWE|>meddelande	m eː d d eː l a n d ɛ
<|SWE|>meny	m ɛ n yː
<|SWE|>mer	m eː r
<|SWE|>meter	m eː t ɛ r
<|SWE|>mikael	m iː k aː e l
<|SWE|>miljard	m ɪ l j ɑː ɖ
<|SWE|>miljon	m ɪ l j uː n
<|SWE|>miljö	m ɪ l j øː
<|SWE|>min	m iː n
<|SWE|>mitt	m ɪ tː
<|SWE|>mittemot	m ɪ tˑ e m uː t
<|SWE|>mod	m uː d
<|SWE|>mor	m uː r
<|SWE|>morse	 m ɔ r s e
<|SWE|>moskva	m ʊ s k v ɑː
<|SWE|>mot	m uː t
<|SWE|>museer	m ɵ s eː ɛ r
<|SWE|>museum	m ɵ s eː ɵ m
<|SWE|>musik	m ʉ s iː k
<|SWE|>mycket	m ʏ k ɛ t
<|SWE|>mystisk	m ʏ s t ɪ s k
<|SWE|>mäktig	 m ɛ k t ɪ ɡ
<|SWE|>män	m ɛ n
<|SWE|>människa	m ɛ nː ɪ ɧ a
<|SWE|>mänsklig	 m ɛ n s k l ɪ ɡ
<|SWE|>mästerskap	 m ɛ s t e r s k ɑː p
<|SWE|>mäta	m ɛː t a
<|SWE|>mål	m oː l
<|SWE|>mög	m øː ɡ
<|SWE|>möjlig	 m œ j l ɪ ɡ
<|SWE|>mötesplats	 m øː t ɛ s p l a t s
<|SWE|>nacka	 n a k a
<|SWE|>nationell	n a t ɧ ʊ n ɛ l
<|SWE|>natt	n a tː
<|SWE|>nederländerna	 n e d ɛ r l ɛ n d ɛ ɲ a
<|SWE|>nej	n ɛ j
<|SWE|>nellie	¹ n ɛ l ɪ
<|SWE|>ner	n eː r
<|SWE|>nobben	n ɔ b ɛ n
<|SWE|>nordkorea	 n uː ɖ k ʊ r eː a
<|SWE|>norge	n ɔ r j ɛ
<|SWE|>norr	n ɔ rː
<|SWE|>norska	 n ɔ ʂ k a
<|SWE|>not	n uː t
<|SWE|>november	n ʊ v ɛ m b ɛ r
<|SWE|>nummer	¹ n ɵ m ɛ r
<|SWE|>ny	n yː
<|SWE|>nya	 n yː a
<|SWE|>nyckel	 n ʏ k ɛ l
<|SWE|>nyss	n ʏ s
<|SWE|>nyttig	 n ʏ t ɪ ɡ
<|SWE|>näsa	n ɛː s a
<|SWE|>nätter	n ɛ tː ə r
<|SWE|>nå	n oː
<|SWE|>nått	n ɔ t
<|SWE|>nödvändig	n øː d v ɛ n d ɪ ɡ
<|SWE|>objekt	ɔ b j ɛ k t
<|SWE|>offside	ɔ f s a j d
<|SWE|>ogilla	 uː j ɪ l a
<|SWE|>oklar	uː k l ɑː r
<|SWE|>om	ɔ m
<|SWE|>omöjlig	 uː m ø j l ɪ ɡ
<|SWE|>ord	uː r d
<|SWE|>order	ɔ r d ɛ r
<|SWE|>ordning	ɔ r d n ɪ ŋ
<|SWE|>orientering	ɔ r j ɛ n ¹ t eː r ɪ ŋ
<|SWE|>orka	ɔ r k a
<|SWE|>oskar	¹ ɔ s k a r
<|SWE|>oss	ɔ s
<|SWE|>osäker	uː s ɛː k ɛ r
<|SWE|>paket	p a k eː t
<|SWE|>papper	 p a pː ɛ r
<|SWE|>paris	p a r iː s
<|SWE|>part	p ɑː ʈ
<|SWE|>passagerare	p a s a ² ɧ eː r a r ɛ
<|SWE|>paus	p a ʊ̯ s
<|SWE|>pension	p a n ɧ uː n
<|SWE|>pep	p eː p
<|SWE|>period	p ɛ rː j uː d
<|SWE|>person	p ɛ r s uː n
<|SWE|>personlig	p ɛ ʂ oː n l ɪ ɡ
<|SWE|>personligen	p ɛ r s uː n l ɪ ɡ ɛ n
<|SWE|>piper	p iː p ɛ r
<|SWE|>platt	p l a tː
<|SWE|>podd	p ɔ d
<|SWE|>pojke	 p ɔ j k ɛ
<|SWE|>pokal	p ʊ k ɑː l
<|SWE|>politik	p ʊ l ɪ t iː k
<|SWE|>prata	p r ɑː t a
<|SWE|>present	p r e s e n t
<|SWE|>pressmeddelande	 p r ɛ s m eː d eː l a n d ɛ
<|SWE|>princip	p r ɪ n s iː p
<|SWE|>pris	p r iː s
<|SWE|>problem	p r ʊ b l eː m
<|SWE|>procent	p r ʊ s ɛ n t
<|SWE|>process	p r ʊ s ɛ s
<|SWE|>prognos	p r ɔ ɡ n oː s
<|SWE|>pröva	p r øː v a
<|SWE|>punkt	p ɵ ŋ k t
<|SWE|>på	p oː
<|SWE|>regering	r ɛ j eː r ɪ ŋ
<|SWE|>regissör	r ɛ ɧ ɪ s øː r
<|SWE|>regn	r ɛ ŋ n
<|SWE|>rejäl	r ɛ j ɛː l
<|SWE|>reklam	r ɛ k l ɑː m
<|SWE|>relation	r ɛ l a ɧ uː n
<|SWE|>religiös	r ɛ l ɪ ɧ øː s
<|SWE|>rent	r eː n t
<|SWE|>resultat	r ɛ s ɵ l t ɑː t
<|SWE|>rik	r iː k
<|SWE|>rulle	 r ɵ l ɛ
<|SWE|>rum	r ɵ m
<|SWE|>ryska	 r ʏ s k a
<|SWE|>ryttare	r ʏ t a r e
<|SWE|>rå	r oː
<|SWE|>råd	r oː d
<|SWE|>rån	r oː n
<|SWE|>rökning	 r øː k n ɪ ŋ
<|SWE|>sabotage	s a b ʊ t ɑː ɧ
<|SWE|>sade	s ɑː d ɛ
<|SWE|>sagt	s a k t
<|SWE|>sak	s ɑː k
<|SWE|>sakna	s ɑː k n a
<|SWE|>samling	 s a m l ɪ ŋ
<|SWE|>samt	s a m t
<|SWE|>schack	ɧ a k
<|SWE|>schlager	ɧ l ɑː ɡ e r
<|SWE|>schweiz	ʂ v ɛ jː t s
<|SWE|>seg	s eː ɡ
<|SWE|>seger	s eː ɡ ɛ r
<|SWE|>semester	s ɛ m ɛ s t ɛ r
<|SWE|>sent	s eː n t
<|SWE|>september	s ɛ p t ɛ m b ɛ r
<|SWE|>sevilla	s ɛ v iː a
<|SWE|>silver	s ɪ l v ɛ r
<|SWE|>simma	 s ɪ m a
<|SWE|>sitt	s ɪ tː
<|SWE|>sitta	 s ɪ t a
<|SWE|>sju	ɧ ʉː
<|SWE|>sjuda	ɧ ʉː d a
<|SWE|>sjuk	ɧ ʉː k
<|SWE|>sjuka	 ɧ ʉː k a
<|SWE|>sjukdom	 ɧ ʉː k d ʊ m
<|SWE|>sjukhus	 ɧ ʉː k h ʉː s
<|SWE|>sjuksköterska	 ɧ ʉː k ɧ øː t ɛ r s k a
<|SWE|>sjunde	ɧ ɵ n d ɛ
<|SWE|>sjunga	 ɧ ɵ ŋ a
<|SWE|>sjutton	ɧ ɵ t ɔ n
<|SWE|>själ	ɧ ɛː l
<|SWE|>självklar	 ɧ ɛ l v k l ɑː r
<|SWE|>sjätte	ɧ ɛ t ɛ
<|SWE|>sjön	ɧ œ n
<|SWE|>skapa	s k ɑː p a
<|SWE|>ske	ɧ eː
<|SWE|>skicka	ɧ ɪ k a
<|SWE|>skilja	 ɧ ɪ l j a
<|SWE|>skillnad	ɧ ɪ l n a d
<|SWE|>skit	ɧ iː t
<|SWE|>skjuta	 ɧ ʉː t a
<|SWE|>skola	 s k uː l a
<|SWE|>skottland	s k ɔ t l a n d
<|SWE|>skrik	s k r iː k
<|SWE|>skriva	s k r iː v a
<|SWE|>skulle	s k ɵ lː ə
<|SWE|>skydd	ɧ ʏ d
<|SWE|>skyhög	ɧ ỳː h øː ɡ
<|SWE|>skytt	ɧ ʏ t
<|SWE|>skäl	ɧ ɛː l
<|SWE|>skämt	ɧ ɛ m t
<|SWE|>skänka	 ɧ ɛ ŋ k a
<|SWE|>skära	ɧ æː r a
<|SWE|>skärpa	 ɧ æ r p a
<|SWE|>sköld	ɧ œ l d
<|SWE|>skön	ɧ øː n
<|SWE|>slagsmål	s l a k s m oː l
<|SWE|>slog	s l uː ɡ
<|SWE|>släkt	s l ɛ k t
<|SWE|>slät	s l ɛː t
<|SWE|>slå	s l oː
<|SWE|>små	s m oː
<|SWE|>snabb	s n a b
<|SWE|>snabbt	s n a p t
<|SWE|>snacka	 s n a kː a
<|SWE|>snart	s n ɑː ʈ
<|SWE|>snälla	s n ɛ lː a
<|SWE|>snö	s n øː
<|SWE|>solna	 s oː l n a
<|SWE|>som	s ɔ m
<|SWE|>sommar	s ɔ mː a r
<|SWE|>sommartid	s ɔ m a r t iː d
<|SWE|>somras	 s ɔ m r a s
<|SWE|>soppa	s ɔ p a
<|SWE|>sorg	s ɔ r j
<|SWE|>sova	 s oː v a
<|SWE|>spanska	 s p a n s k a
<|SWE|>spara	s p ɑː r a
<|SWE|>spel	s p eː l
<|SWE|>spelar	s p eː l a r
<|SWE|>språk	s p r oː k
<|SWE|>stab	s t ɑː b
<|SWE|>stadig	s t ɑː d ɪ ɡ
<|SWE|>stal	s t ɑː l
<|SWE|>stel	s t eː l
<|SWE|>stjäl	ɧ ɛː l
<|SWE|>stjäla	ɧ ɛː l a
<|SWE|>storm	s t ɔ r m
<|SWE|>student	s t ɵ d ɛ n t
<|SWE|>stuga	 s t ʉ̟ː ɡ a
<|SWE|>stulit	s t ʉː l ɪ t
<|SWE|>ställningstagande	 s t ɛ l n ɪ ŋ s t ɑː ɡ a n d ɛ
<|SWE|>stål	s t oː l
<|SWE|>stöd	s t øː d
<|SWE|>störa	 s t œː r a
<|SWE|>sundsvall	s ɵ nː d s v a l
<|SWE|>svag	s v ɑː ɡ
<|SWE|>svar	s v ɑː r
<|SWE|>svara	s v ɑː r a
<|SWE|>svart	¹ s v a r t
<|SWE|>svensk	s v ɛ nː s k
<|SWE|>svenska	 s v ɛ n s k a
<|SWE|>sverige	¹ s v ɛ r j ɛ
<|SWE|>svåger	s v oː ɡ ə r
<|SWE|>syd	s yː d
<|SWE|>sydkorea	 s yː d k ʊ r eː a
<|SWE|>syl	s yː l
<|SWE|>syra	s yː r a
<|SWE|>syster	s ʏ sː t ɛ r
<|SWE|>säga	s ɛ jː a
<|SWE|>sälja	s ɛ lː j a
<|SWE|>särskild	 s ɛː r ɧ ɪ l d
<|SWE|>sätt	s ɛ tː
<|SWE|>så	s oː
<|SWE|>sång	s ɔ ŋː
<|SWE|>söder	s øː d ə r
<|SWE|>södertälje	s œ d ɛ ʈ ɛ lː j ɛ
<|SWE|>tack	t a k
<|SWE|>tag	t ɑː ɡ
<|SWE|>tak	t ɑː k
<|SWE|>tanke	 t a ŋː k ɛ
<|SWE|>teori	t ɛ ʊ r iː
<|SWE|>therese	t ɛ r eː s
<|SWE|>thunberg	t ʉ̂ː n b æ r j
<|SWE|>tid	t iː d
<|SWE|>tidning	 t iː n ɪ ŋ
<|SWE|>tiger	¹ t iː ɡ ɛ r
<|SWE|>till	t ɪ l
<|SWE|>tillbaka	t ɪ l b ɑː k a
<|SWE|>tillförordnad	 t ɪ l f œː r oː r d n a d
<|SWE|>tillhandahålla	t ɪ l ² h a n d a h ɔ l a
<|SWE|>tionde	t iː ɔ n d ɛ
<|SWE|>tjej	ɕ ɛ j
<|SWE|>tobak	t uː b a k
<|SWE|>tofflor	t ɔ f l ʊ ɹ
<|SWE|>tog	t uː ɡ
<|SWE|>tok	t uː k
<|SWE|>tolfte	t ɔ l f t ɛ
<|SWE|>tolv	t ɔ l v
<|SWE|>tor	t uː r
<|SWE|>torg	t ɔ r j
<|SWE|>total	t ʊ t ɑː l
<|SWE|>tredje	t r eː d j ɛ
<|SWE|>tro	t r uː
<|SWE|>tror	t r uː r
<|SWE|>trä	t r ɛː
<|SWE|>träd	t r ɛː d
<|SWE|>tråd	t r oː d
<|SWE|>tuff	t ɵ f
<|SWE|>tusen	t ʉː s ɛ n
<|SWE|>tvivla	t v iː v l a
<|SWE|>tvärtom	t v ɛː ʈ ɔ m
<|SWE|>två	t v oː
<|SWE|>tycka	t ʏ k a
<|SWE|>tyska	 t ʏ s k a
<|SWE|>tyskland	t ʏ s k l a n d
<|SWE|>tyst	t ʏ sː t
<|SWE|>täcke	 t ɛ kː ɛ
<|SWE|>täckt	t ɛ k t
<|SWE|>tända	 t ɛ n d a
<|SWE|>tänkte	t ɛ ŋ k t ɛ
<|SWE|>tå	t oː
<|SWE|>tåg	t oː ɡ
<|SWE|>ugn	ɵ ŋ n
<|SWE|>ukulele	ɵ k ɵ l eː l ɛ
<|SWE|>ulla	 ɵ l a
<|SWE|>under	ɵ n d ɛ r
<|SWE|>universitet	ɵ n ɪ v ɛ ʂ ɪ t eː t
<|SWE|>upp	ɵ p
<|SWE|>uppträda	ɵ pː t r ɛː d a
<|SWE|>uppvisning	 ɵ p v iː s n ɪ ŋ
<|SWE|>ur	ʉː r
<|SWE|>ut	ʉː t
<|SWE|>utan	ʉː t a n
<|SWE|>utgång	ʉː t ɡ ɔ ŋ
<|SWE|>utom	 ʉ̟ː t ɔ m
<|SWE|>uttryck	ʉː t t r ʏ kː
<|SWE|>vaccin	v a k s iː n
<|SWE|>vacker	v a k ɛ r
<|SWE|>vandrare	v a n d r a r ɛ
<|SWE|>vann	v a n
<|SWE|>vapen	¹ v ɑː p ɛ n
<|SWE|>var	v ɑː ɾ
<|SWE|>varandra	v a r a n d r a
<|SWE|>varg	v a r j
<|SWE|>varken	v a r k ɛ n
<|SWE|>varm	v a r m
<|SWE|>varmt	v a r m t
<|SWE|>vasa	v a s ɑː
<|SWE|>vass	v a s
<|SWE|>vatten	v ǎ t ɛ n
<|SWE|>vattnet	v a tː n ɛ t
<|SWE|>vecka	 v ɛ k a
<|SWE|>verk	v æ r k
<|SWE|>verka	v ɛ r k a
<|SWE|>veta	 v eː t a
<|SWE|>vikt	v iː k t
<|SWE|>vilja	 v ɪ lː j a
<|SWE|>vill	v ɪ l
<|SWE|>ville	v ɪ lː ɛ
<|SWE|>vind	v ɪ n d
<|SWE|>vinter	v ɪ n t ɛ r
<|SWE|>vintertid	v ɪ n t ɛ r t iː d
<|SWE|>vintras	 v ɪ n t r a s
<|SWE|>vit	v iː t
<|SWE|>vred	v r eː d
<|SWE|>vuxen	v ɵ k s ɛ n
<|SWE|>väcka	 v ɛ k a
<|SWE|>väg	v ɛː ɡ
<|SWE|>vägg	v ɛ ɡ
<|SWE|>vägra	 v ɛː ɡ r a
<|SWE|>välja	 v ɛ lː j a
<|SWE|>välkommen	 v ɛː l k ɔ mː ɛ n
<|SWE|>vänta	 v ɛ nː t a
<|SWE|>väntan	 v ɛ n t a n
<|SWE|>värd	v ɛː ɖ
<|SWE|>värden	v æː ɖ ɛ n
<|SWE|>värdighet	 v ɛː r d ɪ ɡ h eː t
<|SWE|>världens	v æː ɖ ɛ n s
<|SWE|>värva	 v æ r v a
<|SWE|>väster	v ɛ sː t ə r
<|SWE|>västerås	ʋ ɛ s t ɛ r oː s
<|SWE|>väte	v ɛː t ɛ
<|SWE|>växjö	v ɛ kː ɧ øː
<|SWE|>våg	v oː ɡ
<|SWE|>vår	v oː r
<|SWE|>våras	 v oː r a s
<|SWE|>vård	v oː ɖ
<|SWE|>våt	v oː t
<|SWE|>äga	 ɛː ɡ a
<|SWE|>äldre	ɛ l d r ɛ
<|SWE|>äldst	ɛ l s t
<|SWE|>än	ɛ nː
<|SWE|>ända	ɛ n d a
<|SWE|>ära	 æː r a
<|SWE|>ärlig	æː ɭ ɪ ɡ
<|SWE|>äter	ɛː t ɘ r
<|SWE|>år	oː r
<|SWE|>årlig	 oː ɭ ɪ ɡ
<|SWE|>åsikt	oː s ɪ k t
<|SWE|>åstadkomma	 oː s t a k ɔ m a
<|SWE|>åt	oː t
<|SWE|>åtta	 ɔ tː a
<|SWE|>öga	øː ɡ a
<|SWE|>öl	øː l
<|SWE|>ön	øː n
<|SWE|>öppen	 œ p ɛ n
<|SWE|>öster	œ sː t ə r
<|SWE|>östersjön	 ø sː t ɛ r ɧ ø n
<|SWE|>östersund	œ s t ɛ r s ɵ n d
<|SWE|>över	øː v æ r
<|SWE|>överflöd	øː v ɛ r f l øː d
<|DUT|>aandeel	aː n d eː l
<|DUT|>aanhangen	aː n ɦ ɑ ŋ ə n
<|DUT|>aanhangsel	aː n ɦ ɑ ŋ s ə l
<|DUT|>aanhouding	aː n ɦ ɑ u̯ d ɪ ŋ
<|DUT|>aanrijding	aː n r ɛ i̯ d ɪ ŋ
<|DUT|>aanspreken	aː n s p r eː k ə n
<|DUT|>aanvoerder	aː n v uː r d ə r
<|DUT|>aanvoeren	aː n v uː r ə n
<|DUT|>aanwakkeren	aː n ʋ ɑ k ə r ə n
<|DUT|>aarden	aː r d ə n
<|DUT|>abacus	ɑ b aː k ʏ s
<|DUT|>achterblijven	ɑ x t ə r b l ɛ i̯ v ə n
<|DUT|>achthoek	ɑ x t ɦ u k
<|DUT|>achttien	ɑ x t i n
<|DUT|>acrobatiek	ɑ k r oː b aː t i k
<|DUT|>actrice	ɑ k t r i s ə
<|DUT|>adel	aː d ə l
<|DUT|>ademnood	aː d ə m n oː t
<|DUT|>adriaan	aː d r i aː n
<|DUT|>afbraak	ɑ f b r aː k
<|DUT|>afgeleide	ɑ f x ə l ɛ i̯ d ə
<|DUT|>afgoderij	ɑ f x oː d ə r ɛ i̯
<|DUT|>afhangen	ɑ f ɦ ɑ ŋ ə n
<|DUT|>afrit	ɑ f r ɪ t
<|DUT|>afscheiding	ɑ f s x ɛ i̯ d ɪ ŋ
<|DUT|>afslanken	ɑ f s l ɑ ŋ k ə n
<|DUT|>afstandsbediening	ɑ f s t ɑ n t s b ə d i n ɪ ŋ
<|DUT|>akelig	aː k ə l ə x
<|DUT|>alarmsignaal	ɑ l ɑ r m s ɪ n j aː l
<|DUT|>albanees	ɑ l b aː n eː s
<|DUT|>ale	eː l
<|DUT|>algemeenheid	ɑ l ɣ ə m eː n ɦ ɛ i̯ t
<|DUT|>almaar	ɑ l m aː r
<|DUT|>alsem	ɑ l s ə m
<|DUT|>alsmaar	ɑ l s m aː r
<|DUT|>alsnog	ɑ l s n ɔ x
<|DUT|>ambtenaar	ɑ m p t ə n aː r
<|DUT|>amerikaans	aː m eː r i k aː n s
<|DUT|>andersom	ɑ n d ə r s ɔ m
<|DUT|>andersvalide	ɑ n d ə r s f aː l i d ə
<|DUT|>angstig	ɑ ŋ s t ə x
<|DUT|>april	ɑ p r ɪ l
<|DUT|>archiveren	ɑ r x i v eː r ə n
<|DUT|>argon	ɑ r ɣ ɔ n
<|DUT|>aristocraat	aː r ɪ s t oː k r aː t
<|DUT|>arnhem	ɑ r n ɦ ɛ m
<|DUT|>aroma	aː r oː m aː
<|DUT|>artistiek	ɑ r t ɪ s t i k
<|DUT|>astrid	ɑ s t r ɪ t
<|DUT|>atelier	aː t ə l j eː
<|DUT|>atol	aː t ɔ l
<|DUT|>attribuut	ɑ t r i b y t
<|DUT|>automatisering	ɑ u̯ t oː m aː t i z eː r ɪ ŋ
<|DUT|>babbelen	b ɑ b ə l ə n
<|DUT|>bakken	b ɑ k ə n
<|DUT|>bakpoeder	b ɑ k p u d ə r
<|DUT|>bankovervaller	b ɑ ŋ k oː v ə r v ɑ l ə r
<|DUT|>bankroet	b ɑ ŋ k r u t
<|DUT|>bankschroef	b ɑ ŋ k s x r u f
<|DUT|>baren	b aː r ə n
<|DUT|>beantwoorden	b ə ɑ n t ʋ oː r d ə n
<|DUT|>bedrag	b ə d r ɑ x
<|DUT|>beduidend	b ə d œ y̯ d ə n t
<|DUT|>beerput	b eː r p ʏ t
<|DUT|>beginnen	b ə ɣ ɪ n ə n
<|DUT|>beginnerscursus	b ə ɣ ɪ n ə r s k ʏ r z ʏ s
<|DUT|>begint	b ə ɣ ɪ n t
<|DUT|>begrippenkader	b ə ɣ r ɪ p ə n k aː d ə r
<|DUT|>begroeten	b ə ɣ r u t ə n
<|DUT|>begroting	b ə ɣ r oː t ɪ ŋ
<|DUT|>behaaglijk	b ə ɦ aː x l ə k
<|DUT|>beheerbaar	b ə ɦ eː r b aː r
<|DUT|>behendigheid	b ə ɦ ɛ n d ə x ɦ ɛ i̯ t
<|DUT|>beiden	b ɛ i̯ d ə n
<|DUT|>bek	b ɛ k
<|DUT|>bekennen	b ə k ɛ n ə n
<|DUT|>beladen	b ə l aː d ə n
<|DUT|>belagen	b ə l aː ɣ ə n
<|DUT|>beledigen	b ə l eː d ə ɣ ə n
<|DUT|>benoemen	b ə n u m ə n
<|DUT|>beoordelen	b ə oː r d eː l ə n
<|DUT|>bepalen	b ə p aː l ə n
<|DUT|>bepleiten	b ə p l ɛ i̯ t ə n
<|DUT|>berber	b ɛ r b ə r
<|DUT|>berging	b ɛ r ɣ ɪ ŋ
<|DUT|>bes	b ɛ s
<|DUT|>beschermen	b ə s x ɛ r m ə n
<|DUT|>beschikken	b ə s x ɪ k ə n
<|DUT|>bespelen	b ə s p eː l ə n
<|DUT|>best	b ɛ s t
<|DUT|>bestanden	b ə s t ɑ n d ə n
<|DUT|>besturingssysteem	b ə s t yː r ɪ ŋ s i s t eː m
<|DUT|>betreffen	b ə t r ɛ f ə n
<|DUT|>betrekken	b ə t r ɛ k ə n
<|DUT|>betrokkenheid	b ə t r ɔ k ə n ɦ ɛ i̯ t
<|DUT|>bevalling	b ə v ɑ l ɪ ŋ
<|DUT|>beveiligen	b ə v ɛ i̯ l ə ɣ ə n
<|DUT|>bewaking	b ə ʋ aː k ɪ ŋ
<|DUT|>beweegbaar	b ə ʋ eː x b aː r
<|DUT|>bewindvoerder	b ə ʋ ɪ n t f uː r d ə r
<|DUT|>bezoeken	b ə z u k ə n
<|DUT|>bezuinigen	b ə z œ y̯ n ə ɣ ə n
<|DUT|>bezwaarschrift	b ə z ʋ aː r s x r ɪ f t
<|DUT|>bezweet	b ə z ʋ eː t
<|DUT|>bierbrouwer	b iː r b r ɑ u̯ ə r
<|DUT|>biestmelk	b i s t m ɛ l k
<|DUT|>bijbrengen	b ɛ i̯ b r ɛ ŋ ə n
<|DUT|>bijdrage	b ɛ i̯ d r aː ɣ ə
<|DUT|>bijou	b i ʒ u
<|DUT|>bijtanken	b ɛ i̯ t ɛ ŋ k ə n
<|DUT|>bijwijf	b ɛ i̯ ʋ ɛ i̯ f
<|DUT|>binden	b ɪ n d ə n
<|DUT|>binnentrekken	b ɪ n ə n t r ɛ k ə n
<|DUT|>binnenzak	b ɪ n ə n z ɑ k
<|DUT|>biodanza	b i oː d ɑ n z aː
<|DUT|>bits	b ɪ t s
<|DUT|>bivak	b i v ɑ k
<|DUT|>bladeren	b l aː d ə r ə n
<|DUT|>blauw	b l ɑ u̯
<|DUT|>bleek	b l eː k
<|DUT|>bleekselderij	b l eː k s ɛ l d ə r ɛ i̯
<|DUT|>bleker	b l eː k ə r
<|DUT|>blog	b l ɔ x
<|DUT|>blondine	b l ɔ n d iː n ə
<|DUT|>blut	b l ʏ t
<|DUT|>boa	b oː aː
<|DUT|>bod	b ɔ t
<|DUT|>bodemonderzoek	b oː d ə m ɔ n d ə r z u k
<|DUT|>boedapest	b u d aː p ɛ s t
<|DUT|>boekjaar	b u k j aː r
<|DUT|>bolsward	b ɔ l s ʋ ɑ r t
<|DUT|>bolvormig	b ɔ l v ɔ r m ə x
<|DUT|>borger	b ɔ r ɣ ə r
<|DUT|>borrel	b ɔ r ə l
<|DUT|>borst	b ɔ r s t
<|DUT|>bosnië	b ɔ s n i ə
<|DUT|>boswachter	b ɔ s ʋ ɑ x t ə r
<|DUT|>botsing	b ɔ t s ɪ ŋ
<|DUT|>botswana	b ɔ t s ʋ aː n aː
<|DUT|>botten	b ɔ t ə n
<|DUT|>bovenal	b oː v ə n ɑ l
<|DUT|>bovenkant	b oː v ə n k ɑ n t
<|DUT|>boventoon	b oː v ə n t oː n
<|DUT|>brandstof	b r ɑ n t s t ɔ f
<|DUT|>breed	b r eː t
<|DUT|>broeikaseffect	b r u i̯ k ɑ s ɛ f ɛ k t
<|DUT|>broncode	b r ɔ n k oː d ə
<|DUT|>bronkhorst	b r ɔ ŋ k ɦ ɔ r s t
<|DUT|>bruine	b r œ y̯ n ə
<|DUT|>btw	b eː t eː ʋ eː
<|DUT|>budgetteren	b ʏ d ʒ ɛ t eː r ə n
<|DUT|>buggy	b ʏ ɡ i
<|DUT|>buienradar	b œ y̯ ə n r aː d ɑ r
<|DUT|>buiging	b œ y̯ ɣ ɪ ŋ
<|DUT|>buitenaf	b œ y̯ t ə n ɑ f
<|DUT|>buitenspelval	b œ y̯ t ə n s p ɛ l v ɑ l
<|DUT|>buitentrouw	b œ y̯ t ə n t r ɑ u̯
<|DUT|>bukken	b ʏ k ə n
<|DUT|>burchtheer	b ʏ r x t ɦ eː r
<|DUT|>byzantijns	b i z ɑ n t ɛ i̯ n s
<|DUT|>cabine	k aː b i n ə
<|DUT|>calamiteit	k aː l aː m i t ɛ i̯ t
<|DUT|>californië	k aː l i f ɔ r n i ə
<|DUT|>capitool	k aː p i t oː l
<|DUT|>cataract	k aː t aː r ɑ k t
<|DUT|>cement	s ə m ɛ n t
<|DUT|>charmant	ʃ ɑ r m ɑ n t
<|DUT|>chef	ʃ ɛ f
<|DUT|>chemie	x eː m i
<|DUT|>chirurgie	ʃ i r ʏ r ɣ i
<|DUT|>cimbaal	s ɪ m b aː l
<|DUT|>clown	k l ɑ u̯ n
<|DUT|>coach	k oː t ʃ
<|DUT|>compensatie	k ɔ m p ɛ n z aː t s i
<|DUT|>completeren	k ɔ m p l eː t eː r ə n
<|DUT|>complexiteit	k ɔ m p l ɛ k s i t ɛ i̯ t
<|DUT|>componist	k ɔ m p oː n ɪ s t
<|DUT|>compositie	k ɔ m p oː z i t s i
<|DUT|>computerspel	k ɔ m p j u t ə r s p ɛ l
<|DUT|>concilie	k ɔ n s i l i
<|DUT|>concluderen	k ɔ ŋ k l y d eː r ə n
<|DUT|>condoleren	k ɔ n d oː l eː r ə n
<|DUT|>condoom	k ɔ n d oː m
<|DUT|>conservatisme	k ɔ n z ɛ r v aː t ɪ s m ə
<|DUT|>constant	k ɔ n s t ɑ n t
<|DUT|>contact	k ɔ n t ɑ k t
<|DUT|>convenant	k ɔ n v ə n ɑ n t
<|DUT|>coulisselandschap	k u l i z ə l ɑ n t s x ɑ p
<|DUT|>crèmekleurig	k r ɛː m k l øː r ə x
<|DUT|>curator	k y r aː t ɔ r
<|DUT|>cyprus	s i p r ʏ s
<|DUT|>daarin	d aː r ɪ n
<|DUT|>daarom	d aː r ɔ m
<|DUT|>daartegen	d aː r t eː ɣ ə n
<|DUT|>daartegenover	d aː r t eː ɣ ə n oː v ə r
<|DUT|>dakdekker	d ɑ k d ɛ k ə r
<|DUT|>danig	d aː n ə x
<|DUT|>dankjewel	d ɑ ŋ k j ə ʋ ɛ l
<|DUT|>dato	d aː t oː
<|DUT|>david	d aː v ɪ t
<|DUT|>ddr	d eː d eː ɛ r
<|DUT|>decaan	d eː k aː n
<|DUT|>decentralisering	d eː s ɛ n t r aː l i z eː r ɪ ŋ
<|DUT|>deelstaat	d eː l s t aː t
<|DUT|>dekmantel	d ɛ k m ɑ n t ə l
<|DUT|>delft	d ɛ l f t
<|DUT|>demonstreren	d eː m ɔ n s t r eː r ə n
<|DUT|>demper	d ɛ m p ə r
<|DUT|>deregulering	d eː r eː ɣ y l eː r ɪ ŋ
<|DUT|>dergelijk	d ɛ r ɣ ə l ə k
<|DUT|>desgewenst	d ɛ s x ə ʋ ɛ n s t
<|DUT|>deskundige	d ɛ s k ʏ n d ə ɣ ə
<|DUT|>detail	d eː t ɑ i̯
<|DUT|>dierenpark	d iː r ə n p ɑ r k
<|DUT|>diner	d i n eː
<|DUT|>diploma	d i p l oː m aː
<|DUT|>disco	d ɪ s k oː
<|DUT|>discriminatie	d ɪ s k r i m i n aː t s i
<|DUT|>discrimineren	d ɪ s k r i m i n eː r ə n
<|DUT|>do	d oː
<|DUT|>doctoraat	d ɔ k t oː r aː t
<|DUT|>doelpunt	d u l p ʏ n t
<|DUT|>domein	d oː m ɛ i̯ n
<|DUT|>donderdagochtend	d ɔ n d ə r d ɑ x ɔ x t ə n t
<|DUT|>donkerblauw	d ɔ ŋ k ə r b l ɑ u̯
<|DUT|>dooddoener	d oː t d u n ə r
<|DUT|>doorbrengen	d oː r b r ɛ ŋ ə n
<|DUT|>doordeweeks	d oː r d ə ʋ eː k s
<|DUT|>doorlopend	d oː r l oː p ə n t
<|DUT|>doorsnijden	d oː r s n ɛ i̯ d ə n
<|DUT|>doorstart	d oː r s t ɑ r t
<|DUT|>doppen	d ɔ p ə n
<|DUT|>dorpsplein	d ɔ r p s p l ɛ i̯ n
<|DUT|>dove	d oː v ə
<|DUT|>draf	d r ɑ f
<|DUT|>drama	d r aː m aː
<|DUT|>drang	d r ɑ ŋ
<|DUT|>driecilinder	d r i s i l ɪ n d ə r
<|DUT|>driejarig	d r i j aː r ə x
<|DUT|>drievoudig	d r i v ɑ u̯ d ə x
<|DUT|>drijfveer	d r ɛ i̯ f eː r
<|DUT|>drink	d r ɪ ŋ k
<|DUT|>droogte	d r oː x t ə
<|DUT|>drukker	d r ʏ k ə r
<|DUT|>drukte	d r ʏ k t ə
<|DUT|>duidelijk	d œ y̯ d ə l ə k
<|DUT|>duim	d œ y̯ m
<|DUT|>duivel	d œ y̯ v ə l
<|DUT|>duizelingwekkend	d œ y̯ z ə l ɪ ŋ ʋ ɛ k ə n t
<|DUT|>dwaas	d ʋ aː s
<|DUT|>dwarszitten	d ʋ ɑ r s ɪ t ə n
<|DUT|>dweilen	d ʋ ɛ i̯ l ə n
<|DUT|>dwingen	d ʋ ɪ ŋ ə n
<|DUT|>dyslexie	d ɪ s l ɛ k s i
<|DUT|>echter	ɛ x t ə r
<|DUT|>eden	eː d ə n
<|DUT|>eenzaam	eː n z aː m
<|DUT|>eerstejaars	eː r s t ə j aː r s
<|DUT|>eeuwigheid	eː u̯ ə x ɦ ɛ i̯ t
<|DUT|>effect	ɛ f ɛ k t
<|DUT|>eieren	ɛ i̯ j ə r ə n
<|DUT|>eigenwijs	ɛ i̯ ɣ ə n ʋ ɛ i̯ s
<|DUT|>einde	ɛ i̯ n d ə
<|DUT|>els	ɛ l s
<|DUT|>ene	eː n ə
<|DUT|>eredivisie	eː r ə d i v i s i
<|DUT|>erfzonde	ɛ r f s ɔ n d ə
<|DUT|>evenknie	eː v ə n k n i
<|DUT|>extract	ɛ k t r ɑ k t
<|DUT|>fabriceren	f ɑ b r i s eː r ə n
<|DUT|>factuur	f ɑ k t yː r
<|DUT|>feit	f ɛ i̯ t
<|DUT|>flevoland	f l eː v oː l ɑ n t
<|DUT|>fotografie	f oː t oː ɣ r aː f i
<|DUT|>fretten	f r ɛ t ə n
<|DUT|>fundering	f ʏ n d eː r ɪ ŋ
<|DUT|>föhn	f øː n
<|DUT|>gade	ɣ aː d ə
<|DUT|>game	ɡ eː m
<|DUT|>garde	ɣ ɑ r d ə
<|DUT|>gas	ɣ ɑ s
<|DUT|>gastvrij	ɣ ɑ s t f r ɛ i̯
<|DUT|>gastvrijheid	ɣ ɑ s t f r ɛ i̯ ɦ ɛ i̯ t
<|DUT|>gebouw	ɣ ə b ɑ u̯
<|DUT|>geheten	ɣ ə ɦ eː t ə n
<|DUT|>gek	ɣ ɛ k
<|DUT|>gelaat	ɣ ə l aː t
<|DUT|>geldbuidel	ɣ ɛ l t b œ y̯ d ə l
<|DUT|>geleen	ɣ ə l eː n
<|DUT|>gelijkstelling	ɣ ə l ɛ i̯ k s t ɛ l ɪ ŋ
<|DUT|>gelijktijdigheid	ɣ ə l ɛ i̯ k t ɛ i̯ d ə ɣ ɦ ɛ i̯ d
<|DUT|>geluid	ɣ ə l œ y̯ t
<|DUT|>geologie	ɣ eː oː l oː ɣ i
<|DUT|>geschenk	ɣ ə s x ɛ ŋ k
<|DUT|>geweld	ɣ ə ʋ ɛ l t
<|DUT|>gewoon	ɣ ə ʋ oː n
<|DUT|>gezagvoerder	ɣ ə z ɑ x f uː r d ə r
<|DUT|>giftig	ɣ ɪ f t ə x
<|DUT|>gillen	ɣ ɪ l ə n
<|DUT|>glastuinbouw	ɣ l ɑ s t œ y̯ n b ɑ u̯
<|DUT|>gloeilamp	ɣ l u i̯ l ɑ m p
<|DUT|>goede	ɣ u d ə
<|DUT|>goes	ɣ u s
<|DUT|>gordijn	ɣ ɔ r d ɛ i̯ n
<|DUT|>grapjas	ɣ r ɑ p j ɑ s
<|DUT|>grasduinen	ɣ r ɑ s d œ y̯ n ə n
<|DUT|>grassen	ɣ r ɑ s ə n
<|DUT|>guichelheil	ɣ œ y̯ x ə l ɦ ɛ i̯ l
<|DUT|>haan	ɦ aː n
<|DUT|>half	ɦ ɑ l f
<|DUT|>hamer	ɦ aː m ə r
<|DUT|>hanteerbaar	ɦ ɑ n t eː r b aː r
<|DUT|>heerlijk	ɦ eː r l ə k
<|DUT|>heiligen	ɦ ɛ i̯ l ə ɣ ə n
<|DUT|>hele	ɦ eː l ə
<|DUT|>hermans	ɦ ɛ r m ɑ n s
<|DUT|>hester	ɦ ɛ s t ə r
<|DUT|>hollen	ɦ ɔ l ə n
<|DUT|>homeopathisch	ɦ oː m eː oː p aː t i s
<|DUT|>honkbalknuppel	ɦ ɔ ŋ k b ɑ l k n ʏ p ə l
<|DUT|>hoofdredacteur	ɦ oː f t r eː d ɑ k t øː r
<|DUT|>horizon	ɦ oː r i z ɔ n
<|DUT|>houten	ɦ ɑ u̯ t ə n
<|DUT|>houtworm	ɦ ɑ u̯ t ʋ ɔ r m
<|DUT|>huilebalk	ɦ œ y̯ l ə b ɑ l k
<|DUT|>huis	ɦ œ y̯ s
<|DUT|>huishoudelijk	ɦ œ y̯ s ɦ ɑ u̯ d ə l ə k
<|DUT|>huisvesting	ɦ œ y̯ s f ɛ s t ɪ ŋ
<|DUT|>hup	ɦ ʏ p
<|DUT|>ijmuiden	ɛ i̯ m œ y̯ d ə n
<|DUT|>in	ɪ n
<|DUT|>indien	ɪ n d i n
<|DUT|>indonesisch	ɪ n d oː n eː z i s
<|DUT|>indonesië	ɪ n d oː n eː z i j ə
<|DUT|>inflatie	ɪ n f l aː t s i
<|DUT|>instituut	ɪ n s t i t y t
<|DUT|>instrumentarium	ɪ n s t r y m ɛ n t aː r i ʏ m
<|DUT|>interbellum	ɪ n t ə r b ɛ l ʏ m
<|DUT|>interland	ɪ n t ə r l ɑ n t
<|DUT|>introductie	ɪ n t r oː d ʏ k s i
<|DUT|>intuïtie	ɪ n t y i t s i
<|DUT|>inwerken	ɪ n ʋ ɛ r k ə n
<|DUT|>irakees	i r aː k eː s
<|DUT|>jaarabonnement	j aː r ɑ b ɔ n ə m ɛ n t
<|DUT|>jammer	j ɑ m ə r
<|DUT|>jarige	j aː r ə ɣ ə
<|DUT|>jong	j ɔ ŋ
<|DUT|>jongleren	j ɔ ŋ l eː r ə n
<|DUT|>juffrouw	j ʏ f r ɑ u̯
<|DUT|>ka	k aː
<|DUT|>kabel	k aː b ə l
<|DUT|>kaf	k ɑ f
<|DUT|>kalief	k aː l i f
<|DUT|>kalmte	k ɑ l m t ə
<|DUT|>kamp	k ɑ m p
<|DUT|>kankerhoer	k ɑ ŋ k ə r ɦ uː r
<|DUT|>kapster	k ɑ p s t ə r
<|DUT|>karavaan	k aː r aː v aː n
<|DUT|>karikatuur	k aː r i k aː t y r
<|DUT|>katje	k ɑ t j ə
<|DUT|>katwijk	k ɑ t ʋ ɛ i̯ k
<|DUT|>kazen	k aː z ə n
<|DUT|>keer	k eː r
<|DUT|>kempen	k ɛ m p ə n
<|DUT|>kentering	k ɛ n t ə r ɪ ŋ
<|DUT|>kerkhof	k ɛ r k ɦ ɔ f
<|DUT|>kerkrade	k ɛ r k r aː d ə
<|DUT|>kerstdag	k ɛ r s d ɑ x
<|DUT|>keuren	k øː r ə n
<|DUT|>kiespijn	k i s p ɛ i̯ n
<|DUT|>kin	k ɪ n
<|DUT|>klaslokaal	k l ɑ s l oː k aː l
<|DUT|>klauw	k l ɑ u̯
<|DUT|>kleed	k l eː t
<|DUT|>kleindochter	k l ɛ i̯ n d ɔ x t ə r
<|DUT|>kleinood	k l ɛ i̯ n oː t
<|DUT|>klit	k l ɪ t
<|DUT|>knokpartij	k n ɔ k p ɑ r t ɛ i̯
<|DUT|>koeien	k u i̯ ə n
<|DUT|>komplot	k ɔ m p l ɔ t
<|DUT|>komt	k ɔ m t
<|DUT|>koningin	k oː n ɪ ŋ ɪ n
<|DUT|>koninkrijk	k oː n ɪ ŋ k r ɛ i̯ k
<|DUT|>koolrabi	k oː l r aː b i
<|DUT|>koper	k oː p ə r
<|DUT|>koraal	k oː r aː l
<|DUT|>korea	k oː r eː aː
<|DUT|>krachtdadig	k r ɑ x t d aː d ə x
<|DUT|>krentenbol	k r ɛ n t ə n b ɔ l
<|DUT|>krijgsman	k r ɛ i̯ x s m ɑ n
<|DUT|>kringloopwinkel	k r ɪ ŋ l oː p ʋ ɪ ŋ k ə l
<|DUT|>krokusvakantie	k r oː k ʏ s f aː k ɑ n t s i
<|DUT|>krukas	k r ʏ k ɑ s
<|DUT|>kustplaats	k ʏ s t p l aː t s
<|DUT|>lappen	l ɑ p ə n
<|DUT|>lees	l eː s
<|DUT|>leesten	l eː s t ə n
<|DUT|>leesvoer	l eː s v uː r
<|DUT|>legerleiding	l eː ɣ ə r l ɛ i̯ d ɪ ŋ
<|DUT|>legt	l ɛ x t
<|DUT|>leiding	l ɛ i̯ d ɪ ŋ
<|DUT|>letten	l ɛ t ə n
<|DUT|>letterkundig	l ɛ t ə r k ʏ n d ə x
<|DUT|>leuk	l øː k
<|DUT|>lia	l i aː
<|DUT|>liep	l i p
<|DUT|>limbo	l ɪ m b oː
<|DUT|>lisse	l ɪ s ə
<|DUT|>listig	l ɪ s t ə x
<|DUT|>livestream	l ɑ i̯ v s t r iː m
<|DUT|>locomotief	l oː k oː m oː t i f
<|DUT|>logisch	l oː ɣ i s
<|DUT|>loket	l oː k ɛ t
<|DUT|>londen	l ɔ n d ə n
<|DUT|>loopjongen	l oː p j ɔ ŋ ə n
<|DUT|>lopen	l oː p ə n
<|DUT|>losser	l ɔ s ə r
<|DUT|>lotte	l ɔ t ə
<|DUT|>luchtweerstand	l ʏ x t ʋ eː r s t ɑ n t
<|DUT|>luier	l œ y̯ ə r
<|DUT|>luisterboek	l œ y̯ s t ə r b u k
<|DUT|>maagd	m aː x t
<|DUT|>maar	m aː r
<|DUT|>maat	m aː t
<|DUT|>macedonië	m ɑ s ə d oː n i j ə
<|DUT|>maf	m ɑ f
<|DUT|>mager	m aː ɣ ə r
<|DUT|>maria	m aː r i j aː
<|DUT|>markteconomie	m ɑ r k t eː k oː n oː m i
<|DUT|>marktplaats	m ɑ r k t p l aː t s
<|DUT|>marktwerking	m ɑ r k t ʋ ɛ r k ɪ ŋ
<|DUT|>martelen	m ɑ r t ə l ə n
<|DUT|>mavo	m aː v oː
<|DUT|>maya	m aː j aː
<|DUT|>medezeggenschap	m eː d ə z ɛ ɣ ə n s x ɑ p
<|DUT|>mediatheek	m eː d i aː t eː k
<|DUT|>meervoud	m eː r v ɑ u̯ t
<|DUT|>meijer	m ɛ i̯ ə r
<|DUT|>meisjes	m ɛ i̯ s j ə s
<|DUT|>melkweg	m ɛ l k ʋ ɛ x
<|DUT|>mening	m eː n ɪ ŋ
<|DUT|>mensen	m ɛ n s ə n
<|DUT|>mensenmassa	m ɛ n s ə n m ɑ s aː
<|DUT|>mensensmokkel	m ɛ n s ə n s m ɔ k ə l
<|DUT|>merel	m eː r ə l
<|DUT|>meter	m eː t ə r
<|DUT|>metro	m eː t r oː
<|DUT|>migraine	m i ɡ r ɛː n ə
<|DUT|>milieubelasting	m ɪ l j øː b ə l ɑ s t ɪ ŋ
<|DUT|>miljonair	m ɪ l j oː n ɛ r
<|DUT|>mislukken	m ɪ s l ʏ k ə n
<|DUT|>modder	m ɔ d ə r
<|DUT|>moeheid	m u ɦ ɛ i̯ t
<|DUT|>moeras	m u r ɑ s
<|DUT|>moeten	m u t ə n
<|DUT|>molenaar	m oː l ə n aː r
<|DUT|>mollen	m ɔ l ə n
<|DUT|>mondkap	m ɔ n t k ɑ p
<|DUT|>moreel	m oː r eː l
<|DUT|>muggenzifter	m ʏ ɣ ə n z ɪ f t ə r
<|DUT|>munten	m ʏ n t ə n
<|DUT|>mutant	m y t ɑ n t
<|DUT|>namaken	n aː m aː k ə n
<|DUT|>nasmaak	n aː s m aː k
<|DUT|>natiestaat	n aː t s i s t aː t
<|DUT|>natuursteen	n aː t yː r s t eː n
<|DUT|>nauwkeurig	n ɑ u̯ k øː r ə x
<|DUT|>navo	n aː v oː
<|DUT|>nederlands	n eː d ə r l ɑ n t s
<|DUT|>neptunus	n ɛ p t y n ʏ s
<|DUT|>netjes	n ɛ t j ə s
<|DUT|>neurochirurg	n øː r oː ʃ i r ʏ r x
<|DUT|>nijd	n ɛ i̯ t
<|DUT|>noemer	n u m ə r
<|DUT|>noodlottig	n oː t l ɔ t ə x
<|DUT|>novum	n oː v ʏ m
<|DUT|>oceaan	oː s eː j aː n
<|DUT|>oekaze	u k aː z ə
<|DUT|>oekraïne	u k r aː i n ə
<|DUT|>oeps	u p s
<|DUT|>ofschoon	ɔ f s x oː n
<|DUT|>ogen	oː ɣ ə n
<|DUT|>olietanker	oː l i t ɛ ŋ k ə r
<|DUT|>oliewinning	oː l i ʋ ɪ n ɪ ŋ
<|DUT|>olifantenpad	oː l i f ɑ n t ə n p ɑ t
<|DUT|>omarmen	ɔ m ɑ r m ə n
<|DUT|>ommetje	ɔ m ə t j ə
<|DUT|>onbenul	ɔ n b ə n ʏ l
<|DUT|>onbereikbaar	ɔ n b ə r ɛ i̯ k b aː r
<|DUT|>ondergeschikte	ɔ n d ə r ɣ ə s x ɪ k t ə
<|DUT|>onderwereld	ɔ n d ə r ʋ eː r ə l t
<|DUT|>ongeluk	ɔ ŋ ɣ ə l ʏ k
<|DUT|>onmogelijk	ɔ n m oː ɣ ə l ə k
<|DUT|>ontberingen	ɔ n t b eː r ɪ ŋ ə n
<|DUT|>ontnemen	ɔ n t n eː m ə n
<|DUT|>ontruimen	ɔ n t r œ y̯ m ə n
<|DUT|>ooit	oː i̯ t
<|DUT|>oorlog	oː r l ɔ x
<|DUT|>oosten	oː s t ə n
<|DUT|>oostzee	oː s t s eː
<|DUT|>opbouw	ɔ p b ɑ u̯
<|DUT|>opgeruimd	ɔ p x ə r œ y̯ m t
<|DUT|>opgeven	ɔ p x eː v ə n
<|DUT|>opkomen	ɔ p k oː m ə n
<|DUT|>oppositie	ɔ p oː z i t s i
<|DUT|>optimaal	ɔ p t i m aː l
<|DUT|>opvijzelen	ɔ p f ɛ i̯ z ɛ l ɛ n
<|DUT|>opzetten	ɔ p z ɛ t ə n
<|DUT|>ouwe	ɑ u̯ ə
<|DUT|>overlast	oː v ə r l ɑ s t
<|DUT|>overlaten	oː v ə r l aː t ə n
<|DUT|>overname	oː v ə r n aː m ə
<|DUT|>overplaatsen	oː v ə r p l aː t s ə n
<|DUT|>overzetten	oː v ə r z ɛ t ə n
<|DUT|>overzicht	oː v ə r z ɪ x t
<|DUT|>oxaalzuur	ɔ k s aː l z yː r
<|DUT|>pak	p ɑ k
<|DUT|>paniekvoetbal	p aː n i k f u t b ɑ l
<|DUT|>papierwerk	p aː p iː r ʋ ɛ r k
<|DUT|>parelmoer	p aː r ə l m uː r
<|DUT|>park	p ɑ r k
<|DUT|>parkeerplaats	p ɑ r k eː r p l aː t s
<|DUT|>parking	p ɑ r k ɪ ŋ
<|DUT|>pasgeboren	p ɑ s x ə b oː r ə n
<|DUT|>pech	p ɛ x
<|DUT|>perceel	p ɛ r s eː l
<|DUT|>persen	p ɛ r s ə n
<|DUT|>pijpleiding	p ɛ i̯ p l ɛ i̯ d ɪ ŋ
<|DUT|>pikdonker	p ɪ k d ɔ ŋ k ə r
<|DUT|>pillewegge	p ɪ l ə ʋ ɛ ɣ ə
<|DUT|>pindakaas	p ɪ n d aː k aː s
<|DUT|>pissebed	p ɪ s ə b ɛ t
<|DUT|>plaat	p l aː t
<|DUT|>plaats	p l aː t s
<|DUT|>plan	p l ɑ n
<|DUT|>plasma	p l ɑ s m aː
<|DUT|>plastiek	p l ɑ s t i k
<|DUT|>ploert	p l uː r t
<|DUT|>politiek	p oː l i t i k
<|DUT|>pompen	p ɔ m p ə n
<|DUT|>postbode	p ɔ s t b oː d ə
<|DUT|>postbus	p ɔ s t b ʏ s
<|DUT|>pot	p ɔ t
<|DUT|>printen	p r ɪ n t ə n
<|DUT|>proost	p r oː s t
<|DUT|>prostituee	p r ɔ s t i t y eː
<|DUT|>prothese	p r oː t eː z ə
<|DUT|>provinciën	p r oː v ɪ n s i ə n
<|DUT|>publiek	p y b l i k
<|DUT|>puin	p œ y̯ n
<|DUT|>quarantaine	k aː r ɑ n t ɛː n ə
<|DUT|>raadplegen	r aː t p l eː ɣ ə n
<|DUT|>raadslid	r aː t s l ɪ t
<|DUT|>raam	r aː m
<|DUT|>rare	r aː r ə
<|DUT|>ravage	r aː v aː ʒ ə
<|DUT|>recepten	r ə s ɛ p t ə n
<|DUT|>reken	r eː k ə n
<|DUT|>rellen	r ɛ l ə n
<|DUT|>remmen	r ɛ m ə n
<|DUT|>renswoude	r ɛ n s ʋ ɑ u̯ d ə
<|DUT|>rijdt	r ɛ i̯ t
<|DUT|>rijswijk	r ɛ i̯ s ʋ ɛ i̯ k
<|DUT|>rijweg	r ɛ i̯ ʋ ɛ x
<|DUT|>ring	r ɪ ŋ
<|DUT|>rit	r ɪ t
<|DUT|>rits	r ɪ t s
<|DUT|>roeien	r u i̯ ə n
<|DUT|>roeren	r u r ə n
<|DUT|>rol	r ɔ l
<|DUT|>roof	r oː f
<|DUT|>rook	r oː k
<|DUT|>ruim	r œ y̯ m
<|DUT|>ruimtekromme	r œ y̯ m t ə k r ɔ m ə
<|DUT|>ruimteveer	r œ y̯ m t ə v eː r
<|DUT|>rust	r ʏ s t
<|DUT|>ruth	r ʏ t
<|DUT|>ruïneren	r y i n eː r ə n
<|DUT|>salomonseilanden	s aː l oː m ɔ n s ɛ i̯ l ɑ n d ə n
<|DUT|>samenstelling	s aː m ə n s t ɛ l ɪ ŋ
<|DUT|>sarah	s aː r aː
<|DUT|>sassenheim	s ɑ s ə n ɦ ɛ i̯ m
<|DUT|>schaal	s x aː l
<|DUT|>schaker	s x aː k ə r
<|DUT|>schapenvlees	s x aː p ə n v l eː s
<|DUT|>schelpenpad	s x ɛ l p ə n p ɑ t
<|DUT|>schenking	s x ɛ ŋ k ɪ ŋ
<|DUT|>scherp	s x ɛ r p
<|DUT|>scherpen	s x ɛ r p ə n
<|DUT|>schilderkunst	s x ɪ l d ə r k ʏ n s t
<|DUT|>schizofrenie	s x i t s oː f r eː n i
<|DUT|>schoeien	s x u i̯ ə n
<|DUT|>schokland	s x ɔ k l ɑ n t
<|DUT|>schreef	s x r eː f
<|DUT|>schuiven	s x œ y̯ v ə n
<|DUT|>schuldig	s x ʏ l d ə x
<|DUT|>schutting	s x ʏ t ɪ ŋ
<|DUT|>script	s k r ɪ p t
<|DUT|>seconde	s ɛ k ɔ n d ə
<|DUT|>sedert	s eː d ə r t
<|DUT|>sein	s ɛ i̯ n
<|DUT|>serre	s ɛː r ə
<|DUT|>sier	s i r
<|DUT|>simultaan	s i m ʏ l t aː n
<|DUT|>sjiitisch	ʃ i i t i s
<|DUT|>slachting	s l ɑ x t ɪ ŋ
<|DUT|>slagen	s l aː ɣ ə n
<|DUT|>sleutelrol	s l øː t ə l r ɔ l
<|DUT|>slib	s l ɪ p
<|DUT|>sloeber	s l u b ə r
<|DUT|>sluiten	s l œ y̯ t ə n
<|DUT|>snede	s n eː d ə
<|DUT|>spanjaard	s p ɑ n j aː r t
<|DUT|>spook	s p oː k
<|DUT|>sporthal	s p ɔ r t ɦ ɑ l
<|DUT|>spreekt	s p r eː k t
<|DUT|>springt	s p r ɪ ŋ t
<|DUT|>spuiten	s p œ y̯ t ə n
<|DUT|>staart	s t aː r t
<|DUT|>staat	s t aː t
<|DUT|>stabiel	s t aː b i l
<|DUT|>stagiair	s t aː ʒ ɛː r
<|DUT|>steel	s t eː l
<|DUT|>steen	s t eː n
<|DUT|>stekel	s t eː k ə l
<|DUT|>stekelhuidige	s t eː k ə l ɦ œ y̯ d ə ɣ ə
<|DUT|>step	s t ɛ p
<|DUT|>stiekem	s t i k ə m
<|DUT|>stom	s t ɔ m
<|DUT|>stomp	s t ɔ m p
<|DUT|>stond	s t ɔ n t
<|DUT|>stoppen	s t ɔ p ə n
<|DUT|>strafstudie	s t r ɑ f s t y d i
<|DUT|>stroop	s t r oː p
<|DUT|>stropen	s t r oː p ə n
<|DUT|>structuur	s t r ʏ k t y r
<|DUT|>struikelen	s t r œ y̯ k ə l ə n
<|DUT|>studie	s t y d i
<|DUT|>stuk	s t ʏ k
<|DUT|>suppletie	s ʏ p l eː t s i
<|DUT|>synagoge	s i n aː ɣ oː ɣ ə
<|DUT|>syndroom	s ɪ n d r oː m
<|DUT|>tabel	t aː b ɛ l
<|DUT|>tak	t ɑ k
<|DUT|>tango	t ɑ ŋ ɡ oː
<|DUT|>taugé	t ɑ u̯ ɡ eː
<|DUT|>teef	t eː f
<|DUT|>tegenspoed	t eː ɣ ə n s p u t
<|DUT|>tegenwerpen	t eː ɣ ə n ʋ ɛ r p ə n
<|DUT|>telefoon	t eː l ə f oː n
<|DUT|>teleurstellen	t ə l øː r s t ɛ l ə n
<|DUT|>tempel	t ɛ m p ə l
<|DUT|>teug	t øː x
<|DUT|>thorn	t ɔ r n
<|DUT|>tien	t i n
<|DUT|>tikken	t ɪ k ə n
<|DUT|>toendra	t u n d r aː
<|DUT|>tong	t ɔ ŋ
<|DUT|>toonbank	t oː n b ɑ ŋ k
<|DUT|>topless	t ɔ p l ə s
<|DUT|>totdat	t ɔ t d ɑ t
<|DUT|>traag	t r aː x
<|DUT|>treffen	t r ɛ f ə n
<|DUT|>trend	t r ɛ n t
<|DUT|>tromp	t r ɔ m p
<|DUT|>trouwen	t r ɑ u̯ ə n
<|DUT|>twijfelen	t ʋ ɛ i̯ f ə l ə n
<|DUT|>typesoort	t i p ə s oː r t
<|DUT|>uil	œ y̯ l
<|DUT|>uitdragen	œ y̯ d r aː ɣ ə n
<|DUT|>uitdunnen	œ y̯ d ʏ n ə n
<|DUT|>uiterwaard	œ y̯ t ə r ʋ aː r t
<|DUT|>uitgesproken	œ y̯ t x ə s p r oː k ə n
<|DUT|>uitgestoken	œ y̯ t x ə s t oː k ə n
<|DUT|>uitrekenen	œ y̯ t r eː k ə n ə n
<|DUT|>uitspraak	œ y̯ t s p r aː k
<|DUT|>urine	y r i n ə
<|DUT|>vakmanschap	v ɑ k m ɑ n s x ɑ p
<|DUT|>valk	v ɑ l k
<|DUT|>valuta	v aː l y t aː
<|DUT|>vangrail	v ɑ ŋ r eː l
<|DUT|>varen	v aː r ə n
<|DUT|>vatten	v ɑ t ə n
<|DUT|>vechten	v ɛ x t ə n
<|DUT|>veder	v eː d ə r
<|DUT|>veelbelovend	v eː l b ə l oː v ə n t
<|DUT|>vel	v ɛ l
<|DUT|>vellen	v ɛ l ə n
<|DUT|>vennootschapsbelasting	v ɛ n oː t s x ɑ p s b ə l ɑ s t ɪ ŋ
<|DUT|>verantwoorden	v ə r ɑ n t ʋ oː r d ə n
<|DUT|>verbod	v ə r b ɔ t
<|DUT|>verdichtsel	v ɛ r d ɪ x t s ə l
<|DUT|>verenigde	v ə r eː n ɪ ɣ d ə
<|DUT|>verkrachtingen	v ə r k r ɑ x t ɪ ŋ ə n
<|DUT|>verliest	v ə r l i s t
<|DUT|>verloren	v ə r l oː r ə n
<|DUT|>verschillend	v ə r s x ɪ l ə n t
<|DUT|>versie	v ɛ r z i
<|DUT|>verspilling	v ə r s p ɪ l ɪ ŋ
<|DUT|>vertelling	v ə r t ɛ l ɪ ŋ
<|DUT|>vertoog	v ɛ r t oː x
<|DUT|>vervlieten	v ə r v l i t ə n
<|DUT|>verzendkosten	v ə r z ɛ n t k ɔ s t ə n
<|DUT|>vijfentwintig	v ɛ i̯ f ɛ n t ʋ ɪ n t ə x
<|DUT|>vissers	v ɪ s ə r s
<|DUT|>vitaal	v i t aː l
<|DUT|>vlaanderen	v l aː n d ə r ə n
<|DUT|>vledder	v l ɛ d ə r
<|DUT|>vleermuis	v l eː r m œ y̯ s
<|DUT|>vliegbasis	v l i x b aː z ɪ s
<|DUT|>vliering	v l iː r ɪ ŋ
<|DUT|>vocabulaire	v oː k aː b y l ɛː r
<|DUT|>vochtigheid	v ɔ x t ə x ɦ ɛ i̯ t
<|DUT|>voelen	v u l ə n
<|DUT|>voetballen	v u t b ɑ l ə n
<|DUT|>vogel	v oː ɣ ə l
<|DUT|>vogelaar	v oː ɣ ə l aː r
<|DUT|>voorbaat	v oː r b aː t
<|DUT|>voorbehouden	v oː r b ə ɦ ɑ u̯ d ə n
<|DUT|>voorbij	v oː r b ɛ i̯
<|DUT|>voorbijgaan	v oː r b ɛ i̯ ɣ aː n
<|DUT|>voordoen	v oː r d u n
<|DUT|>voornaam	v oː r n aː m
<|DUT|>voornemen	v oː r n eː m ə n
<|DUT|>voorstaan	v oː r s t aː n
<|DUT|>voorwoord	v oː r ʋ oː r t
<|DUT|>voorzeggen	v oː r z ɛ ɣ ə n
<|DUT|>voorzitster	v oː r z ɪ t s t ə r
<|DUT|>vormen	v ɔ r m ə n
<|DUT|>vraagteken	v r aː x t eː k ə n
<|DUT|>vrijwilliger	v r ɛ i̯ ʋ ɪ l ə ɣ ə r
<|DUT|>vroeger	v r u ɣ ə r
<|DUT|>vsa	v eː ɛ s aː
<|DUT|>vuurwerk	v yː r ʋ ɛ r k
<|DUT|>waar	ʋ aː r
<|DUT|>waardering	ʋ aː r d eː r ɪ ŋ
<|DUT|>waardigheid	ʋ aː r d ə x ɦ ɛ i̯ t
<|DUT|>waarnemen	ʋ aː r n eː m ə n
<|DUT|>wad	ʋ ɑ t
<|DUT|>wao	ʋ eː j aː oː
<|DUT|>waren	ʋ aː r ə n
<|DUT|>was	ʋ ɑ s
<|DUT|>wassen	ʋ ɑ s ə n
<|DUT|>wat	ʋ ɑ t
<|DUT|>wegslepen	ʋ ɛ x s l eː p ə n
<|DUT|>weinig	ʋ ɛ i̯ n ə x
<|DUT|>wekker	ʋ ɛ k ə r
<|DUT|>welbevinden	ʋ ɛ l b ə v ɪ n d ə n
<|DUT|>weleer	ʋ ɛ l eː r
<|DUT|>welvaartsstaat	ʋ ɛ l v aː r t s t aː t
<|DUT|>wen	ʋ ɛ n
<|DUT|>wereld	ʋ eː r ə l t
<|DUT|>wereldbeeld	ʋ eː r ə l t b eː l t
<|DUT|>werk	ʋ ɛ r k
<|DUT|>werkte	ʋ ɛ r k t ə
<|DUT|>wet	ʋ ɛ t
<|DUT|>wetgever	ʋ ɛ t x eː v ə r
<|DUT|>wielrennen	ʋ i l r ɛ n ə n
<|DUT|>wifi	ʋ i f i
<|DUT|>wil	ʋ ɪ l
<|DUT|>winkelen	ʋ ɪ ŋ k ə l ə n
<|DUT|>winters	ʋ ɪ n t ə r s
<|DUT|>wintersport	ʋ ɪ n t ə r s p ɔ r t
<|DUT|>wolven	ʋ ɔ l v ə n
<|DUT|>woont	ʋ oː n t
<|DUT|>woordenwisseling	ʋ oː r d ə n ʋ ɪ s ə l ɪ ŋ
<|DUT|>yoga	j oː ɣ aː
<|DUT|>zakenman	z aː k ə n m ɑ n
<|DUT|>zaklantaarn	z ɑ k l ɑ n t aː r n
<|DUT|>zaltbommel	z ɑ l t b ɔ m ə l
<|DUT|>zangvogel	z ɑ ŋ v oː ɣ ə l
<|DUT|>zeelandia	z eː l ɑ n d i aː
<|DUT|>zeemonster	z eː m ɔ n s t ə r
<|DUT|>zeepbel	z eː p b ɛ l
<|DUT|>zegt	z ɛ x t
<|DUT|>zelf	z ɛ l f
<|DUT|>zelfgenoegzaam	z ɛ l f x ə n u x s aː m
<|DUT|>zenne	z ɛ n ə
<|DUT|>zesentwintig	z ɛ s ɛ n t ʋ ɪ n t ə x
<|DUT|>zeug	z øː x
<|DUT|>ziekenboeg	z i k ə n b u x
<|DUT|>zielig	z i l ə x
<|DUT|>zijkant	z ɛ i̯ k ɑ n t
<|DUT|>zilveren	z ɪ l v ə r ə n
<|DUT|>zilverkleurig	z ɪ l v ə r k l øː r ə x
<|DUT|>zittend	z ɪ t ə n t
<|DUT|>zoekt	z u k t
<|DUT|>zomers	z oː m ə r s
<|DUT|>zondags	z ɔ n d ɑ x s
<|DUT|>zondig	z ɔ n d ə x
<|DUT|>zonsondergang	z ɔ n s ɔ n d ə r ɣ ɑ ŋ
<|DUT|>zonvakantie	z ɔ n v aː k ɑ n s i
<|DUT|>zucht	z ʏ x t
<|DUT|>zuigen	z œ y̯ ɣ ə n
<|DUT|>zuinigheid	z œ y̯ n ə x ɦ ɛ i̯ t
<|DUT|>zwaailicht	z ʋ aː i̯ l ɪ x t
<|DUT|>zwaargewond	z ʋ aː r ɣ ə ʋ ɔ n t
<|DUT|>zwembroek	z ʋ ɛ m b r u k
<|DUT|>zwijgen	z ʋ ɛ i̯ ɣ ə n
<|DUT|>zwijnen	z ʋ ɛ i̯ n ə n
